Zeit;Fahrradbruecke;Fahrradbruecke stadteinwaerts;Fahrradbruecke stadtauswaerts;Symbol Wetter;Temperatur (°C);Gefuehlte Temperatur (°C);Regen (mm);Quelle
01.01.2022 00:00;50;10;40;Sonnig;5;4;0;Stadt Konstanz, Amt für Stadtplanung und Umwelt
01.01.2022 01:00;150;84;66;Sonnig;5;4;0;Stadt Konstanz, Amt für Stadtplanung und Umwelt
01.01.2022 02:00;157;73;84;Sonnig;5;4;0;Stadt Konstanz, Amt für Stadtplanung und Umwelt
01.01.2022 03:00;121;56;65;Sonnig;5;4;0;Stadt Konstanz, Amt für Stadtplanung und Umwelt
01.01.2022 04:00;92;40;52;Sonnig;5;4;0;Stadt Konstanz, Amt für Stadtplanung und Umwelt
01.01.2022 05:00;59;18;41;Sonnig;4;4;0;Stadt Konstanz, Amt für Stadtplanung und Umwelt
01.01.2022 06:00;34;26;8;Sonnig;4;4;0;Stadt Konstanz, Amt für Stadtplanung und Umwelt
01.01.2022 07:00;21;8;13;Sonnig;4;4;0;Stadt Konstanz, Amt für Stadtplanung und Umwelt
01.01.2022 08:00;24;16;8;Sonnig;5;4;0;Stadt Konstanz, Amt für Stadtplanung und Umwelt
01.01.2022 09:00;33;17;16;Sonnig;5;4;0;Stadt Konstanz, Amt für Stadtplanung und Umwelt
01.01.2022 10:00;41;27;14;Sonnig;7;7;0;Stadt Konstanz, Amt für Stadtplanung und Umwelt
01.01.2022 11:00;61;33;28;Sonnig;9;9;0;Stadt Konstanz, Amt für Stadtplanung und Umwelt
01.01.2022 12:00;86;37;49;Sonnig;12;12;0;Stadt Konstanz, Amt für Stadtplanung und Umwelt
01.01.2022 13:00;139;68;71;Sonnig;11;11;0;Stadt Konstanz, Amt für Stadtplanung und Umwelt
01.01.2022 14:00;136;66;70;Sonnig;11;11;0;Stadt Konstanz, Amt für Stadtplanung und Umwelt
01.01.2022 15:00;185;89;96;Sonnig;11;11;0;Stadt Konstanz, Amt für Stadtplanung und Umwelt
01.01.2022 16:00;190;82;108;Sonnig;9;9;0;Stadt Konstanz, Amt für Stadtplanung und Umwelt
01.01.2022 17:00;159;71;88;Leicht bewoelkt;7;7;0;Stadt Konstanz, Amt für Stadtplanung und Umwelt
01.01.2022 18:00;89;34;55;Leicht bewoelkt;6;6;0;Stadt Konstanz, Amt für Stadtplanung und Umwelt
01.01.2022 19:00;60;29;31;Leicht bewoelkt;5;5;0;Stadt Konstanz, Amt für Stadtplanung und Umwelt
01.01.2022 20:00;51;19;32;Leicht bewoelkt;5;5;0;Stadt Konstanz, Amt für Stadtplanung und Umwelt
01.01.2022 21:00;47;21;26;Leicht bewoelkt;4;4;0;Stadt Konstanz, Amt für Stadtplanung und Umwelt
01.01.2022 22:00;31;17;14;Leicht bewoelkt;4;4;0;Stadt Konstanz, Amt für Stadtplanung und Umwelt
01.01.2022 23:00;21;13;8;Sonnig;3;3;0;Stadt Konstanz, Amt für Stadtplanung und Umwelt
02.01.2022 00:00;15;9;6;Sonnig;3;3;0;Stadt Konstanz, Amt für Stadtplanung und Umwelt
02.01.2022 01:00;14;1;13;Sonnig;3;3;0;Stadt Konstanz, Amt für Stadtplanung und Umwelt
02.01.2022 02:00;7;4;3;Sonnig;3;3;0;Stadt Konstanz, Amt für Stadtplanung und Umwelt
02.01.2022 03:00;3;0;3;Sonnig;3;3;0;Stadt Konstanz, Amt für Stadtplanung und Umwelt
02.01.2022 04:00;2;0;2;Sonnig;3;2;0;Stadt Konstanz, Amt für Stadtplanung und Umwelt
02.01.2022 05:00;9;4;5;Sonnig;2;2;0;Stadt Konstanz, Amt für Stadtplanung und Umwelt
02.01.2022 06:00;16;13;3;Sonnig;2;2;0;Stadt Konstanz, Amt für Stadtplanung und Umwelt
02.01.2022 07:00;17;10;7;Sonnig;3;2;0;Stadt Konstanz, Amt für Stadtplanung und Umwelt
02.01.2022 08:00;31;17;14;Leicht bewoelkt;3;2;0;Stadt Konstanz, Amt für Stadtplanung und Umwelt
02.01.2022 09:00;61;35;26;Leicht bewoelkt;3;3;0;Stadt Konstanz, Amt für Stadtplanung und Umwelt
02.01.2022 10:00;70;37;33;Leicht bewoelkt;5;4;0;Stadt Konstanz, Amt für Stadtplanung und Umwelt
02.01.2022 11:00;117;57;60;Leicht bewoelkt;7;6;0;Stadt Konstanz, Amt für Stadtplanung und Umwelt
02.01.2022 12:00;123;61;62;Leicht bewoelkt;8;8;0;Stadt Konstanz, Amt für Stadtplanung und Umwelt
02.01.2022 13:00;143;76;67;Leicht bewoelkt;8;8;0;Stadt Konstanz, Amt für Stadtplanung und Umwelt
02.01.2022 14:00;226;108;118;Bedeckt;8;8;0;Stadt Konstanz, Amt für Stadtplanung und Umwelt
02.01.2022 15:00;236;115;121;Bedeckt;9;8;0;Stadt Konstanz, Amt für Stadtplanung und Umwelt
02.01.2022 16:00;198;84;114;Bedeckt;8;7;0;Stadt Konstanz, Amt für Stadtplanung und Umwelt
02.01.2022 17:00;178;77;101;Sonnig;7;5;0;Stadt Konstanz, Amt für Stadtplanung und Umwelt
02.01.2022 18:00;119;50;69;Sonnig;6;4;0;Stadt Konstanz, Amt für Stadtplanung und Umwelt
02.01.2022 19:00;98;50;48;Sonnig;6;4;0;Stadt Konstanz, Amt für Stadtplanung und Umwelt
02.01.2022 20:00;78;36;42;Bedeckt;7;5;0;Stadt Konstanz, Amt für Stadtplanung und Umwelt
02.01.2022 21:00;57;26;31;Bedeckt;7;6;0;Stadt Konstanz, Amt für Stadtplanung und Umwelt
02.01.2022 22:00;52;27;25;Bedeckt;7;5;0;Stadt Konstanz, Amt für Stadtplanung und Umwelt
02.01.2022 23:00;31;14;17;Leicht bewoelkt;7;5;0;Stadt Konstanz, Amt für Stadtplanung und Umwelt
03.01.2022 00:00;27;14;13;Leicht bewoelkt;6;5;0;Stadt Konstanz, Amt für Stadtplanung und Umwelt
03.01.2022 01:00;11;5;6;Leicht bewoelkt;7;5;0;Stadt Konstanz, Amt für Stadtplanung und Umwelt
03.01.2022 02:00;5;4;1;Bedeckt;7;5;0;Stadt Konstanz, Amt für Stadtplanung und Umwelt
03.01.2022 03:00;6;4;2;Bedeckt;8;5;0;Stadt Konstanz, Amt für Stadtplanung und Umwelt
03.01.2022 04:00;8;4;4;Bedeckt;8;6;0;Stadt Konstanz, Amt für Stadtplanung und Umwelt
03.01.2022 05:00;35;20;15;Bedeckt;8;6;0;Stadt Konstanz, Amt für Stadtplanung und Umwelt
03.01.2022 06:00;93;52;41;Bedeckt;8;6;0;Stadt Konstanz, Amt für Stadtplanung und Umwelt
03.01.2022 07:00;217;134;83;Bedeckt;8;6;0;Stadt Konstanz, Amt für Stadtplanung und Umwelt
03.01.2022 08:00;267;146;121;Bedeckt;8;6;0;Stadt Konstanz, Amt für Stadtplanung und Umwelt
03.01.2022 09:00;285;169;116;Bedeckt;8;6;0;Stadt Konstanz, Amt für Stadtplanung und Umwelt
03.01.2022 10:00;278;150;128;Bedeckt;9;6;0;Stadt Konstanz, Amt für Stadtplanung und Umwelt
03.01.2022 11:00;343;190;153;Nieselregen;9;6;0.1;Stadt Konstanz, Amt für Stadtplanung und Umwelt
03.01.2022 12:00;338;159;179;Nieselregen;9;7;0.2;Stadt Konstanz, Amt für Stadtplanung und Umwelt
03.01.2022 13:00;379;180;199;Nieselregen;9;7;0.1;Stadt Konstanz, Amt für Stadtplanung und Umwelt
03.01.2022 14:00;405;209;196;Stellenweiser Regenfall;9;7;0;Stadt Konstanz, Amt für Stadtplanung und Umwelt
03.01.2022 15:00;402;193;209;Stellenweiser Regenfall;9;7;0;Stadt Konstanz, Amt für Stadtplanung und Umwelt
03.01.2022 16:00;466;211;255;Stellenweiser Regenfall;9;7;0;Stadt Konstanz, Amt für Stadtplanung und Umwelt
03.01.2022 17:00;422;181;241;Stellenweiser Regenfall;9;7;0;Stadt Konstanz, Amt für Stadtplanung und Umwelt
03.01.2022 18:00;330;158;172;Stellenweiser Regenfall;8;7;0;Stadt Konstanz, Amt für Stadtplanung und Umwelt
03.01.2022 19:00;193;79;114;Stellenweiser Regenfall;8;6;0;Stadt Konstanz, Amt für Stadtplanung und Umwelt
03.01.2022 20:00;154;65;89;Nieselregen;8;6;0.1;Stadt Konstanz, Amt für Stadtplanung und Umwelt
03.01.2022 21:00;90;39;51;Nieselregen;8;6;0.1;Stadt Konstanz, Amt für Stadtplanung und Umwelt
03.01.2022 22:00;65;31;34;Nieselregen;8;6;0;Stadt Konstanz, Amt für Stadtplanung und Umwelt
03.01.2022 23:00;29;9;20;Bedeckt;7;6;0;Stadt Konstanz, Amt für Stadtplanung und Umwelt
04.01.2022 00:00;26;9;17;Bedeckt;7;5;0;Stadt Konstanz, Amt für Stadtplanung und Umwelt
04.01.2022 01:00;18;10;8;Bedeckt;7;5;0;Stadt Konstanz, Amt für Stadtplanung und Umwelt
04.01.2022 02:00;2;1;1;Leicht bewoelkt;7;5;0;Stadt Konstanz, Amt für Stadtplanung und Umwelt
04.01.2022 03:00;7;1;6;Leicht bewoelkt;7;5;0;Stadt Konstanz, Amt für Stadtplanung und Umwelt
04.01.2022 04:00;5;2;3;Leicht bewoelkt;7;5;0;Stadt Konstanz, Amt für Stadtplanung und Umwelt
04.01.2022 05:00;31;24;7;Bedeckt;7;5;0;Stadt Konstanz, Amt für Stadtplanung und Umwelt
04.01.2022 06:00;101;57;44;Bedeckt;7;5;0;Stadt Konstanz, Amt für Stadtplanung und Umwelt
04.01.2022 07:00;175;105;70;Bedeckt;7;5;0;Stadt Konstanz, Amt für Stadtplanung und Umwelt
04.01.2022 08:00;286;158;128;Bedeckt;7;5;0;Stadt Konstanz, Amt für Stadtplanung und Umwelt
04.01.2022 09:00;251;147;104;Bedeckt;7;5;0;Stadt Konstanz, Amt für Stadtplanung und Umwelt
04.01.2022 10:00;307;191;116;Bedeckt;8;6;0;Stadt Konstanz, Amt für Stadtplanung und Umwelt
04.01.2022 11:00;338;193;145;Stellenweiser Nieselregen;9;7;0.1;Stadt Konstanz, Amt für Stadtplanung und Umwelt
04.01.2022 12:00;358;149;209;Stellenweiser Nieselregen;10;8;0.1;Stadt Konstanz, Amt für Stadtplanung und Umwelt
04.01.2022 13:00;383;188;195;Stellenweiser Nieselregen;11;9;0;Stadt Konstanz, Amt für Stadtplanung und Umwelt
04.01.2022 14:00;386;173;213;Sonnig;12;10;0;Stadt Konstanz, Amt für Stadtplanung und Umwelt
04.01.2022 15:00;390;187;203;Sonnig;13;11;0;Stadt Konstanz, Amt für Stadtplanung und Umwelt
04.01.2022 16:00;469;235;234;Sonnig;12;10;0;Stadt Konstanz, Amt für Stadtplanung und Umwelt
04.01.2022 17:00;380;159;221;Sonnig;11;10;0;Stadt Konstanz, Amt für Stadtplanung und Umwelt
04.01.2022 18:00;374;165;209;Sonnig;10;9;0;Stadt Konstanz, Amt für Stadtplanung und Umwelt
04.01.2022 19:00;227;100;127;Sonnig;11;9;0;Stadt Konstanz, Amt für Stadtplanung und Umwelt
04.01.2022 20:00;164;69;95;Sonnig;11;9;0;Stadt Konstanz, Amt für Stadtplanung und Umwelt
04.01.2022 21:00;126;59;67;Sonnig;11;9;0;Stadt Konstanz, Amt für Stadtplanung und Umwelt
04.01.2022 22:00;71;28;43;Sonnig;10;7;0;Stadt Konstanz, Amt für Stadtplanung und Umwelt
04.01.2022 23:00;52;22;30;Stellenweiser Regenfall;9;6;0;Stadt Konstanz, Amt für Stadtplanung und Umwelt
05.01.2022 00:00;29;10;19;Stellenweiser Regenfall;8;5;0.1;Stadt Konstanz, Amt für Stadtplanung und Umwelt
05.01.2022 01:00;12;5;7;Stellenweiser Regenfall;6;4;0;Stadt Konstanz, Amt für Stadtplanung und Umwelt
05.01.2022 02:00;8;3;5;Leichter Regenfall;5;3;0.7;Stadt Konstanz, Amt für Stadtplanung und Umwelt
05.01.2022 03:00;4;4;0;Leichter Regenfall;4;2;0.9;Stadt Konstanz, Amt für Stadtplanung und Umwelt
05.01.2022 04:00;5;3;2;Leichter Regenfall;4;1;0.4;Stadt Konstanz, Amt für Stadtplanung und Umwelt
05.01.2022 05:00;37;29;8;Leichter Eisregen;3;1;0.6;Stadt Konstanz, Amt für Stadtplanung und Umwelt
05.01.2022 06:00;85;51;34;Leichter Eisregen;3;1;0.8;Stadt Konstanz, Amt für Stadtplanung und Umwelt
05.01.2022 07:00;198;118;80;Leichter Eisregen;3;1;0.4;Stadt Konstanz, Amt für Stadtplanung und Umwelt
05.01.2022 08:00;288;159;129;Nebel;3;1;0;Stadt Konstanz, Amt für Stadtplanung und Umwelt
05.01.2022 09:00;254;152;102;Nebel;3;1;0;Stadt Konstanz, Amt für Stadtplanung und Umwelt
05.01.2022 10:00;280;147;133;Nebel;3;0;0;Stadt Konstanz, Amt für Stadtplanung und Umwelt
05.01.2022 11:00;272;140;132;Starker Schneefall;3;0;0.2;Stadt Konstanz, Amt für Stadtplanung und Umwelt
05.01.2022 12:00;308;149;159;Starker Schneefall;3;0;0.3;Stadt Konstanz, Amt für Stadtplanung und Umwelt
05.01.2022 13:00;296;129;167;Starker Schneefall;3;-1;0.2;Stadt Konstanz, Amt für Stadtplanung und Umwelt
05.01.2022 14:00;373;185;188;Starker Schneefall;2;-1;0.2;Stadt Konstanz, Amt für Stadtplanung und Umwelt
05.01.2022 15:00;379;199;180;Starker Schneefall;2;-1;0.3;Stadt Konstanz, Amt für Stadtplanung und Umwelt
05.01.2022 16:00;412;203;209;Starker Schneefall;1;-1;0.2;Stadt Konstanz, Amt für Stadtplanung und Umwelt
05.01.2022 17:00;418;186;232;Stellenweise starker Schneefall;1;-2;0.1;Stadt Konstanz, Amt für Stadtplanung und Umwelt
05.01.2022 18:00;379;186;193;Stellenweise starker Schneefall;0;-3;0.2;Stadt Konstanz, Amt für Stadtplanung und Umwelt
05.01.2022 19:00;229;96;133;Stellenweise starker Schneefall;0;-3;0.1;Stadt Konstanz, Amt für Stadtplanung und Umwelt
05.01.2022 20:00;192;88;104;Maessiger Schneefall;-1;-4;0;Stadt Konstanz, Amt für Stadtplanung und Umwelt
05.01.2022 21:00;143;57;86;Maessiger Schneefall;-1;-4;0;Stadt Konstanz, Amt für Stadtplanung und Umwelt
05.01.2022 22:00;92;33;59;Maessiger Schneefall;-1;-4;0;Stadt Konstanz, Amt für Stadtplanung und Umwelt
05.01.2022 23:00;68;28;40;Leicht bewoelkt;-1;-3;0;Stadt Konstanz, Amt für Stadtplanung und Umwelt
06.01.2022 00:00;35;16;19;Leicht bewoelkt;0;-3;0;Stadt Konstanz, Amt für Stadtplanung und Umwelt
06.01.2022 01:00;28;17;11;Leicht bewoelkt;-1;-3;0;Stadt Konstanz, Amt für Stadtplanung und Umwelt
06.01.2022 02:00;15;11;4;Bewoelkt;-1;-3;0;Stadt Konstanz, Amt für Stadtplanung und Umwelt
06.01.2022 03:00;13;5;8;Bewoelkt;-1;-3;0;Stadt Konstanz, Amt für Stadtplanung und Umwelt
06.01.2022 04:00;10;7;3;Bewoelkt;-1;-3;0;Stadt Konstanz, Amt für Stadtplanung und Umwelt
06.01.2022 05:00;12;9;3;Maessiger Schneefall;-1;-3;0;Stadt Konstanz, Amt für Stadtplanung und Umwelt
06.01.2022 06:00;28;23;5;Maessiger Schneefall;-1;-3;0;Stadt Konstanz, Amt für Stadtplanung und Umwelt
06.01.2022 07:00;41;28;13;Maessiger Schneefall;-1;-3;0;Stadt Konstanz, Amt für Stadtplanung und Umwelt
06.01.2022 08:00;42;21;21;Maessiger Schneefall;-1;-3;0;Stadt Konstanz, Amt für Stadtplanung und Umwelt
06.01.2022 09:00;86;37;49;Maessiger Schneefall;-1;-3;0;Stadt Konstanz, Amt für Stadtplanung und Umwelt
06.01.2022 10:00;90;56;34;Maessiger Schneefall;0;-1;0;Stadt Konstanz, Amt für Stadtplanung und Umwelt
06.01.2022 11:00;89;48;41;Leichter Schneefall;1;0;0;Stadt Konstanz, Amt für Stadtplanung und Umwelt
06.01.2022 12:00;118;69;49;Leichter Schneefall;1;1;0;Stadt Konstanz, Amt für Stadtplanung und Umwelt
06.01.2022 13:00;102;45;57;Leichter Schneefall;2;1;0;Stadt Konstanz, Amt für Stadtplanung und Umwelt
06.01.2022 14:00;169;97;72;Bewoelkt;2;2;0;Stadt Konstanz, Amt für Stadtplanung und Umwelt
06.01.2022 15:00;190;90;100;Bewoelkt;2;2;0;Stadt Konstanz, Amt für Stadtplanung und Umwelt
06.01.2022 16:00;206;101;105;Bewoelkt;1;0;0;Stadt Konstanz, Amt für Stadtplanung und Umwelt
06.01.2022 17:00;219;98;121;Sonnig;0;-1;0;Stadt Konstanz, Amt für Stadtplanung und Umwelt
06.01.2022 18:00;168;80;88;Sonnig;-1;-2;0;Stadt Konstanz, Amt für Stadtplanung und Umwelt
06.01.2022 19:00;133;71;62;Sonnig;-2;-3;0;Stadt Konstanz, Amt für Stadtplanung und Umwelt
06.01.2022 20:00;94;38;56;Sonnig;-2;-4;0;Stadt Konstanz, Amt für Stadtplanung und Umwelt
06.01.2022 21:00;87;39;48;Sonnig;-3;-5;0;Stadt Konstanz, Amt für Stadtplanung und Umwelt
06.01.2022 22:00;77;25;52;Sonnig;-4;-5;0;Stadt Konstanz, Amt für Stadtplanung und Umwelt
06.01.2022 23:00;40;13;27;Leicht bewoelkt;-4;-5;0;Stadt Konstanz, Amt für Stadtplanung und Umwelt
07.01.2022 00:00;16;8;8;Leicht bewoelkt;-4;-4;0;Stadt Konstanz, Amt für Stadtplanung und Umwelt
07.01.2022 01:00;22;14;8;Leicht bewoelkt;-5;-6;0;Stadt Konstanz, Amt für Stadtplanung und Umwelt
07.01.2022 02:00;11;2;9;Sonnig;-6;-7;0;Stadt Konstanz, Amt für Stadtplanung und Umwelt
07.01.2022 03:00;1;0;1;Sonnig;-6;-8;0;Stadt Konstanz, Amt für Stadtplanung und Umwelt
07.01.2022 04:00;6;2;4;Sonnig;-6;-8;0;Stadt Konstanz, Amt für Stadtplanung und Umwelt
07.01.2022 05:00;32;22;10;Bedeckt;-5;-7;0;Stadt Konstanz, Amt für Stadtplanung und Umwelt
07.01.2022 06:00;91;59;32;Bedeckt;-5;-7;0;Stadt Konstanz, Amt für Stadtplanung und Umwelt
07.01.2022 07:00;158;96;62;Bedeckt;-4;-6;0;Stadt Konstanz, Amt für Stadtplanung und Umwelt
07.01.2022 08:00;250;128;122;Bedeckt;-3;-5;0;Stadt Konstanz, Amt für Stadtplanung und Umwelt
07.01.2022 09:00;279;167;112;Bedeckt;-2;-4;0;Stadt Konstanz, Amt für Stadtplanung und Umwelt
07.01.2022 10:00;333;196;137;Bedeckt;-1;-3;0;Stadt Konstanz, Amt für Stadtplanung und Umwelt
07.01.2022 11:00;378;215;163;Leicht bewoelkt;0;-3;0;Stadt Konstanz, Amt für Stadtplanung und Umwelt
07.01.2022 12:00;386;168;218;Leicht bewoelkt;1;-2;0;Stadt Konstanz, Amt für Stadtplanung und Umwelt
07.01.2022 13:00;394;173;221;Leicht bewoelkt;1;-2;0;Stadt Konstanz, Amt für Stadtplanung und Umwelt
07.01.2022 14:00;360;183;177;Maessiger Schneefall;1;-2;0;Stadt Konstanz, Amt für Stadtplanung und Umwelt
07.01.2022 15:00;307;126;181;Maessiger Schneefall;1;-2;0;Stadt Konstanz, Amt für Stadtplanung und Umwelt
07.01.2022 16:00;293;111;182;Maessiger Schneefall;1;-3;0;Stadt Konstanz, Amt für Stadtplanung und Umwelt
07.01.2022 17:00;289;146;143;Starker Schneefall;1;-3;0.1;Stadt Konstanz, Amt für Stadtplanung und Umwelt
07.01.2022 18:00;250;108;142;Starker Schneefall;1;-3;0.2;Stadt Konstanz, Amt für Stadtplanung und Umwelt
07.01.2022 19:00;225;108;117;Starker Schneefall;1;-3;0.1;Stadt Konstanz, Amt für Stadtplanung und Umwelt
07.01.2022 20:00;135;60;75;Maessiger Schneefall;1;-2;0;Stadt Konstanz, Amt für Stadtplanung und Umwelt
07.01.2022 21:00;91;38;53;Maessiger Schneefall;1;-2;0;Stadt Konstanz, Amt für Stadtplanung und Umwelt
07.01.2022 22:00;78;37;41;Maessiger Schneefall;0;-3;0;Stadt Konstanz, Amt für Stadtplanung und Umwelt
07.01.2022 23:00;60;21;39;Stellenweise leichter Schneefall;-1;-4;0;Stadt Konstanz, Amt für Stadtplanung und Umwelt
08.01.2022 00:00;33;12;21;Stellenweise leichter Schneefall;-2;-5;0;Stadt Konstanz, Amt für Stadtplanung und Umwelt
08.01.2022 01:00;26;16;10;Stellenweise leichter Schneefall;-2;-5;0;Stadt Konstanz, Amt für Stadtplanung und Umwelt
08.01.2022 02:00;45;17;28;Stellenweise leichter Schneefall;-1;-6;0;Stadt Konstanz, Amt für Stadtplanung und Umwelt
08.01.2022 03:00;14;4;10;Stellenweise leichter Schneefall;-1;-6;0;Stadt Konstanz, Amt für Stadtplanung und Umwelt
08.01.2022 04:00;9;6;3;Stellenweise leichter Schneefall;0;-5;0;Stadt Konstanz, Amt für Stadtplanung und Umwelt
08.01.2022 05:00;33;23;10;Maessiger Schneefall;0;-5;0;Stadt Konstanz, Amt für Stadtplanung und Umwelt
08.01.2022 06:00;32;16;16;Maessiger Schneefall;1;-5;0;Stadt Konstanz, Amt für Stadtplanung und Umwelt
08.01.2022 07:00;37;21;16;Maessiger Schneefall;1;-5;0;Stadt Konstanz, Amt für Stadtplanung und Umwelt
08.01.2022 08:00;74;44;30;Bewoelkt;1;-4;0;Stadt Konstanz, Amt für Stadtplanung und Umwelt
08.01.2022 09:00;163;94;69;Bewoelkt;1;-4;0;Stadt Konstanz, Amt für Stadtplanung und Umwelt
08.01.2022 10:00;280;156;124;Bewoelkt;1;-3;0;Stadt Konstanz, Amt für Stadtplanung und Umwelt
08.01.2022 11:00;302;167;135;Leichte Schneeschauer;2;-2;0;Stadt Konstanz, Amt für Stadtplanung und Umwelt
08.01.2022 12:00;339;190;149;Leichte Schneeschauer;3;-1;0;Stadt Konstanz, Amt für Stadtplanung und Umwelt
08.01.2022 13:00;297;146;151;Leichte Schneeschauer;3;-1;0;Stadt Konstanz, Amt für Stadtplanung und Umwelt
08.01.2022 14:00;312;139;173;Bedeckt;3;0;0;Stadt Konstanz, Amt für Stadtplanung und Umwelt
08.01.2022 15:00;332;167;165;Bedeckt;3;0;0;Stadt Konstanz, Amt für Stadtplanung und Umwelt
08.01.2022 16:00;282;131;151;Bedeckt;3;-1;0;Stadt Konstanz, Amt für Stadtplanung und Umwelt
08.01.2022 17:00;261;103;158;Bedeckt;2;-1;0;Stadt Konstanz, Amt für Stadtplanung und Umwelt
08.01.2022 18:00;269;135;134;Bedeckt;2;-1;0;Stadt Konstanz, Amt für Stadtplanung und Umwelt
08.01.2022 19:00;190;99;91;Bedeckt;2;-1;0;Stadt Konstanz, Amt für Stadtplanung und Umwelt
08.01.2022 20:00;139;71;68;Leicht bewoelkt;2;-1;0;Stadt Konstanz, Amt für Stadtplanung und Umwelt
08.01.2022 21:00;127;61;66;Leicht bewoelkt;2;-1;0;Stadt Konstanz, Amt für Stadtplanung und Umwelt
08.01.2022 22:00;87;44;43;Leicht bewoelkt;2;-1;0;Stadt Konstanz, Amt für Stadtplanung und Umwelt
08.01.2022 23:00;78;24;54;Leichter Eisregen;1;-1;0;Stadt Konstanz, Amt für Stadtplanung und Umwelt
09.01.2022 00:00;61;27;34;Leichter Eisregen;1;-1;0.1;Stadt Konstanz, Amt für Stadtplanung und Umwelt
09.01.2022 01:00;35;17;18;Leichter Eisregen;2;-2;0;Stadt Konstanz, Amt für Stadtplanung und Umwelt
09.01.2022 02:00;36;10;26;Leichter Eisregen;2;-2;0.7;Stadt Konstanz, Amt für Stadtplanung und Umwelt
09.01.2022 03:00;15;5;10;Leichter Eisregen;3;-2;0.9;Stadt Konstanz, Amt für Stadtplanung und Umwelt
09.01.2022 04:00;7;3;4;Leichter Eisregen;3;-3;0.4;Stadt Konstanz, Amt für Stadtplanung und Umwelt
09.01.2022 05:00;10;2;8;Schneesturm;2;-3;0.5;Stadt Konstanz, Amt für Stadtplanung und Umwelt
09.01.2022 06:00;28;13;15;Schneesturm;2;-4;0.6;Stadt Konstanz, Amt für Stadtplanung und Umwelt
09.01.2022 07:00;24;9;15;Schneesturm;2;-4;0.3;Stadt Konstanz, Amt für Stadtplanung und Umwelt
09.01.2022 08:00;37;19;18;Bedeckt;2;-4;0;Stadt Konstanz, Amt für Stadtplanung und Umwelt
09.01.2022 09:00;89;53;36;Bedeckt;1;-4;0;Stadt Konstanz, Amt für Stadtplanung und Umwelt
09.01.2022 10:00;119;65;54;Bedeckt;1;-4;0;Stadt Konstanz, Amt für Stadtplanung und Umwelt
09.01.2022 11:00;156;85;71;Leichte Schneeschauer;2;-3;0;Stadt Konstanz, Amt für Stadtplanung und Umwelt
09.01.2022 12:00;175;85;90;Leichte Schneeschauer;2;-3;0;Stadt Konstanz, Amt für Stadtplanung und Umwelt
09.01.2022 13:00;218;105;113;Leichte Schneeschauer;2;-3;0;Stadt Konstanz, Amt für Stadtplanung und Umwelt
09.01.2022 14:00;159;71;88;Maessige bis starke Schneefaelle;2;-2;0.1;Stadt Konstanz, Amt für Stadtplanung und Umwelt
09.01.2022 15:00;174;85;89;Maessige bis starke Schneefaelle;2;-2;0.1;Stadt Konstanz, Amt für Stadtplanung und Umwelt
09.01.2022 16:00;144;59;85;Maessige bis starke Schneefaelle;2;-2;0;Stadt Konstanz, Amt für Stadtplanung und Umwelt
09.01.2022 17:00;171;94;77;Maessige bis starke Schneefaelle;1;-3;0.1;Stadt Konstanz, Amt für Stadtplanung und Umwelt
09.01.2022 18:00;155;88;67;Maessige bis starke Schneefaelle;1;-3;0.1;Stadt Konstanz, Amt für Stadtplanung und Umwelt
09.01.2022 19:00;117;62;55;Maessige bis starke Schneefaelle;0;-3;0;Stadt Konstanz, Amt für Stadtplanung und Umwelt
09.01.2022 20:00;92;44;48;Leichte Schneeschauer;0;-3;0;Stadt Konstanz, Amt für Stadtplanung und Umwelt
09.01.2022 21:00;68;25;43;Leichte Schneeschauer;-1;-4;0;Stadt Konstanz, Amt für Stadtplanung und Umwelt
09.01.2022 22:00;54;29;25;Leichte Schneeschauer;-1;-3;0;Stadt Konstanz, Amt für Stadtplanung und Umwelt
09.01.2022 23:00;22;13;9;Starker Schneefall;0;-3;0.1;Stadt Konstanz, Amt für Stadtplanung und Umwelt
10.01.2022 00:00;14;4;10;Starker Schneefall;0;-2;0.2;Stadt Konstanz, Amt für Stadtplanung und Umwelt
10.01.2022 01:00;9;5;4;Starker Schneefall;0;-2;0.1;Stadt Konstanz, Amt für Stadtplanung und Umwelt
10.01.2022 02:00;6;4;2;Eisnebel;0;-2;0;Stadt Konstanz, Amt für Stadtplanung und Umwelt
10.01.2022 03:00;6;2;4;Eisnebel;0;-2;0;Stadt Konstanz, Amt für Stadtplanung und Umwelt
10.01.2022 04:00;3;2;1;Eisnebel;0;-2;0;Stadt Konstanz, Amt für Stadtplanung und Umwelt
10.01.2022 05:00;28;18;10;Starker Schneefall;0;-1;0.1;Stadt Konstanz, Amt für Stadtplanung und Umwelt
10.01.2022 06:00;129;76;53;Starker Schneefall;0;0;0.1;Stadt Konstanz, Amt für Stadtplanung und Umwelt
10.01.2022 07:00;773;469;304;Starker Schneefall;0;0;0.1;Stadt Konstanz, Amt für Stadtplanung und Umwelt
10.01.2022 08:00;533;280;253;Starker Schneefall;0;0;0.1;Stadt Konstanz, Amt für Stadtplanung und Umwelt
10.01.2022 09:00;457;261;196;Starker Schneefall;0;0;0.1;Stadt Konstanz, Amt für Stadtplanung und Umwelt
10.01.2022 10:00;253;141;112;Starker Schneefall;0;-1;0.1;Stadt Konstanz, Amt für Stadtplanung und Umwelt
10.01.2022 11:00;363;183;180;Starker Schneefall;1;-2;0.2;Stadt Konstanz, Amt für Stadtplanung und Umwelt
10.01.2022 12:00;393;175;218;Starker Schneefall;1;-2;0.2;Stadt Konstanz, Amt für Stadtplanung und Umwelt
10.01.2022 13:00;660;309;351;Starker Schneefall;1;-2;0.1;Stadt Konstanz, Amt für Stadtplanung und Umwelt
10.01.2022 14:00;395;201;194;Starker Schneefall;1;-2;0.1;Stadt Konstanz, Amt für Stadtplanung und Umwelt
10.01.2022 15:00;713;368;345;Starker Schneefall;1;-2;0.1;Stadt Konstanz, Amt für Stadtplanung und Umwelt
10.01.2022 16:00;561;273;288;Starker Schneefall;0;-3;0.1;Stadt Konstanz, Amt für Stadtplanung und Umwelt
10.01.2022 17:00;720;327;393;Maessige bis starke Schneefaelle;-1;-3;0.1;Stadt Konstanz, Amt für Stadtplanung und Umwelt
10.01.2022 18:00;561;244;317;Maessige bis starke Schneefaelle;-2;-4;0.1;Stadt Konstanz, Amt für Stadtplanung und Umwelt
10.01.2022 19:00;383;163;220;Maessige bis starke Schneefaelle;-2;-4;0;Stadt Konstanz, Amt für Stadtplanung und Umwelt
10.01.2022 20:00;287;143;144;Bedeckt;-2;-5;0;Stadt Konstanz, Amt für Stadtplanung und Umwelt
10.01.2022 21:00;143;63;80;Bedeckt;-2;-5;0;Stadt Konstanz, Amt für Stadtplanung und Umwelt
10.01.2022 22:00;113;58;55;Bedeckt;-2;-5;0;Stadt Konstanz, Amt für Stadtplanung und Umwelt
10.01.2022 23:00;48;17;31;Leicht bewoelkt;-1;-5;0;Stadt Konstanz, Amt für Stadtplanung und Umwelt
11.01.2022 00:00;19;11;8;Leicht bewoelkt;-1;-4;0;Stadt Konstanz, Amt für Stadtplanung und Umwelt
11.01.2022 01:00;20;9;11;Leicht bewoelkt;-1;-4;0;Stadt Konstanz, Amt für Stadtplanung und Umwelt
11.01.2022 02:00;5;4;1;Leicht bewoelkt;-1;-5;0;Stadt Konstanz, Amt für Stadtplanung und Umwelt
11.01.2022 03:00;3;3;0;Leicht bewoelkt;-2;-5;0;Stadt Konstanz, Amt für Stadtplanung und Umwelt
11.01.2022 04:00;6;5;1;Leicht bewoelkt;-1;-4;0;Stadt Konstanz, Amt für Stadtplanung und Umwelt
11.01.2022 05:00;47;34;13;Bedeckt;-1;-4;0;Stadt Konstanz, Amt für Stadtplanung und Umwelt
11.01.2022 06:00;143;81;62;Bedeckt;0;-3;0;Stadt Konstanz, Amt für Stadtplanung und Umwelt
11.01.2022 07:00;847;524;323;Bedeckt;-1;-4;0;Stadt Konstanz, Amt für Stadtplanung und Umwelt
11.01.2022 08:00;647;325;322;Leichter Schneefall;-1;-4;0;Stadt Konstanz, Amt für Stadtplanung und Umwelt
11.01.2022 09:00;597;343;254;Leichter Schneefall;-2;-5;0;Stadt Konstanz, Amt für Stadtplanung und Umwelt
11.01.2022 10:00;356;203;153;Leichter Schneefall;-1;-3;0;Stadt Konstanz, Amt für Stadtplanung und Umwelt
11.01.2022 11:00;521;248;273;Stellenweise leichter Schneefall;1;-2;0;Stadt Konstanz, Amt für Stadtplanung und Umwelt
11.01.2022 12:00;543;200;343;Stellenweise leichter Schneefall;2;-1;0;Stadt Konstanz, Amt für Stadtplanung und Umwelt
11.01.2022 13:00;706;332;374;Stellenweise leichter Schneefall;2;-1;0;Stadt Konstanz, Amt für Stadtplanung und Umwelt
11.01.2022 14:00;471;227;244;Sonnig;3;0;0;Stadt Konstanz, Amt für Stadtplanung und Umwelt
11.01.2022 15:00;708;361;347;Sonnig;3;0;0;Stadt Konstanz, Amt für Stadtplanung und Umwelt
11.01.2022 16:00;678;322;356;Sonnig;2;-1;0;Stadt Konstanz, Amt für Stadtplanung und Umwelt
11.01.2022 17:00;811;353;458;Sonnig;2;-2;0;Stadt Konstanz, Amt für Stadtplanung und Umwelt
11.01.2022 18:00;608;283;325;Sonnig;1;-3;0;Stadt Konstanz, Amt für Stadtplanung und Umwelt
11.01.2022 19:00;394;174;220;Sonnig;-1;-5;0;Stadt Konstanz, Amt für Stadtplanung und Umwelt
11.01.2022 20:00;267;122;145;Sonnig;-3;-6;0;Stadt Konstanz, Amt für Stadtplanung und Umwelt
11.01.2022 21:00;164;87;77;Sonnig;-4;-8;0;Stadt Konstanz, Amt für Stadtplanung und Umwelt
11.01.2022 22:00;143;67;76;Sonnig;-4;-8;0;Stadt Konstanz, Amt für Stadtplanung und Umwelt
11.01.2022 23:00;70;30;40;Sonnig;-4;-8;0;Stadt Konstanz, Amt für Stadtplanung und Umwelt
12.01.2022 00:00;19;9;10;Sonnig;-4;-8;0;Stadt Konstanz, Amt für Stadtplanung und Umwelt
12.01.2022 01:00;20;7;13;Sonnig;-5;-9;0;Stadt Konstanz, Amt für Stadtplanung und Umwelt
12.01.2022 02:00;3;2;1;Sonnig;-6;-10;0;Stadt Konstanz, Amt für Stadtplanung und Umwelt
12.01.2022 03:00;4;3;1;Sonnig;-7;-11;0;Stadt Konstanz, Amt für Stadtplanung und Umwelt
12.01.2022 04:00;3;2;1;Sonnig;-7;-11;0;Stadt Konstanz, Amt für Stadtplanung und Umwelt
12.01.2022 05:00;41;22;19;Sonnig;-8;-11;0;Stadt Konstanz, Amt für Stadtplanung und Umwelt
12.01.2022 06:00;165;91;74;Sonnig;-8;-11;0;Stadt Konstanz, Amt für Stadtplanung und Umwelt
12.01.2022 07:00;694;486;208;Sonnig;-8;-10;0;Stadt Konstanz, Amt für Stadtplanung und Umwelt
12.01.2022 08:00;602;356;246;Sonnig;-8;-9;0;Stadt Konstanz, Amt für Stadtplanung und Umwelt
12.01.2022 09:00;540;313;227;Sonnig;-7;-9;0;Stadt Konstanz, Amt für Stadtplanung und Umwelt
12.01.2022 10:00;338;168;170;Sonnig;-5;-7;0;Stadt Konstanz, Amt für Stadtplanung und Umwelt
12.01.2022 11:00;432;213;219;Sonnig;-3;-6;0;Stadt Konstanz, Amt für Stadtplanung und Umwelt
12.01.2022 12:00;474;203;271;Sonnig;-1;-4;0;Stadt Konstanz, Amt für Stadtplanung und Umwelt
12.01.2022 13:00;687;280;407;Sonnig;0;-3;0;Stadt Konstanz, Amt für Stadtplanung und Umwelt
12.01.2022 14:00;479;238;241;Sonnig;0;-2;0;Stadt Konstanz, Amt für Stadtplanung und Umwelt
12.01.2022 15:00;743;299;444;Sonnig;1;-2;0;Stadt Konstanz, Amt für Stadtplanung und Umwelt
12.01.2022 16:00;657;295;362;Sonnig;-1;-4;0;Stadt Konstanz, Amt für Stadtplanung und Umwelt
12.01.2022 17:00;758;362;396;Sonnig;-3;-6;0;Stadt Konstanz, Amt für Stadtplanung und Umwelt
12.01.2022 18:00;561;252;309;Sonnig;-5;-8;0;Stadt Konstanz, Amt für Stadtplanung und Umwelt
12.01.2022 19:00;397;177;220;Sonnig;-6;-8;0;Stadt Konstanz, Amt für Stadtplanung und Umwelt
12.01.2022 20:00;282;133;149;Sonnig;-7;-9;0;Stadt Konstanz, Amt für Stadtplanung und Umwelt
12.01.2022 21:00;173;74;99;Sonnig;-7;-9;0;Stadt Konstanz, Amt für Stadtplanung und Umwelt
12.01.2022 22:00;161;70;91;Sonnig;-6;-8;0;Stadt Konstanz, Amt für Stadtplanung und Umwelt
12.01.2022 23:00;59;19;40;Sonnig;-6;-7;0;Stadt Konstanz, Amt für Stadtplanung und Umwelt
13.01.2022 00:00;30;13;17;Sonnig;-5;-7;0;Stadt Konstanz, Amt für Stadtplanung und Umwelt
13.01.2022 01:00;9;3;6;Sonnig;-5;-7;0;Stadt Konstanz, Amt für Stadtplanung und Umwelt
13.01.2022 02:00;9;1;8;Sonnig;-5;-7;0;Stadt Konstanz, Amt für Stadtplanung und Umwelt
13.01.2022 03:00;4;3;1;Sonnig;-5;-7;0;Stadt Konstanz, Amt für Stadtplanung und Umwelt
13.01.2022 04:00;5;4;1;Sonnig;-5;-7;0;Stadt Konstanz, Amt für Stadtplanung und Umwelt
13.01.2022 05:00;34;22;12;Sonnig;-5;-8;0;Stadt Konstanz, Amt für Stadtplanung und Umwelt
13.01.2022 06:00;128;69;59;Sonnig;-5;-8;0;Stadt Konstanz, Amt für Stadtplanung und Umwelt
13.01.2022 07:00;827;534;293;Sonnig;-5;-7;0;Stadt Konstanz, Amt für Stadtplanung und Umwelt
13.01.2022 08:00;627;348;279;Sonnig;-5;-7;0;Stadt Konstanz, Amt für Stadtplanung und Umwelt
13.01.2022 09:00;539;280;259;Sonnig;-5;-6;0;Stadt Konstanz, Amt für Stadtplanung und Umwelt
13.01.2022 10:00;312;178;134;Sonnig;-3;-4;0;Stadt Konstanz, Amt für Stadtplanung und Umwelt
13.01.2022 11:00;444;222;222;Sonnig;0;-2;0;Stadt Konstanz, Amt für Stadtplanung und Umwelt
13.01.2022 12:00;477;211;266;Sonnig;2;1;0;Stadt Konstanz, Amt für Stadtplanung und Umwelt
13.01.2022 13:00;710;316;394;Sonnig;3;2;0;Stadt Konstanz, Amt für Stadtplanung und Umwelt
13.01.2022 14:00;514;239;275;Sonnig;4;4;0;Stadt Konstanz, Amt für Stadtplanung und Umwelt
13.01.2022 15:00;763;357;406;Sonnig;5;5;0;Stadt Konstanz, Amt für Stadtplanung und Umwelt
13.01.2022 16:00;708;324;384;Sonnig;4;3;0;Stadt Konstanz, Amt für Stadtplanung und Umwelt
13.01.2022 17:00;796;350;446;Sonnig;2;2;0;Stadt Konstanz, Amt für Stadtplanung und Umwelt
13.01.2022 18:00;585;257;328;Sonnig;0;0;0;Stadt Konstanz, Amt für Stadtplanung und Umwelt
13.01.2022 19:00;398;172;226;Sonnig;-1;-1;0;Stadt Konstanz, Amt für Stadtplanung und Umwelt
13.01.2022 20:00;298;149;149;Sonnig;-2;-2;0;Stadt Konstanz, Amt für Stadtplanung und Umwelt
13.01.2022 21:00;148;59;89;Sonnig;-4;-4;0;Stadt Konstanz, Amt für Stadtplanung und Umwelt
13.01.2022 22:00;152;69;83;Sonnig;-3;-3;0;Stadt Konstanz, Amt für Stadtplanung und Umwelt
13.01.2022 23:00;72;24;48;Sonnig;-3;-3;0;Stadt Konstanz, Amt für Stadtplanung und Umwelt
14.01.2022 00:00;29;12;17;Sonnig;-3;-3;0;Stadt Konstanz, Amt für Stadtplanung und Umwelt
14.01.2022 01:00;20;14;6;Sonnig;-3;-3;0;Stadt Konstanz, Amt für Stadtplanung und Umwelt
14.01.2022 02:00;11;4;7;Sonnig;-3;-3;0;Stadt Konstanz, Amt für Stadtplanung und Umwelt
14.01.2022 03:00;3;0;3;Sonnig;-3;-3;0;Stadt Konstanz, Amt für Stadtplanung und Umwelt
14.01.2022 04:00;10;7;3;Sonnig;-3;-3;0;Stadt Konstanz, Amt für Stadtplanung und Umwelt
14.01.2022 05:00;30;21;9;Sonnig;-3;-3;0;Stadt Konstanz, Amt für Stadtplanung und Umwelt
14.01.2022 06:00;120;64;56;Sonnig;-3;-3;0;Stadt Konstanz, Amt für Stadtplanung und Umwelt
14.01.2022 07:00;796;474;322;Sonnig;-3;-3;0;Stadt Konstanz, Amt für Stadtplanung und Umwelt
14.01.2022 08:00;560;286;274;Sonnig;-3;-3;0;Stadt Konstanz, Amt für Stadtplanung und Umwelt
14.01.2022 09:00;548;318;230;Sonnig;-2;-2;0;Stadt Konstanz, Amt für Stadtplanung und Umwelt
14.01.2022 10:00;361;207;154;Sonnig;0;0;0;Stadt Konstanz, Amt für Stadtplanung und Umwelt
14.01.2022 11:00;478;234;244;Sonnig;3;3;0;Stadt Konstanz, Amt für Stadtplanung und Umwelt
14.01.2022 12:00;635;294;341;Sonnig;6;6;0;Stadt Konstanz, Amt für Stadtplanung und Umwelt
14.01.2022 13:00;826;323;503;Sonnig;6;6;0;Stadt Konstanz, Amt für Stadtplanung und Umwelt
14.01.2022 14:00;549;272;277;Sonnig;6;6;0;Stadt Konstanz, Amt für Stadtplanung und Umwelt
14.01.2022 15:00;638;287;351;Sonnig;6;6;0;Stadt Konstanz, Amt für Stadtplanung und Umwelt
14.01.2022 16:00;606;275;331;Sonnig;5;5;0;Stadt Konstanz, Amt für Stadtplanung und Umwelt
14.01.2022 17:00;561;254;307;Sonnig;4;4;0;Stadt Konstanz, Amt für Stadtplanung und Umwelt
14.01.2022 18:00;489;239;250;Sonnig;2;2;0;Stadt Konstanz, Amt für Stadtplanung und Umwelt
14.01.2022 19:00;387;192;195;Sonnig;1;1;0;Stadt Konstanz, Amt für Stadtplanung und Umwelt
14.01.2022 20:00;253;130;123;Sonnig;0;0;0;Stadt Konstanz, Amt für Stadtplanung und Umwelt
14.01.2022 21:00;160;68;92;Sonnig;-1;-1;0;Stadt Konstanz, Amt für Stadtplanung und Umwelt
14.01.2022 22:00;180;59;121;Sonnig;-1;-2;0;Stadt Konstanz, Amt für Stadtplanung und Umwelt
14.01.2022 23:00;109;37;72;Sonnig;-2;-3;0;Stadt Konstanz, Amt für Stadtplanung und Umwelt
15.01.2022 00:00;72;31;41;Sonnig;-2;-3;0;Stadt Konstanz, Amt für Stadtplanung und Umwelt
15.01.2022 01:00;68;33;35;Sonnig;-2;-3;0;Stadt Konstanz, Amt für Stadtplanung und Umwelt
15.01.2022 02:00;50;23;27;Sonnig;-2;-4;0;Stadt Konstanz, Amt für Stadtplanung und Umwelt
15.01.2022 03:00;18;9;9;Sonnig;-2;-4;0;Stadt Konstanz, Amt für Stadtplanung und Umwelt
15.01.2022 04:00;14;10;4;Sonnig;-2;-4;0;Stadt Konstanz, Amt für Stadtplanung und Umwelt
15.01.2022 05:00;22;12;10;Sonnig;-3;-4;0;Stadt Konstanz, Amt für Stadtplanung und Umwelt
15.01.2022 06:00;51;33;18;Sonnig;-3;-4;0;Stadt Konstanz, Amt für Stadtplanung und Umwelt
15.01.2022 07:00;53;24;29;Sonnig;-3;-4;0;Stadt Konstanz, Amt für Stadtplanung und Umwelt
15.01.2022 08:00;109;60;49;Sonnig;-2;-4;0;Stadt Konstanz, Amt für Stadtplanung und Umwelt
15.01.2022 09:00;213;125;88;Sonnig;-2;-4;0;Stadt Konstanz, Amt für Stadtplanung und Umwelt
15.01.2022 10:00;310;178;132;Sonnig;0;-1;0;Stadt Konstanz, Amt für Stadtplanung und Umwelt
15.01.2022 11:00;278;156;122;Sonnig;3;2;0;Stadt Konstanz, Amt für Stadtplanung und Umwelt
15.01.2022 12:00;328;174;154;Sonnig;6;4;0;Stadt Konstanz, Amt für Stadtplanung und Umwelt
15.01.2022 13:00;345;176;169;Sonnig;6;6;0;Stadt Konstanz, Amt für Stadtplanung und Umwelt
15.01.2022 14:00;386;179;207;Sonnig;7;7;0;Stadt Konstanz, Amt für Stadtplanung und Umwelt
15.01.2022 15:00;384;188;196;Sonnig;8;8;0;Stadt Konstanz, Amt für Stadtplanung und Umwelt
15.01.2022 16:00;350;161;189;Sonnig;5;5;0;Stadt Konstanz, Amt für Stadtplanung und Umwelt
15.01.2022 17:00;403;190;213;Sonnig;3;3;0;Stadt Konstanz, Amt für Stadtplanung und Umwelt
15.01.2022 18:00;316;135;181;Sonnig;1;1;0;Stadt Konstanz, Amt für Stadtplanung und Umwelt
15.01.2022 19:00;233;123;110;Sonnig;0;0;0;Stadt Konstanz, Amt für Stadtplanung und Umwelt
15.01.2022 20:00;167;83;84;Sonnig;-1;-1;0;Stadt Konstanz, Amt für Stadtplanung und Umwelt
15.01.2022 21:00;111;51;60;Sonnig;-2;-2;0;Stadt Konstanz, Amt für Stadtplanung und Umwelt
15.01.2022 22:00;144;56;88;Sonnig;-2;-2;0;Stadt Konstanz, Amt für Stadtplanung und Umwelt
15.01.2022 23:00;98;31;67;Leichter Nebel;-3;-3;0;Stadt Konstanz, Amt für Stadtplanung und Umwelt
16.01.2022 00:00;71;30;41;Leichter Nebel;-3;-3;0;Stadt Konstanz, Amt für Stadtplanung und Umwelt
16.01.2022 01:00;53;23;30;Leichter Nebel;-3;-4;0;Stadt Konstanz, Amt für Stadtplanung und Umwelt
16.01.2022 02:00;38;15;23;Leichter Nebel;-3;-4;0;Stadt Konstanz, Amt für Stadtplanung und Umwelt
16.01.2022 03:00;23;10;13;Leichter Nebel;-4;-5;0;Stadt Konstanz, Amt für Stadtplanung und Umwelt
16.01.2022 04:00;22;15;7;Leichter Nebel;-4;-5;0;Stadt Konstanz, Amt für Stadtplanung und Umwelt
16.01.2022 05:00;24;9;15;Leichter Nebel;-4;-5;0;Stadt Konstanz, Amt für Stadtplanung und Umwelt
16.01.2022 06:00;37;27;10;Leichter Nebel;-4;-5;0;Stadt Konstanz, Amt für Stadtplanung und Umwelt
16.01.2022 07:00;28;10;18;Leichter Nebel;-3;-4;0;Stadt Konstanz, Amt für Stadtplanung und Umwelt
16.01.2022 08:00;49;31;18;Sonnig;-2;-4;0;Stadt Konstanz, Amt für Stadtplanung und Umwelt
16.01.2022 09:00;116;53;63;Sonnig;-2;-3;0;Stadt Konstanz, Amt für Stadtplanung und Umwelt
16.01.2022 10:00;153;76;77;Sonnig;0;-1;0;Stadt Konstanz, Amt für Stadtplanung und Umwelt
16.01.2022 11:00;203;93;110;Sonnig;2;1;0;Stadt Konstanz, Amt für Stadtplanung und Umwelt
16.01.2022 12:00;222;102;120;Sonnig;4;3;0;Stadt Konstanz, Amt für Stadtplanung und Umwelt
16.01.2022 13:00;247;122;125;Sonnig;5;3;0;Stadt Konstanz, Amt für Stadtplanung und Umwelt
16.01.2022 14:00;250;123;127;Sonnig;5;4;0;Stadt Konstanz, Amt für Stadtplanung und Umwelt
16.01.2022 15:00;260;135;125;Sonnig;5;4;0;Stadt Konstanz, Amt für Stadtplanung und Umwelt
16.01.2022 16:00;268;117;151;Sonnig;4;3;0;Stadt Konstanz, Amt für Stadtplanung und Umwelt
16.01.2022 17:00;235;109;126;Sonnig;3;1;0;Stadt Konstanz, Amt für Stadtplanung und Umwelt
16.01.2022 18:00;177;78;99;Sonnig;1;0;0;Stadt Konstanz, Amt für Stadtplanung und Umwelt
16.01.2022 19:00;164;71;93;Sonnig;1;0;0;Stadt Konstanz, Amt für Stadtplanung und Umwelt
16.01.2022 20:00;125;61;64;Sonnig;0;-1;0;Stadt Konstanz, Amt für Stadtplanung und Umwelt
16.01.2022 21:00;65;35;30;Sonnig;-1;-1;0;Stadt Konstanz, Amt für Stadtplanung und Umwelt
16.01.2022 22:00;87;40;47;Sonnig;0;-1;0;Stadt Konstanz, Amt für Stadtplanung und Umwelt
16.01.2022 23:00;34;18;16;Leicht bewoelkt;0;-1;0;Stadt Konstanz, Amt für Stadtplanung und Umwelt
17.01.2022 00:00;16;7;9;Leicht bewoelkt;0;-1;0;Stadt Konstanz, Amt für Stadtplanung und Umwelt
17.01.2022 01:00;5;4;1;Leicht bewoelkt;0;-1;0;Stadt Konstanz, Amt für Stadtplanung und Umwelt
17.01.2022 02:00;4;2;2;Bedeckt;0;-1;0;Stadt Konstanz, Amt für Stadtplanung und Umwelt
17.01.2022 03:00;1;0;1;Bedeckt;0;-1;0;Stadt Konstanz, Amt für Stadtplanung und Umwelt
17.01.2022 04:00;6;3;3;Bedeckt;0;-2;0;Stadt Konstanz, Amt für Stadtplanung und Umwelt
17.01.2022 05:00;31;16;15;Leichter Schneefall;0;-2;0;Stadt Konstanz, Amt für Stadtplanung und Umwelt
17.01.2022 06:00;140;81;59;Leichter Schneefall;0;-2;0;Stadt Konstanz, Amt für Stadtplanung und Umwelt
17.01.2022 07:00;839;503;336;Leichter Schneefall;0;-2;0;Stadt Konstanz, Amt für Stadtplanung und Umwelt
17.01.2022 08:00;616;335;281;Leicht bewoelkt;0;-1;0;Stadt Konstanz, Amt für Stadtplanung und Umwelt
17.01.2022 09:00;533;297;236;Leicht bewoelkt;0;-1;0;Stadt Konstanz, Amt für Stadtplanung und Umwelt
17.01.2022 10:00;324;164;160;Leicht bewoelkt;2;0;0;Stadt Konstanz, Amt für Stadtplanung und Umwelt
17.01.2022 11:00;430;192;238;Leicht bewoelkt;3;2;0;Stadt Konstanz, Amt für Stadtplanung und Umwelt
17.01.2022 12:00;461;206;255;Leicht bewoelkt;4;3;0;Stadt Konstanz, Amt für Stadtplanung und Umwelt
17.01.2022 13:00;757;352;405;Leicht bewoelkt;4;3;0;Stadt Konstanz, Amt für Stadtplanung und Umwelt
17.01.2022 14:00;497;249;248;Leicht bewoelkt;5;4;0;Stadt Konstanz, Amt für Stadtplanung und Umwelt
17.01.2022 15:00;726;325;401;Leicht bewoelkt;5;4;0;Stadt Konstanz, Amt für Stadtplanung und Umwelt
17.01.2022 16:00;638;287;351;Leicht bewoelkt;4;3;0;Stadt Konstanz, Amt für Stadtplanung und Umwelt
17.01.2022 17:00;805;338;467;Sonnig;2;2;0;Stadt Konstanz, Amt für Stadtplanung und Umwelt
17.01.2022 18:00;582;273;309;Sonnig;1;1;0;Stadt Konstanz, Amt für Stadtplanung und Umwelt
17.01.2022 19:00;365;136;229;Sonnig;1;1;0;Stadt Konstanz, Amt für Stadtplanung und Umwelt
17.01.2022 20:00;279;130;149;Bewoelkt;0;0;0;Stadt Konstanz, Amt für Stadtplanung und Umwelt
17.01.2022 21:00;136;60;76;Bewoelkt;0;0;0;Stadt Konstanz, Amt für Stadtplanung und Umwelt
17.01.2022 22:00;132;66;66;Bewoelkt;0;0;0;Stadt Konstanz, Amt für Stadtplanung und Umwelt
17.01.2022 23:00;60;24;36;Leicht bewoelkt;-1;-1;0;Stadt Konstanz, Amt für Stadtplanung und Umwelt
18.01.2022 00:00;25;14;11;Leicht bewoelkt;-1;-1;0;Stadt Konstanz, Amt für Stadtplanung und Umwelt
18.01.2022 01:00;10;3;7;Leicht bewoelkt;-1;-1;0;Stadt Konstanz, Amt für Stadtplanung und Umwelt
18.01.2022 02:00;6;4;2;Leicht bewoelkt;-1;-2;0;Stadt Konstanz, Amt für Stadtplanung und Umwelt
18.01.2022 03:00;3;2;1;Leicht bewoelkt;-1;-3;0;Stadt Konstanz, Amt für Stadtplanung und Umwelt
18.01.2022 04:00;8;7;1;Leicht bewoelkt;-1;-2;0;Stadt Konstanz, Amt für Stadtplanung und Umwelt
18.01.2022 05:00;35;20;15;Bewoelkt;0;-2;0;Stadt Konstanz, Amt für Stadtplanung und Umwelt
18.01.2022 06:00;139;74;65;Bewoelkt;0;-2;0;Stadt Konstanz, Amt für Stadtplanung und Umwelt
18.01.2022 07:00;822;496;326;Bewoelkt;0;-2;0;Stadt Konstanz, Amt für Stadtplanung und Umwelt
18.01.2022 08:00;678;339;339;Sonnig;0;-1;0;Stadt Konstanz, Amt für Stadtplanung und Umwelt
18.01.2022 09:00;543;319;224;Sonnig;0;-1;0;Stadt Konstanz, Amt für Stadtplanung und Umwelt
18.01.2022 10:00;402;230;172;Sonnig;2;0;0;Stadt Konstanz, Amt für Stadtplanung und Umwelt
18.01.2022 11:00;471;238;233;Sonnig;4;1;0;Stadt Konstanz, Amt für Stadtplanung und Umwelt
18.01.2022 12:00;521;199;322;Sonnig;5;2;0;Stadt Konstanz, Amt für Stadtplanung und Umwelt
18.01.2022 13:00;760;362;398;Sonnig;5;2;0;Stadt Konstanz, Amt für Stadtplanung und Umwelt
18.01.2022 14:00;513;249;264;Leicht bewoelkt;5;2;0;Stadt Konstanz, Amt für Stadtplanung und Umwelt
18.01.2022 15:00;742;324;418;Leicht bewoelkt;5;1;0;Stadt Konstanz, Amt für Stadtplanung und Umwelt
18.01.2022 16:00;721;309;412;Leicht bewoelkt;4;0;0;Stadt Konstanz, Amt für Stadtplanung und Umwelt
18.01.2022 17:00;783;325;458;Sonnig;3;-1;0;Stadt Konstanz, Amt für Stadtplanung und Umwelt
18.01.2022 18:00;572;239;333;Sonnig;1;-3;0;Stadt Konstanz, Amt für Stadtplanung und Umwelt
18.01.2022 19:00;437;200;237;Sonnig;0;-3;0;Stadt Konstanz, Amt für Stadtplanung und Umwelt
18.01.2022 20:00;260;126;134;Sonnig;-1;-4;0;Stadt Konstanz, Amt für Stadtplanung und Umwelt
18.01.2022 21:00;173;74;99;Sonnig;-2;-5;0;Stadt Konstanz, Amt für Stadtplanung und Umwelt
18.01.2022 22:00;144;73;71;Sonnig;-2;-5;0;Stadt Konstanz, Amt für Stadtplanung und Umwelt
18.01.2022 23:00;69;23;46;Leichter Nebel;-3;-5;0;Stadt Konstanz, Amt für Stadtplanung und Umwelt
19.01.2022 00:00;39;15;24;Leichter Nebel;-3;-5;0;Stadt Konstanz, Amt für Stadtplanung und Umwelt
19.01.2022 01:00;8;3;5;Leichter Nebel;-3;-4;0;Stadt Konstanz, Amt für Stadtplanung und Umwelt
19.01.2022 02:00;5;2;3;Bewoelkt;-3;-4;0;Stadt Konstanz, Amt für Stadtplanung und Umwelt
19.01.2022 03:00;4;3;1;Bewoelkt;-3;-3;0;Stadt Konstanz, Amt für Stadtplanung und Umwelt
19.01.2022 04:00;5;4;1;Bewoelkt;-3;-3;0;Stadt Konstanz, Amt für Stadtplanung und Umwelt
19.01.2022 05:00;34;21;13;Bewoelkt;-3;-3;0;Stadt Konstanz, Amt für Stadtplanung und Umwelt
19.01.2022 06:00;139;65;74;Bewoelkt;-3;-3;0;Stadt Konstanz, Amt für Stadtplanung und Umwelt
19.01.2022 07:00;827;506;321;Bewoelkt;-2;-3;0;Stadt Konstanz, Amt für Stadtplanung und Umwelt
19.01.2022 08:00;649;356;293;Sonnig;-2;-2;0;Stadt Konstanz, Amt für Stadtplanung und Umwelt
19.01.2022 09:00;583;327;256;Sonnig;-1;-2;0;Stadt Konstanz, Amt für Stadtplanung und Umwelt
19.01.2022 10:00;335;176;159;Sonnig;1;0;0;Stadt Konstanz, Amt für Stadtplanung und Umwelt
19.01.2022 11:00;469;225;244;Sonnig;3;2;0;Stadt Konstanz, Amt für Stadtplanung und Umwelt
19.01.2022 12:00;585;258;327;Sonnig;5;3;0;Stadt Konstanz, Amt für Stadtplanung und Umwelt
19.01.2022 13:00;810;367;443;Sonnig;5;4;0;Stadt Konstanz, Amt für Stadtplanung und Umwelt
19.01.2022 14:00;513;257;256;Sonnig;6;5;0;Stadt Konstanz, Amt für Stadtplanung und Umwelt
19.01.2022 15:00;767;334;433;Sonnig;7;5;0;Stadt Konstanz, Amt für Stadtplanung und Umwelt
19.01.2022 16:00;698;316;382;Sonnig;4;3;0;Stadt Konstanz, Amt für Stadtplanung und Umwelt
19.01.2022 17:00;753;343;410;Sonnig;2;0;0;Stadt Konstanz, Amt für Stadtplanung und Umwelt
19.01.2022 18:00;576;250;326;Sonnig;0;-2;0;Stadt Konstanz, Amt für Stadtplanung und Umwelt
19.01.2022 19:00;403;169;234;Sonnig;0;-2;0;Stadt Konstanz, Amt für Stadtplanung und Umwelt
19.01.2022 20:00;308;127;181;Bedeckt;0;-2;0;Stadt Konstanz, Amt für Stadtplanung und Umwelt
19.01.2022 21:00;163;71;92;Bedeckt;1;-2;0;Stadt Konstanz, Amt für Stadtplanung und Umwelt
19.01.2022 22:00;171;77;94;Bedeckt;1;-2;0;Stadt Konstanz, Amt für Stadtplanung und Umwelt
19.01.2022 23:00;89;36;53;Leichter Schneefall;2;-2;0;Stadt Konstanz, Amt für Stadtplanung und Umwelt
20.01.2022 00:00;29;17;12;Leichter Schneefall;2;-3;0;Stadt Konstanz, Amt für Stadtplanung und Umwelt
20.01.2022 01:00;13;6;7;Leichter Schneefall;2;-3;0;Stadt Konstanz, Amt für Stadtplanung und Umwelt
20.01.2022 02:00;5;2;3;Bedeckt;1;-3;0;Stadt Konstanz, Amt für Stadtplanung und Umwelt
20.01.2022 03:00;2;1;1;Bedeckt;1;-4;0;Stadt Konstanz, Amt für Stadtplanung und Umwelt
20.01.2022 04:00;9;6;3;Bedeckt;1;-3;0;Stadt Konstanz, Amt für Stadtplanung und Umwelt
20.01.2022 05:00;40;26;14;Starker Schneefall;2;-3;0.2;Stadt Konstanz, Amt für Stadtplanung und Umwelt
20.01.2022 06:00;122;63;59;Starker Schneefall;2;-3;0.2;Stadt Konstanz, Amt für Stadtplanung und Umwelt
20.01.2022 07:00;724;458;266;Starker Schneefall;2;-3;0.1;Stadt Konstanz, Amt für Stadtplanung und Umwelt
20.01.2022 08:00;589;293;296;Bedeckt;2;-3;0;Stadt Konstanz, Amt für Stadtplanung und Umwelt
20.01.2022 09:00;539;288;251;Bedeckt;2;-3;0;Stadt Konstanz, Amt für Stadtplanung und Umwelt
20.01.2022 10:00;308;177;131;Bedeckt;2;-2;0;Stadt Konstanz, Amt für Stadtplanung und Umwelt
20.01.2022 11:00;370;174;196;Maessige bis starke Schneefaelle;2;-2;0.1;Stadt Konstanz, Amt für Stadtplanung und Umwelt
20.01.2022 12:00;478;209;269;Maessige bis starke Schneefaelle;3;-2;0.1;Stadt Konstanz, Amt für Stadtplanung und Umwelt
20.01.2022 13:00;700;343;357;Maessige bis starke Schneefaelle;2;-2;0;Stadt Konstanz, Amt für Stadtplanung und Umwelt
20.01.2022 14:00;457;212;245;Starker Schneefall;2;-2;0.1;Stadt Konstanz, Amt für Stadtplanung und Umwelt
20.01.2022 15:00;703;312;391;Starker Schneefall;2;-2;0.1;Stadt Konstanz, Amt für Stadtplanung und Umwelt
20.01.2022 16:00;636;305;331;Starker Schneefall;0;-3;0.1;Stadt Konstanz, Amt für Stadtplanung und Umwelt
20.01.2022 17:00;845;356;489;Stellenweiser Schneefall;-1;-4;0.1;Stadt Konstanz, Amt für Stadtplanung und Umwelt
20.01.2022 18:00;560;257;303;Stellenweiser Schneefall;-2;-5;0.1;Stadt Konstanz, Amt für Stadtplanung und Umwelt
20.01.2022 19:00;406;177;229;Stellenweiser Schneefall;-3;-5;0;Stadt Konstanz, Amt für Stadtplanung und Umwelt
20.01.2022 20:00;253;110;143;Sonnig;-3;-6;0;Stadt Konstanz, Amt für Stadtplanung und Umwelt
20.01.2022 21:00;151;64;87;Sonnig;-4;-7;0;Stadt Konstanz, Amt für Stadtplanung und Umwelt
20.01.2022 22:00;165;72;93;Sonnig;-4;-7;0;Stadt Konstanz, Amt für Stadtplanung und Umwelt
20.01.2022 23:00;73;28;45;Leichte Schneeschauer;-4;-7;0;Stadt Konstanz, Amt für Stadtplanung und Umwelt
21.01.2022 00:00;51;30;21;Leichte Schneeschauer;-4;-7;0;Stadt Konstanz, Amt für Stadtplanung und Umwelt
21.01.2022 01:00;21;13;8;Leichte Schneeschauer;-5;-6;0;Stadt Konstanz, Amt für Stadtplanung und Umwelt
21.01.2022 02:00;11;7;4;Leicht bewoelkt;-5;-6;0;Stadt Konstanz, Amt für Stadtplanung und Umwelt
21.01.2022 03:00;20;6;14;Leicht bewoelkt;-5;-6;0;Stadt Konstanz, Amt für Stadtplanung und Umwelt
21.01.2022 04:00;6;2;4;Leicht bewoelkt;-5;-6;0;Stadt Konstanz, Amt für Stadtplanung und Umwelt
21.01.2022 05:00;25;16;9;Leicht bewoelkt;-6;-6;0;Stadt Konstanz, Amt für Stadtplanung und Umwelt
21.01.2022 06:00;111;69;42;Leicht bewoelkt;-6;-6;0;Stadt Konstanz, Amt für Stadtplanung und Umwelt
21.01.2022 07:00;694;430;264;Leicht bewoelkt;-6;-6;0;Stadt Konstanz, Amt für Stadtplanung und Umwelt
21.01.2022 08:00;517;265;252;Leicht bewoelkt;-5;-5;0;Stadt Konstanz, Amt für Stadtplanung und Umwelt
21.01.2022 09:00;542;301;241;Leicht bewoelkt;-4;-4;0;Stadt Konstanz, Amt für Stadtplanung und Umwelt
21.01.2022 10:00;355;206;149;Leicht bewoelkt;-3;-3;0;Stadt Konstanz, Amt für Stadtplanung und Umwelt
21.01.2022 11:00;460;245;215;Sonnig;-2;-2;0;Stadt Konstanz, Amt für Stadtplanung und Umwelt
21.01.2022 12:00;566;246;320;Sonnig;0;-2;0;Stadt Konstanz, Amt für Stadtplanung und Umwelt
21.01.2022 13:00;766;293;473;Sonnig;0;-2;0;Stadt Konstanz, Amt für Stadtplanung und Umwelt
21.01.2022 14:00;517;240;277;Sonnig;0;-2;0;Stadt Konstanz, Amt für Stadtplanung und Umwelt
21.01.2022 15:00;528;242;286;Sonnig;1;-2;0;Stadt Konstanz, Amt für Stadtplanung und Umwelt
21.01.2022 16:00;547;254;293;Sonnig;-1;-3;0;Stadt Konstanz, Amt für Stadtplanung und Umwelt
21.01.2022 17:00;547;263;284;Leicht bewoelkt;-2;-4;0;Stadt Konstanz, Amt für Stadtplanung und Umwelt
21.01.2022 18:00;436;206;230;Leicht bewoelkt;-3;-5;0;Stadt Konstanz, Amt für Stadtplanung und Umwelt
21.01.2022 19:00;391;206;185;Leicht bewoelkt;-3;-5;0;Stadt Konstanz, Amt für Stadtplanung und Umwelt
21.01.2022 20:00;252;122;130;Leicht bewoelkt;-3;-5;0;Stadt Konstanz, Amt für Stadtplanung und Umwelt
21.01.2022 21:00;172;93;79;Leicht bewoelkt;-3;-5;0;Stadt Konstanz, Amt für Stadtplanung und Umwelt
21.01.2022 22:00;177;60;117;Leicht bewoelkt;-3;-5;0;Stadt Konstanz, Amt für Stadtplanung und Umwelt
21.01.2022 23:00;129;50;79;Leicht bewoelkt;-4;-6;0;Stadt Konstanz, Amt für Stadtplanung und Umwelt
22.01.2022 00:00;75;27;48;Leicht bewoelkt;-4;-6;0;Stadt Konstanz, Amt für Stadtplanung und Umwelt
22.01.2022 01:00;67;29;38;Leicht bewoelkt;-4;-6;0;Stadt Konstanz, Amt für Stadtplanung und Umwelt
22.01.2022 02:00;42;21;21;Bewoelkt;-4;-6;0;Stadt Konstanz, Amt für Stadtplanung und Umwelt
22.01.2022 03:00;21;10;11;Bewoelkt;-3;-6;0;Stadt Konstanz, Amt für Stadtplanung und Umwelt
22.01.2022 04:00;17;8;9;Bewoelkt;-3;-6;0;Stadt Konstanz, Amt für Stadtplanung und Umwelt
22.01.2022 05:00;24;17;7;Leicht bewoelkt;-3;-6;0;Stadt Konstanz, Amt für Stadtplanung und Umwelt
22.01.2022 06:00;35;25;10;Leicht bewoelkt;-3;-5;0;Stadt Konstanz, Amt für Stadtplanung und Umwelt
22.01.2022 07:00;41;22;19;Leicht bewoelkt;-3;-5;0;Stadt Konstanz, Amt für Stadtplanung und Umwelt
22.01.2022 08:00;108;59;49;Bedeckt;-2;-5;0;Stadt Konstanz, Amt für Stadtplanung und Umwelt
22.01.2022 09:00;230;134;96;Bedeckt;-2;-4;0;Stadt Konstanz, Amt für Stadtplanung und Umwelt
22.01.2022 10:00;296;139;157;Bedeckt;-1;-4;0;Stadt Konstanz, Amt für Stadtplanung und Umwelt
22.01.2022 11:00;310;180;130;Starker Schneefall;-1;-4;0.1;Stadt Konstanz, Amt für Stadtplanung und Umwelt
22.01.2022 12:00;324;174;150;Starker Schneefall;0;-3;0.1;Stadt Konstanz, Amt für Stadtplanung und Umwelt
22.01.2022 13:00;310;153;157;Starker Schneefall;0;-2;0.1;Stadt Konstanz, Amt für Stadtplanung und Umwelt
22.01.2022 14:00;369;174;195;Starker Schneefall;1;-2;0.2;Stadt Konstanz, Amt für Stadtplanung und Umwelt
22.01.2022 15:00;325;150;175;Starker Schneefall;1;-1;0.3;Stadt Konstanz, Amt für Stadtplanung und Umwelt
22.01.2022 16:00;360;150;210;Starker Schneefall;1;-1;0.1;Stadt Konstanz, Amt für Stadtplanung und Umwelt
22.01.2022 17:00;323;174;149;Starker Schneefall;1;-1;0.2;Stadt Konstanz, Amt für Stadtplanung und Umwelt
22.01.2022 18:00;322;146;176;Starker Schneefall;1;0;0.3;Stadt Konstanz, Amt für Stadtplanung und Umwelt
22.01.2022 19:00;315;163;152;Starker Schneefall;1;0;0.1;Stadt Konstanz, Amt für Stadtplanung und Umwelt
22.01.2022 20:00;211;104;107;Leichter Eisregen;1;0;0.1;Stadt Konstanz, Amt für Stadtplanung und Umwelt
22.01.2022 21:00;139;65;74;Leichter Eisregen;1;0;0.1;Stadt Konstanz, Amt für Stadtplanung und Umwelt
22.01.2022 22:00;129;48;81;Leichter Eisregen;0;0;0;Stadt Konstanz, Amt für Stadtplanung und Umwelt
22.01.2022 23:00;101;43;58;Leichter Schneefall;0;0;0;Stadt Konstanz, Amt für Stadtplanung und Umwelt
23.01.2022 00:00;81;32;49;Leichter Schneefall;-1;-1;0;Stadt Konstanz, Amt für Stadtplanung und Umwelt
23.01.2022 01:00;64;33;31;Leichter Schneefall;-1;-1;0;Stadt Konstanz, Amt für Stadtplanung und Umwelt
23.01.2022 02:00;50;17;33;Leichter Nebel;-1;-1;0;Stadt Konstanz, Amt für Stadtplanung und Umwelt
23.01.2022 03:00;31;19;12;Leichter Nebel;0;-1;0;Stadt Konstanz, Amt für Stadtplanung und Umwelt
23.01.2022 04:00;11;9;2;Leichter Nebel;0;-1;0;Stadt Konstanz, Amt für Stadtplanung und Umwelt
23.01.2022 05:00;15;11;4;Bewoelkt;0;-1;0;Stadt Konstanz, Amt für Stadtplanung und Umwelt
23.01.2022 06:00;19;13;6;Bewoelkt;0;-1;0;Stadt Konstanz, Amt für Stadtplanung und Umwelt
23.01.2022 07:00;40;21;19;Bewoelkt;0;0;0;Stadt Konstanz, Amt für Stadtplanung und Umwelt
23.01.2022 08:00;48;28;20;Bewoelkt;0;0;0;Stadt Konstanz, Amt für Stadtplanung und Umwelt
23.01.2022 09:00;123;58;65;Bewoelkt;0;0;0;Stadt Konstanz, Amt für Stadtplanung und Umwelt
23.01.2022 10:00;120;65;55;Bewoelkt;1;0;0;Stadt Konstanz, Amt für Stadtplanung und Umwelt
23.01.2022 11:00;170;99;71;Leicht bewoelkt;3;1;0;Stadt Konstanz, Amt für Stadtplanung und Umwelt
23.01.2022 12:00;225;89;136;Leicht bewoelkt;4;1;0;Stadt Konstanz, Amt für Stadtplanung und Umwelt
23.01.2022 13:00;271;138;133;Leicht bewoelkt;4;1;0;Stadt Konstanz, Amt für Stadtplanung und Umwelt
23.01.2022 14:00;268;120;148;Sonnig;3;1;0;Stadt Konstanz, Amt für Stadtplanung und Umwelt
23.01.2022 15:00;281;135;146;Sonnig;3;1;0;Stadt Konstanz, Amt für Stadtplanung und Umwelt
23.01.2022 16:00;269;142;127;Sonnig;2;-1;0;Stadt Konstanz, Amt für Stadtplanung und Umwelt
23.01.2022 17:00;265;114;151;Sonnig;1;-3;0;Stadt Konstanz, Amt für Stadtplanung und Umwelt
23.01.2022 18:00;207;88;119;Sonnig;0;-4;0;Stadt Konstanz, Amt für Stadtplanung und Umwelt
23.01.2022 19:00;185;97;88;Sonnig;-1;-4;0;Stadt Konstanz, Amt für Stadtplanung und Umwelt
23.01.2022 20:00;125;70;55;Leicht bewoelkt;-1;-4;0;Stadt Konstanz, Amt für Stadtplanung und Umwelt
23.01.2022 21:00;96;42;54;Leicht bewoelkt;-1;-4;0;Stadt Konstanz, Amt für Stadtplanung und Umwelt
23.01.2022 22:00;86;38;48;Leicht bewoelkt;-1;-4;0;Stadt Konstanz, Amt für Stadtplanung und Umwelt
23.01.2022 23:00;31;9;22;Sonnig;-2;-4;0;Stadt Konstanz, Amt für Stadtplanung und Umwelt
24.01.2022 00:00;24;15;9;Sonnig;-2;-4;0;Stadt Konstanz, Amt für Stadtplanung und Umwelt
24.01.2022 01:00;12;8;4;Sonnig;-3;-4;0;Stadt Konstanz, Amt für Stadtplanung und Umwelt
24.01.2022 02:00;4;4;0;Sonnig;-3;-5;0;Stadt Konstanz, Amt für Stadtplanung und Umwelt
24.01.2022 03:00;2;2;0;Sonnig;-3;-5;0;Stadt Konstanz, Amt für Stadtplanung und Umwelt
24.01.2022 04:00;7;6;1;Sonnig;-4;-5;0;Stadt Konstanz, Amt für Stadtplanung und Umwelt
24.01.2022 05:00;43;22;21;Sonnig;-4;-5;0;Stadt Konstanz, Amt für Stadtplanung und Umwelt
24.01.2022 06:00;124;67;57;Sonnig;-5;-6;0;Stadt Konstanz, Amt für Stadtplanung und Umwelt
24.01.2022 07:00;740;448;292;Sonnig;-4;-5;0;Stadt Konstanz, Amt für Stadtplanung und Umwelt
24.01.2022 08:00;574;302;272;Sonnig;-4;-4;0;Stadt Konstanz, Amt für Stadtplanung und Umwelt
24.01.2022 09:00;506;261;245;Sonnig;-4;-4;0;Stadt Konstanz, Amt für Stadtplanung und Umwelt
24.01.2022 10:00;269;158;111;Sonnig;-1;-1;0;Stadt Konstanz, Amt für Stadtplanung und Umwelt
24.01.2022 11:00;423;206;217;Sonnig;1;1;0;Stadt Konstanz, Amt für Stadtplanung und Umwelt
24.01.2022 12:00;493;213;280;Sonnig;4;3;0;Stadt Konstanz, Amt für Stadtplanung und Umwelt
24.01.2022 13:00;668;321;347;Sonnig;4;4;0;Stadt Konstanz, Amt für Stadtplanung und Umwelt
24.01.2022 14:00;396;174;222;Sonnig;5;5;0;Stadt Konstanz, Amt für Stadtplanung und Umwelt
24.01.2022 15:00;722;319;403;Sonnig;6;5;0;Stadt Konstanz, Amt für Stadtplanung und Umwelt
24.01.2022 16:00;556;248;308;Sonnig;4;3;0;Stadt Konstanz, Amt für Stadtplanung und Umwelt
24.01.2022 17:00;712;301;411;Sonnig;1;1;0;Stadt Konstanz, Amt für Stadtplanung und Umwelt
24.01.2022 18:00;586;305;281;Sonnig;-1;-1;0;Stadt Konstanz, Amt für Stadtplanung und Umwelt
24.01.2022 19:00;451;192;259;Sonnig;-2;-2;0;Stadt Konstanz, Amt für Stadtplanung und Umwelt
24.01.2022 20:00;296;134;162;Leicht bewoelkt;-2;-2;0;Stadt Konstanz, Amt für Stadtplanung und Umwelt
24.01.2022 21:00;171;88;83;Leicht bewoelkt;-3;-3;0;Stadt Konstanz, Amt für Stadtplanung und Umwelt
24.01.2022 22:00;124;58;66;Leicht bewoelkt;-3;-3;0;Stadt Konstanz, Amt für Stadtplanung und Umwelt
24.01.2022 23:00;47;27;20;Leichter Nebel;-3;-3;0;Stadt Konstanz, Amt für Stadtplanung und Umwelt
25.01.2022 00:00;33;11;22;Leichter Nebel;-4;-4;0;Stadt Konstanz, Amt für Stadtplanung und Umwelt
25.01.2022 01:00;14;8;6;Leichter Nebel;-3;-3;0;Stadt Konstanz, Amt für Stadtplanung und Umwelt
25.01.2022 02:00;6;4;2;Leichter Nebel;-3;-3;0;Stadt Konstanz, Amt für Stadtplanung und Umwelt
25.01.2022 03:00;3;2;1;Leichter Nebel;-3;-3;0;Stadt Konstanz, Amt für Stadtplanung und Umwelt
25.01.2022 04:00;2;1;1;Leichter Nebel;-3;-3;0;Stadt Konstanz, Amt für Stadtplanung und Umwelt
25.01.2022 05:00;37;28;9;Bewoelkt;-2;-2;0;Stadt Konstanz, Amt für Stadtplanung und Umwelt
25.01.2022 06:00;125;69;56;Bewoelkt;-2;-2;0;Stadt Konstanz, Amt für Stadtplanung und Umwelt
25.01.2022 07:00;772;483;289;Bewoelkt;-2;-2;0;Stadt Konstanz, Amt für Stadtplanung und Umwelt
25.01.2022 08:00;629;314;315;Leicht bewoelkt;-2;-2;0;Stadt Konstanz, Amt für Stadtplanung und Umwelt
25.01.2022 09:00;584;320;264;Leicht bewoelkt;-2;-2;0;Stadt Konstanz, Amt für Stadtplanung und Umwelt
25.01.2022 10:00;347;202;145;Leicht bewoelkt;0;0;0;Stadt Konstanz, Amt für Stadtplanung und Umwelt
25.01.2022 11:00;508;237;271;Sonnig;2;2;0;Stadt Konstanz, Amt für Stadtplanung und Umwelt
25.01.2022 12:00;467;188;279;Sonnig;4;4;0;Stadt Konstanz, Amt für Stadtplanung und Umwelt
25.01.2022 13:00;694;304;390;Sonnig;5;5;0;Stadt Konstanz, Amt für Stadtplanung und Umwelt
25.01.2022 14:00;459;213;246;Sonnig;5;5;0;Stadt Konstanz, Amt für Stadtplanung und Umwelt
25.01.2022 15:00;647;323;324;Sonnig;6;6;0;Stadt Konstanz, Amt für Stadtplanung und Umwelt
25.01.2022 16:00;681;309;372;Sonnig;5;5;0;Stadt Konstanz, Amt für Stadtplanung und Umwelt
25.01.2022 17:00;738;298;440;Sonnig;4;4;0;Stadt Konstanz, Amt für Stadtplanung und Umwelt
25.01.2022 18:00;592;270;322;Sonnig;3;3;0;Stadt Konstanz, Amt für Stadtplanung und Umwelt
25.01.2022 19:00;431;174;257;Sonnig;1;1;0;Stadt Konstanz, Amt für Stadtplanung und Umwelt
25.01.2022 20:00;266;118;148;Sonnig;0;0;0;Stadt Konstanz, Amt für Stadtplanung und Umwelt
25.01.2022 21:00;168;87;81;Sonnig;-1;-1;0;Stadt Konstanz, Amt für Stadtplanung und Umwelt
25.01.2022 22:00;144;62;82;Sonnig;-2;-2;0;Stadt Konstanz, Amt für Stadtplanung und Umwelt
25.01.2022 23:00;69;28;41;Sonnig;-2;-2;0;Stadt Konstanz, Amt für Stadtplanung und Umwelt
26.01.2022 00:00;26;12;14;Sonnig;-3;-3;0;Stadt Konstanz, Amt für Stadtplanung und Umwelt
26.01.2022 01:00;12;9;3;Sonnig;-3;-3;0;Stadt Konstanz, Amt für Stadtplanung und Umwelt
26.01.2022 02:00;3;1;2;Sonnig;-3;-3;0;Stadt Konstanz, Amt für Stadtplanung und Umwelt
26.01.2022 03:00;2;2;0;Sonnig;-3;-3;0;Stadt Konstanz, Amt für Stadtplanung und Umwelt
26.01.2022 04:00;6;3;3;Sonnig;-3;-3;0;Stadt Konstanz, Amt für Stadtplanung und Umwelt
26.01.2022 05:00;39;24;15;Sonnig;-3;-3;0;Stadt Konstanz, Amt für Stadtplanung und Umwelt
26.01.2022 06:00;121;68;53;Sonnig;-3;-3;0;Stadt Konstanz, Amt für Stadtplanung und Umwelt
26.01.2022 07:00;777;486;291;Sonnig;-3;-3;0;Stadt Konstanz, Amt für Stadtplanung und Umwelt
26.01.2022 08:00;582;313;269;Sonnig;-2;-2;0;Stadt Konstanz, Amt für Stadtplanung und Umwelt
26.01.2022 09:00;563;342;221;Sonnig;-2;-2;0;Stadt Konstanz, Amt für Stadtplanung und Umwelt
26.01.2022 10:00;336;176;160;Sonnig;1;0;0;Stadt Konstanz, Amt für Stadtplanung und Umwelt
26.01.2022 11:00;450;213;237;Sonnig;3;2;0;Stadt Konstanz, Amt für Stadtplanung und Umwelt
26.01.2022 12:00;471;235;236;Sonnig;5;5;0;Stadt Konstanz, Amt für Stadtplanung und Umwelt
26.01.2022 13:00;718;313;405;Sonnig;5;5;0;Stadt Konstanz, Amt für Stadtplanung und Umwelt
26.01.2022 14:00;440;210;230;Sonnig;6;5;0;Stadt Konstanz, Amt für Stadtplanung und Umwelt
26.01.2022 15:00;632;279;353;Sonnig;6;6;0;Stadt Konstanz, Amt für Stadtplanung und Umwelt
26.01.2022 16:00;644;299;345;Sonnig;5;4;0;Stadt Konstanz, Amt für Stadtplanung und Umwelt
26.01.2022 17:00;707;323;384;Sonnig;3;2;0;Stadt Konstanz, Amt für Stadtplanung und Umwelt
26.01.2022 18:00;591;257;334;Sonnig;1;0;0;Stadt Konstanz, Amt für Stadtplanung und Umwelt
26.01.2022 19:00;398;184;214;Sonnig;0;0;0;Stadt Konstanz, Amt für Stadtplanung und Umwelt
26.01.2022 20:00;309;149;160;Sonnig;-1;-1;0;Stadt Konstanz, Amt für Stadtplanung und Umwelt
26.01.2022 21:00;189;68;121;Sonnig;-2;-2;0;Stadt Konstanz, Amt für Stadtplanung und Umwelt
26.01.2022 22:00;158;62;96;Sonnig;-2;-2;0;Stadt Konstanz, Amt für Stadtplanung und Umwelt
26.01.2022 23:00;72;26;46;Sonnig;-2;-2;0;Stadt Konstanz, Amt für Stadtplanung und Umwelt
27.01.2022 00:00;31;14;17;Sonnig;-3;-3;0;Stadt Konstanz, Amt für Stadtplanung und Umwelt
27.01.2022 01:00;19;7;12;Sonnig;-3;-3;0;Stadt Konstanz, Amt für Stadtplanung und Umwelt
27.01.2022 02:00;9;4;5;Sonnig;-3;-4;0;Stadt Konstanz, Amt für Stadtplanung und Umwelt
27.01.2022 03:00;10;7;3;Sonnig;-3;-5;0;Stadt Konstanz, Amt für Stadtplanung und Umwelt
27.01.2022 04:00;4;2;2;Sonnig;-3;-4;0;Stadt Konstanz, Amt für Stadtplanung und Umwelt
27.01.2022 05:00;33;23;10;Sonnig;-3;-4;0;Stadt Konstanz, Amt für Stadtplanung und Umwelt
27.01.2022 06:00;115;64;51;Sonnig;-3;-4;0;Stadt Konstanz, Amt für Stadtplanung und Umwelt
27.01.2022 07:00;744;494;250;Sonnig;-2;-4;0;Stadt Konstanz, Amt für Stadtplanung und Umwelt
27.01.2022 08:00;601;298;303;Sonnig;-2;-3;0;Stadt Konstanz, Amt für Stadtplanung und Umwelt
27.01.2022 09:00;516;263;253;Sonnig;-1;-2;0;Stadt Konstanz, Amt für Stadtplanung und Umwelt
27.01.2022 10:00;302;176;126;Sonnig;1;-1;0;Stadt Konstanz, Amt für Stadtplanung und Umwelt
27.01.2022 11:00;432;214;218;Sonnig;3;1;0;Stadt Konstanz, Amt für Stadtplanung und Umwelt
27.01.2022 12:00;513;208;305;Sonnig;5;3;0;Stadt Konstanz, Amt für Stadtplanung und Umwelt
27.01.2022 13:00;658;271;387;Sonnig;5;4;0;Stadt Konstanz, Amt für Stadtplanung und Umwelt
27.01.2022 14:00;515;265;250;Sonnig;6;4;0;Stadt Konstanz, Amt für Stadtplanung und Umwelt
27.01.2022 15:00;652;338;314;Sonnig;6;5;0;Stadt Konstanz, Amt für Stadtplanung und Umwelt
27.01.2022 16:00;635;317;318;Sonnig;5;3;0;Stadt Konstanz, Amt für Stadtplanung und Umwelt
27.01.2022 17:00;767;336;431;Sonnig;3;1;0;Stadt Konstanz, Amt für Stadtplanung und Umwelt
27.01.2022 18:00;599;272;327;Sonnig;2;0;0;Stadt Konstanz, Amt für Stadtplanung und Umwelt
27.01.2022 19:00;439;200;239;Sonnig;2;-1;0;Stadt Konstanz, Amt für Stadtplanung und Umwelt
27.01.2022 20:00;259;128;131;Sonnig;2;-1;0;Stadt Konstanz, Amt für Stadtplanung und Umwelt
27.01.2022 21:00;179;72;107;Sonnig;2;-2;0;Stadt Konstanz, Amt für Stadtplanung und Umwelt
27.01.2022 22:00;188;90;98;Sonnig;2;-1;0;Stadt Konstanz, Amt für Stadtplanung und Umwelt
27.01.2022 23:00;84;43;41;Bewoelkt;2;-1;0;Stadt Konstanz, Amt für Stadtplanung und Umwelt
28.01.2022 00:00;29;8;21;Bewoelkt;2;0;0;Stadt Konstanz, Amt für Stadtplanung und Umwelt
28.01.2022 01:00;18;8;10;Bewoelkt;2;0;0;Stadt Konstanz, Amt für Stadtplanung und Umwelt
28.01.2022 02:00;7;2;5;Stellenweiser Regenfall;2;0;0;Stadt Konstanz, Amt für Stadtplanung und Umwelt
28.01.2022 03:00;4;0;4;Stellenweiser Regenfall;2;0;0;Stadt Konstanz, Amt für Stadtplanung und Umwelt
28.01.2022 04:00;9;6;3;Stellenweiser Regenfall;2;0;0;Stadt Konstanz, Amt für Stadtplanung und Umwelt
28.01.2022 05:00;32;24;8;Stellenweiser Regenfall;2;0;0;Stadt Konstanz, Amt für Stadtplanung und Umwelt
28.01.2022 06:00;114;66;48;Stellenweiser Regenfall;2;0;0;Stadt Konstanz, Amt für Stadtplanung und Umwelt
28.01.2022 07:00;700;424;276;Stellenweiser Regenfall;1;0;0;Stadt Konstanz, Amt für Stadtplanung und Umwelt
28.01.2022 08:00;502;268;234;Leicht bewoelkt;1;-1;0;Stadt Konstanz, Amt für Stadtplanung und Umwelt
28.01.2022 09:00;463;264;199;Leicht bewoelkt;1;-1;0;Stadt Konstanz, Amt für Stadtplanung und Umwelt
28.01.2022 10:00;350;201;149;Leicht bewoelkt;2;0;0;Stadt Konstanz, Amt für Stadtplanung und Umwelt
28.01.2022 11:00;455;227;228;Stellenweiser Regenfall;3;1;0;Stadt Konstanz, Amt für Stadtplanung und Umwelt
28.01.2022 12:00;574;279;295;Stellenweiser Regenfall;5;2;0;Stadt Konstanz, Amt für Stadtplanung und Umwelt
28.01.2022 13:00;757;286;471;Stellenweiser Regenfall;4;2;0;Stadt Konstanz, Amt für Stadtplanung und Umwelt
28.01.2022 14:00;584;297;287;Stellenweiser Eisregen;4;2;0.1;Stadt Konstanz, Amt für Stadtplanung und Umwelt
28.01.2022 15:00;648;294;354;Stellenweiser Eisregen;4;2;0.1;Stadt Konstanz, Amt für Stadtplanung und Umwelt
28.01.2022 16:00;486;240;246;Stellenweiser Eisregen;3;2;0;Stadt Konstanz, Amt für Stadtplanung und Umwelt
28.01.2022 17:00;560;277;283;Stellenweiser Eisregen;2;1;0.1;Stadt Konstanz, Amt für Stadtplanung und Umwelt
28.01.2022 18:00;467;214;253;Stellenweiser Eisregen;1;1;0.1;Stadt Konstanz, Amt für Stadtplanung und Umwelt
28.01.2022 19:00;385;194;191;Stellenweiser Eisregen;1;1;0;Stadt Konstanz, Amt für Stadtplanung und Umwelt
28.01.2022 20:00;290;172;118;Bedeckt;1;1;0;Stadt Konstanz, Amt für Stadtplanung und Umwelt
28.01.2022 21:00;179;105;74;Bedeckt;0;0;0;Stadt Konstanz, Amt für Stadtplanung und Umwelt
28.01.2022 22:00;162;46;116;Bedeckt;0;0;0;Stadt Konstanz, Amt für Stadtplanung und Umwelt
28.01.2022 23:00;117;57;60;Bedeckt;0;0;0;Stadt Konstanz, Amt für Stadtplanung und Umwelt
29.01.2022 00:00;106;35;71;Bedeckt;0;0;0;Stadt Konstanz, Amt für Stadtplanung und Umwelt
29.01.2022 01:00;88;34;54;Bedeckt;-1;-1;0;Stadt Konstanz, Amt für Stadtplanung und Umwelt
29.01.2022 02:00;45;19;26;Bedeckt;-1;-2;0;Stadt Konstanz, Amt für Stadtplanung und Umwelt
29.01.2022 03:00;29;9;20;Bedeckt;-1;-3;0;Stadt Konstanz, Amt für Stadtplanung und Umwelt
29.01.2022 04:00;19;5;14;Bedeckt;-1;-3;0;Stadt Konstanz, Amt für Stadtplanung und Umwelt
29.01.2022 05:00;49;22;27;Leicht bewoelkt;-2;-3;0;Stadt Konstanz, Amt für Stadtplanung und Umwelt
29.01.2022 06:00;51;28;23;Leicht bewoelkt;-2;-3;0;Stadt Konstanz, Amt für Stadtplanung und Umwelt
29.01.2022 07:00;61;38;23;Leicht bewoelkt;-1;-2;0;Stadt Konstanz, Amt für Stadtplanung und Umwelt
29.01.2022 08:00;133;74;59;Leicht bewoelkt;0;-2;0;Stadt Konstanz, Amt für Stadtplanung und Umwelt
29.01.2022 09:00;239;131;108;Leicht bewoelkt;1;-1;0;Stadt Konstanz, Amt für Stadtplanung und Umwelt
29.01.2022 10:00;288;170;118;Leicht bewoelkt;2;0;0;Stadt Konstanz, Amt für Stadtplanung und Umwelt
29.01.2022 11:00;289;140;149;Leicht bewoelkt;3;1;0;Stadt Konstanz, Amt für Stadtplanung und Umwelt
29.01.2022 12:00;379;221;158;Leicht bewoelkt;5;2;0;Stadt Konstanz, Amt für Stadtplanung und Umwelt
29.01.2022 13:00;433;217;216;Leicht bewoelkt;5;3;0;Stadt Konstanz, Amt für Stadtplanung und Umwelt
29.01.2022 14:00;495;235;260;Sonnig;6;3;0;Stadt Konstanz, Amt für Stadtplanung und Umwelt
29.01.2022 15:00;619;313;306;Sonnig;6;4;0;Stadt Konstanz, Amt für Stadtplanung und Umwelt
29.01.2022 16:00;560;284;276;Sonnig;5;3;0;Stadt Konstanz, Amt für Stadtplanung und Umwelt
29.01.2022 17:00;372;181;191;Sonnig;4;1;0;Stadt Konstanz, Amt für Stadtplanung und Umwelt
29.01.2022 18:00;396;174;222;Sonnig;3;0;0;Stadt Konstanz, Amt für Stadtplanung und Umwelt
29.01.2022 19:00;326;171;155;Sonnig;2;-1;0;Stadt Konstanz, Amt für Stadtplanung und Umwelt
29.01.2022 20:00;206;93;113;Leicht bewoelkt;2;-1;0;Stadt Konstanz, Amt für Stadtplanung und Umwelt
29.01.2022 21:00;139;64;75;Leicht bewoelkt;2;-1;0;Stadt Konstanz, Amt für Stadtplanung und Umwelt
29.01.2022 22:00;113;36;77;Leicht bewoelkt;2;-1;0;Stadt Konstanz, Amt für Stadtplanung und Umwelt
29.01.2022 23:00;127;41;86;Bedeckt;3;0;0;Stadt Konstanz, Amt für Stadtplanung und Umwelt
30.01.2022 00:00;97;33;64;Bedeckt;4;1;0;Stadt Konstanz, Amt für Stadtplanung und Umwelt
30.01.2022 01:00;86;41;45;Bedeckt;4;1;0;Stadt Konstanz, Amt für Stadtplanung und Umwelt
30.01.2022 02:00;52;27;25;Bedeckt;4;1;0;Stadt Konstanz, Amt für Stadtplanung und Umwelt
30.01.2022 03:00;42;13;29;Bedeckt;4;1;0;Stadt Konstanz, Amt für Stadtplanung und Umwelt
30.01.2022 04:00;16;8;8;Bedeckt;4;2;0;Stadt Konstanz, Amt für Stadtplanung und Umwelt
30.01.2022 05:00;22;10;12;Stellenweiser Regenfall;3;2;0;Stadt Konstanz, Amt für Stadtplanung und Umwelt
30.01.2022 06:00;15;11;4;Stellenweiser Regenfall;3;2;0;Stadt Konstanz, Amt für Stadtplanung und Umwelt
30.01.2022 07:00;23;9;14;Stellenweiser Regenfall;3;2;0;Stadt Konstanz, Amt für Stadtplanung und Umwelt
30.01.2022 08:00;58;25;33;Bedeckt;3;3;0;Stadt Konstanz, Amt für Stadtplanung und Umwelt
30.01.2022 09:00;139;76;63;Bedeckt;4;4;0;Stadt Konstanz, Amt für Stadtplanung und Umwelt
30.01.2022 10:00;158;86;72;Bedeckt;4;4;0;Stadt Konstanz, Amt für Stadtplanung und Umwelt
30.01.2022 11:00;177;79;98;Leicht bewoelkt;5;5;0;Stadt Konstanz, Amt für Stadtplanung und Umwelt
30.01.2022 12:00;243;124;119;Leicht bewoelkt;6;6;0;Stadt Konstanz, Amt für Stadtplanung und Umwelt
30.01.2022 13:00;282;120;162;Leicht bewoelkt;7;7;0;Stadt Konstanz, Amt für Stadtplanung und Umwelt
30.01.2022 14:00;321;157;164;Bewoelkt;7;7;0;Stadt Konstanz, Amt für Stadtplanung und Umwelt
30.01.2022 15:00;310;153;157;Bewoelkt;7;7;0;Stadt Konstanz, Amt für Stadtplanung und Umwelt
30.01.2022 16:00;267;132;135;Bewoelkt;6;5;0;Stadt Konstanz, Amt für Stadtplanung und Umwelt
30.01.2022 17:00;273;127;146;Sonnig;5;4;0;Stadt Konstanz, Amt für Stadtplanung und Umwelt
30.01.2022 18:00;193;91;102;Sonnig;3;2;0;Stadt Konstanz, Amt für Stadtplanung und Umwelt
30.01.2022 19:00;177;101;76;Sonnig;2;0;0;Stadt Konstanz, Amt für Stadtplanung und Umwelt
30.01.2022 20:00;123;66;57;Sonnig;1;-2;0;Stadt Konstanz, Amt für Stadtplanung und Umwelt
30.01.2022 21:00;108;52;56;Sonnig;-1;-3;0;Stadt Konstanz, Amt für Stadtplanung und Umwelt
30.01.2022 22:00;76;38;38;Sonnig;-1;-3;0;Stadt Konstanz, Amt für Stadtplanung und Umwelt
30.01.2022 23:00;42;21;21;Sonnig;-1;-2;0;Stadt Konstanz, Amt für Stadtplanung und Umwelt
31.01.2022 00:00;27;13;14;Sonnig;-1;-1;0;Stadt Konstanz, Amt für Stadtplanung und Umwelt
31.01.2022 01:00;10;8;2;Sonnig;-1;-2;0;Stadt Konstanz, Amt für Stadtplanung und Umwelt
31.01.2022 02:00;7;4;3;Leicht bewoelkt;-1;-2;0;Stadt Konstanz, Amt für Stadtplanung und Umwelt
31.01.2022 03:00;1;1;0;Leicht bewoelkt;-1;-2;0;Stadt Konstanz, Amt für Stadtplanung und Umwelt
31.01.2022 04:00;4;4;0;Leicht bewoelkt;0;-2;0;Stadt Konstanz, Amt für Stadtplanung und Umwelt
31.01.2022 05:00;37;23;14;Leicht bewoelkt;1;-3;0;Stadt Konstanz, Amt für Stadtplanung und Umwelt
31.01.2022 06:00;126;68;58;Leicht bewoelkt;2;-3;0;Stadt Konstanz, Amt für Stadtplanung und Umwelt
31.01.2022 07:00;694;399;295;Leicht bewoelkt;2;-3;0;Stadt Konstanz, Amt für Stadtplanung und Umwelt
31.01.2022 08:00;556;310;246;Bewoelkt;2;-3;0;Stadt Konstanz, Amt für Stadtplanung und Umwelt
31.01.2022 09:00;400;222;178;Bewoelkt;3;-2;0;Stadt Konstanz, Amt für Stadtplanung und Umwelt
31.01.2022 10:00;231;115;116;Bewoelkt;3;-2;0;Stadt Konstanz, Amt für Stadtplanung und Umwelt
31.01.2022 11:00;262;133;129;Maessiger Schneefall;3;-2;0.1;Stadt Konstanz, Amt für Stadtplanung und Umwelt
31.01.2022 12:00;350;158;192;Maessiger Schneefall;3;-2;0.1;Stadt Konstanz, Amt für Stadtplanung und Umwelt
31.01.2022 13:00;564;258;306;Maessiger Schneefall;3;-2;0;Stadt Konstanz, Amt für Stadtplanung und Umwelt
31.01.2022 14:00;414;218;196;Bewoelkt;3;-2;0;Stadt Konstanz, Amt für Stadtplanung und Umwelt
31.01.2022 15:00;560;266;294;Bewoelkt;4;-2;0;Stadt Konstanz, Amt für Stadtplanung und Umwelt
31.01.2022 16:00;511;236;275;Bewoelkt;3;-2;0;Stadt Konstanz, Amt für Stadtplanung und Umwelt
31.01.2022 17:00;582;246;336;Maessige bis starke Schneefaelle;3;-3;0;Stadt Konstanz, Amt für Stadtplanung und Umwelt
31.01.2022 18:00;523;254;269;Maessige bis starke Schneefaelle;2;-3;0;Stadt Konstanz, Amt für Stadtplanung und Umwelt
31.01.2022 19:00;368;178;190;Maessige bis starke Schneefaelle;2;-4;0;Stadt Konstanz, Amt für Stadtplanung und Umwelt
31.01.2022 20:00;270;134;136;Bedeckt;2;-4;0;Stadt Konstanz, Amt für Stadtplanung und Umwelt
31.01.2022 21:00;142;72;70;Bedeckt;1;-5;0;Stadt Konstanz, Amt für Stadtplanung und Umwelt
31.01.2022 22:00;103;45;58;Bedeckt;1;-5;0;Stadt Konstanz, Amt für Stadtplanung und Umwelt
31.01.2022 23:00;64;28;36;Starker Schneefall;0;-6;0.2;Stadt Konstanz, Amt für Stadtplanung und Umwelt
01.02.2022 00:00;41;23;18;Starker Schneefall;0;-6;0.4;Stadt Konstanz, Amt für Stadtplanung und Umwelt
01.02.2022 01:00;9;1;8;Starker Schneefall;0;-6;0.2;Stadt Konstanz, Amt für Stadtplanung und Umwelt
01.02.2022 02:00;10;6;4;Leichter Schneefall;0;-6;0;Stadt Konstanz, Amt für Stadtplanung und Umwelt
01.02.2022 03:00;0;0;0;Leichter Schneefall;-1;-7;0;Stadt Konstanz, Amt für Stadtplanung und Umwelt
01.02.2022 04:00;1;1;0;Leichter Schneefall;0;-6;0;Stadt Konstanz, Amt für Stadtplanung und Umwelt
01.02.2022 05:00;38;30;8;Starker Schneefall;0;-6;0.1;Stadt Konstanz, Amt für Stadtplanung und Umwelt
01.02.2022 06:00;131;72;59;Starker Schneefall;0;-6;0.1;Stadt Konstanz, Amt für Stadtplanung und Umwelt
01.02.2022 07:00;714;396;318;Starker Schneefall;0;-6;0.1;Stadt Konstanz, Amt für Stadtplanung und Umwelt
01.02.2022 08:00;607;309;298;Bewoelkt;0;-5;0;Stadt Konstanz, Amt für Stadtplanung und Umwelt
01.02.2022 09:00;492;284;208;Bewoelkt;0;-5;0;Stadt Konstanz, Amt für Stadtplanung und Umwelt
01.02.2022 10:00;302;184;118;Bewoelkt;1;-4;0;Stadt Konstanz, Amt für Stadtplanung und Umwelt
01.02.2022 11:00;414;198;216;Bewoelkt;2;-3;0;Stadt Konstanz, Amt für Stadtplanung und Umwelt
01.02.2022 12:00;451;185;266;Bewoelkt;3;-2;0;Stadt Konstanz, Amt für Stadtplanung und Umwelt
01.02.2022 13:00;548;245;303;Bewoelkt;3;-2;0;Stadt Konstanz, Amt für Stadtplanung und Umwelt
01.02.2022 14:00;401;182;219;Leicht bewoelkt;3;-1;0;Stadt Konstanz, Amt für Stadtplanung und Umwelt
01.02.2022 15:00;600;279;321;Leicht bewoelkt;4;-1;0;Stadt Konstanz, Amt für Stadtplanung und Umwelt
01.02.2022 16:00;562;246;316;Leicht bewoelkt;3;-2;0;Stadt Konstanz, Amt für Stadtplanung und Umwelt
01.02.2022 17:00;568;275;293;Maessiger Schneefall;2;-3;0.1;Stadt Konstanz, Amt für Stadtplanung und Umwelt
01.02.2022 18:00;513;257;256;Maessiger Schneefall;2;-4;0.1;Stadt Konstanz, Amt für Stadtplanung und Umwelt
01.02.2022 19:00;353;192;161;Maessiger Schneefall;2;-3;0;Stadt Konstanz, Amt für Stadtplanung und Umwelt
01.02.2022 20:00;223;102;121;Bedeckt;2;-3;0;Stadt Konstanz, Amt für Stadtplanung und Umwelt
01.02.2022 21:00;136;67;69;Bedeckt;2;-3;0;Stadt Konstanz, Amt für Stadtplanung und Umwelt
01.02.2022 22:00;127;50;77;Bedeckt;2;-3;0;Stadt Konstanz, Amt für Stadtplanung und Umwelt
01.02.2022 23:00;57;31;26;Starker Schneefall;2;-3;0.4;Stadt Konstanz, Amt für Stadtplanung und Umwelt
02.02.2022 00:00;39;11;28;Starker Schneefall;2;-3;0.9;Stadt Konstanz, Amt für Stadtplanung und Umwelt
02.02.2022 01:00;18;7;11;Starker Schneefall;2;-3;0.4;Stadt Konstanz, Amt für Stadtplanung und Umwelt
02.02.2022 02:00;5;3;2;Nieselregen;2;-3;0.1;Stadt Konstanz, Amt für Stadtplanung und Umwelt
02.02.2022 03:00;6;3;3;Nieselregen;3;-3;0.1;Stadt Konstanz, Amt für Stadtplanung und Umwelt
02.02.2022 04:00;6;4;2;Nieselregen;3;-2;0.1;Stadt Konstanz, Amt für Stadtplanung und Umwelt
02.02.2022 05:00;35;27;8;Nieselregen;3;-2;0.1;Stadt Konstanz, Amt für Stadtplanung und Umwelt
02.02.2022 06:00;131;73;58;Nieselregen;3;-2;0.1;Stadt Konstanz, Amt für Stadtplanung und Umwelt
02.02.2022 07:00;709;426;283;Nieselregen;4;-1;0.1;Stadt Konstanz, Amt für Stadtplanung und Umwelt
02.02.2022 08:00;619;370;249;Nieselregen;4;-1;0.2;Stadt Konstanz, Amt für Stadtplanung und Umwelt
02.02.2022 09:00;457;271;186;Nieselregen;4;0;0.3;Stadt Konstanz, Amt für Stadtplanung und Umwelt
02.02.2022 10:00;285;157;128;Nieselregen;5;0;0.1;Stadt Konstanz, Amt für Stadtplanung und Umwelt
02.02.2022 11:00;388;174;214;Nieselregen;5;1;0.2;Stadt Konstanz, Amt für Stadtplanung und Umwelt
02.02.2022 12:00;456;191;265;Nieselregen;6;1;0.3;Stadt Konstanz, Amt für Stadtplanung und Umwelt
02.02.2022 13:00;628;279;349;Nieselregen;6;2;0.1;Stadt Konstanz, Amt für Stadtplanung und Umwelt
02.02.2022 14:00;482;232;250;Leichter Regenfall;6;2;0.3;Stadt Konstanz, Amt für Stadtplanung und Umwelt
02.02.2022 15:00;610;289;321;Leichter Regenfall;6;2;0.4;Stadt Konstanz, Amt für Stadtplanung und Umwelt
02.02.2022 16:00;495;214;281;Leichter Regenfall;6;2;0.2;Stadt Konstanz, Amt für Stadtplanung und Umwelt
02.02.2022 17:00;660;302;358;Leichter Regenfall;6;2;0.3;Stadt Konstanz, Amt für Stadtplanung und Umwelt
02.02.2022 18:00;536;251;285;Leichter Regenfall;6;2;0.4;Stadt Konstanz, Amt für Stadtplanung und Umwelt
02.02.2022 19:00;363;184;179;Leichter Regenfall;6;2;0.2;Stadt Konstanz, Amt für Stadtplanung und Umwelt
02.02.2022 20:00;299;131;168;Nieselregen;6;2;0.1;Stadt Konstanz, Amt für Stadtplanung und Umwelt
02.02.2022 21:00;132;68;64;Nieselregen;6;2;0.2;Stadt Konstanz, Amt für Stadtplanung und Umwelt
02.02.2022 22:00;134;62;72;Nieselregen;6;2;0.1;Stadt Konstanz, Amt für Stadtplanung und Umwelt
02.02.2022 23:00;71;31;40;Nieselregen;6;2;0.2;Stadt Konstanz, Amt für Stadtplanung und Umwelt
03.02.2022 00:00;47;16;31;Nieselregen;6;3;0.3;Stadt Konstanz, Amt für Stadtplanung und Umwelt
03.02.2022 01:00;30;10;20;Nieselregen;6;3;0.2;Stadt Konstanz, Amt für Stadtplanung und Umwelt
03.02.2022 02:00;5;3;2;Nieselregen;6;3;0.1;Stadt Konstanz, Amt für Stadtplanung und Umwelt
03.02.2022 03:00;4;1;3;Nieselregen;6;3;0.1;Stadt Konstanz, Amt für Stadtplanung und Umwelt
03.02.2022 04:00;6;4;2;Nieselregen;5;3;0;Stadt Konstanz, Amt für Stadtplanung und Umwelt
03.02.2022 05:00;46;32;14;Nieselregen;5;4;0.1;Stadt Konstanz, Amt für Stadtplanung und Umwelt
03.02.2022 06:00;141;83;58;Nieselregen;5;4;0.1;Stadt Konstanz, Amt für Stadtplanung und Umwelt
03.02.2022 07:00;717;441;276;Nieselregen;5;4;0;Stadt Konstanz, Amt für Stadtplanung und Umwelt
03.02.2022 08:00;667;339;328;Leichter Nebel;5;4;0;Stadt Konstanz, Amt für Stadtplanung und Umwelt
03.02.2022 09:00;549;316;233;Leichter Nebel;5;5;0;Stadt Konstanz, Amt für Stadtplanung und Umwelt
03.02.2022 10:00;363;192;171;Leichter Nebel;6;5;0;Stadt Konstanz, Amt für Stadtplanung und Umwelt
03.02.2022 11:00;449;196;253;Bedeckt;6;6;0;Stadt Konstanz, Amt für Stadtplanung und Umwelt
03.02.2022 12:00;529;256;273;Bedeckt;7;7;0;Stadt Konstanz, Amt für Stadtplanung und Umwelt
03.02.2022 13:00;664;280;384;Bedeckt;7;7;0;Stadt Konstanz, Amt für Stadtplanung und Umwelt
03.02.2022 14:00;497;255;242;Bedeckt;8;7;0;Stadt Konstanz, Amt für Stadtplanung und Umwelt
03.02.2022 15:00;745;352;393;Bedeckt;8;8;0;Stadt Konstanz, Amt für Stadtplanung und Umwelt
03.02.2022 16:00;683;333;350;Bedeckt;7;6;0;Stadt Konstanz, Amt für Stadtplanung und Umwelt
03.02.2022 17:00;851;387;464;Leichter Nebel;6;5;0;Stadt Konstanz, Amt für Stadtplanung und Umwelt
03.02.2022 18:00;589;286;303;Leichter Nebel;5;4;0;Stadt Konstanz, Amt für Stadtplanung und Umwelt
03.02.2022 19:00;445;207;238;Leichter Nebel;4;3;0;Stadt Konstanz, Amt für Stadtplanung und Umwelt
03.02.2022 20:00;291;145;146;Bewoelkt;4;3;0;Stadt Konstanz, Amt für Stadtplanung und Umwelt
03.02.2022 21:00;171;68;103;Bewoelkt;4;3;0;Stadt Konstanz, Amt für Stadtplanung und Umwelt
03.02.2022 22:00;150;69;81;Bewoelkt;3;2;0;Stadt Konstanz, Amt für Stadtplanung und Umwelt
03.02.2022 23:00;105;55;50;Bedeckt;3;1;0;Stadt Konstanz, Amt für Stadtplanung und Umwelt
04.02.2022 00:00;51;20;31;Bedeckt;2;1;0;Stadt Konstanz, Amt für Stadtplanung und Umwelt
04.02.2022 01:00;32;8;24;Bedeckt;2;1;0;Stadt Konstanz, Amt für Stadtplanung und Umwelt
04.02.2022 02:00;13;4;9;Sonnig;2;1;0;Stadt Konstanz, Amt für Stadtplanung und Umwelt
04.02.2022 03:00;4;3;1;Sonnig;2;1;0;Stadt Konstanz, Amt für Stadtplanung und Umwelt
04.02.2022 04:00;5;5;0;Sonnig;2;1;0;Stadt Konstanz, Amt für Stadtplanung und Umwelt
04.02.2022 05:00;31;22;9;Bewoelkt;2;1;0;Stadt Konstanz, Amt für Stadtplanung und Umwelt
04.02.2022 06:00;154;88;66;Bewoelkt;2;0;0;Stadt Konstanz, Amt für Stadtplanung und Umwelt
04.02.2022 07:00;715;414;301;Bewoelkt;3;1;0;Stadt Konstanz, Amt für Stadtplanung und Umwelt
04.02.2022 08:00;594;333;261;Bewoelkt;3;1;0;Stadt Konstanz, Amt für Stadtplanung und Umwelt
04.02.2022 09:00;493;296;197;Bewoelkt;3;1;0;Stadt Konstanz, Amt für Stadtplanung und Umwelt
04.02.2022 10:00;453;248;205;Bewoelkt;4;2;0;Stadt Konstanz, Amt für Stadtplanung und Umwelt
04.02.2022 11:00;504;272;232;Bedeckt;5;2;0;Stadt Konstanz, Amt für Stadtplanung und Umwelt
04.02.2022 12:00;652;251;401;Bedeckt;6;3;0;Stadt Konstanz, Amt für Stadtplanung und Umwelt
04.02.2022 13:00;738;302;436;Bedeckt;6;3;0;Stadt Konstanz, Amt für Stadtplanung und Umwelt
04.02.2022 14:00;536;265;271;Bewoelkt;6;3;0;Stadt Konstanz, Amt für Stadtplanung und Umwelt
04.02.2022 15:00;608;279;329;Bewoelkt;6;3;0;Stadt Konstanz, Amt für Stadtplanung und Umwelt
04.02.2022 16:00;587;273;314;Bewoelkt;6;3;0;Stadt Konstanz, Amt für Stadtplanung und Umwelt
04.02.2022 17:00;576;265;311;Leicht bewoelkt;5;2;0;Stadt Konstanz, Amt für Stadtplanung und Umwelt
04.02.2022 18:00;518;229;289;Leicht bewoelkt;5;2;0;Stadt Konstanz, Amt für Stadtplanung und Umwelt
04.02.2022 19:00;393;216;177;Leicht bewoelkt;4;1;0;Stadt Konstanz, Amt für Stadtplanung und Umwelt
04.02.2022 20:00;263;156;107;Bewoelkt;4;1;0;Stadt Konstanz, Amt für Stadtplanung und Umwelt
04.02.2022 21:00;182;119;63;Bewoelkt;3;1;0;Stadt Konstanz, Amt für Stadtplanung und Umwelt
04.02.2022 22:00;148;61;87;Bewoelkt;4;1;0;Stadt Konstanz, Amt für Stadtplanung und Umwelt
04.02.2022 23:00;117;54;63;Stellenweiser Regenfall;5;1;0;Stadt Konstanz, Amt für Stadtplanung und Umwelt
05.02.2022 00:00;126;45;81;Stellenweiser Regenfall;5;2;0.1;Stadt Konstanz, Amt für Stadtplanung und Umwelt
05.02.2022 01:00;56;27;29;Stellenweiser Regenfall;4;1;0;Stadt Konstanz, Amt für Stadtplanung und Umwelt
05.02.2022 02:00;72;21;51;Leichter Eisregen;3;0;0.3;Stadt Konstanz, Amt für Stadtplanung und Umwelt
05.02.2022 03:00;36;11;25;Leichter Eisregen;2;-1;0.4;Stadt Konstanz, Amt für Stadtplanung und Umwelt
05.02.2022 04:00;31;15;16;Leichter Eisregen;2;0;0.2;Stadt Konstanz, Amt für Stadtplanung und Umwelt
05.02.2022 05:00;22;11;11;Stellenweise starker Schneefall;1;0;0.2;Stadt Konstanz, Amt für Stadtplanung und Umwelt
05.02.2022 06:00;46;33;13;Stellenweise starker Schneefall;1;0;0.2;Stadt Konstanz, Amt für Stadtplanung und Umwelt
05.02.2022 07:00;78;43;35;Stellenweise starker Schneefall;1;0;0.1;Stadt Konstanz, Amt für Stadtplanung und Umwelt
05.02.2022 08:00;142;72;70;Sonnig;2;0;0;Stadt Konstanz, Amt für Stadtplanung und Umwelt
05.02.2022 09:00;270;144;126;Sonnig;2;1;0;Stadt Konstanz, Amt für Stadtplanung und Umwelt
05.02.2022 10:00;376;197;179;Sonnig;4;2;0;Stadt Konstanz, Amt für Stadtplanung und Umwelt
05.02.2022 11:00;356;206;150;Sonnig;6;4;0;Stadt Konstanz, Amt für Stadtplanung und Umwelt
05.02.2022 12:00;472;247;225;Sonnig;8;6;0;Stadt Konstanz, Amt für Stadtplanung und Umwelt
05.02.2022 13:00;552;284;268;Sonnig;8;6;0;Stadt Konstanz, Amt für Stadtplanung und Umwelt
05.02.2022 14:00;469;209;260;Sonnig;8;6;0;Stadt Konstanz, Amt für Stadtplanung und Umwelt
05.02.2022 15:00;538;256;282;Sonnig;8;6;0;Stadt Konstanz, Amt für Stadtplanung und Umwelt
05.02.2022 16:00;444;215;229;Sonnig;6;4;0;Stadt Konstanz, Amt für Stadtplanung und Umwelt
05.02.2022 17:00;434;209;225;Sonnig;4;1;0;Stadt Konstanz, Amt für Stadtplanung und Umwelt
05.02.2022 18:00;367;176;191;Sonnig;2;-1;0;Stadt Konstanz, Amt für Stadtplanung und Umwelt
05.02.2022 19:00;252;121;131;Sonnig;1;-1;0;Stadt Konstanz, Amt für Stadtplanung und Umwelt
05.02.2022 20:00;202;100;102;Sonnig;1;-2;0;Stadt Konstanz, Amt für Stadtplanung und Umwelt
05.02.2022 21:00;163;93;70;Sonnig;1;-3;0;Stadt Konstanz, Amt für Stadtplanung und Umwelt
05.02.2022 22:00;108;55;53;Sonnig;0;-3;0;Stadt Konstanz, Amt für Stadtplanung und Umwelt
05.02.2022 23:00;113;63;50;Leicht bewoelkt;0;-3;0;Stadt Konstanz, Amt für Stadtplanung und Umwelt
06.02.2022 00:00;97;41;56;Leicht bewoelkt;0;-3;0;Stadt Konstanz, Amt für Stadtplanung und Umwelt
06.02.2022 01:00;71;37;34;Leicht bewoelkt;1;-3;0;Stadt Konstanz, Amt für Stadtplanung und Umwelt
06.02.2022 02:00;38;15;23;Bedeckt;1;-3;0;Stadt Konstanz, Amt für Stadtplanung und Umwelt
06.02.2022 03:00;37;5;32;Bedeckt;1;-3;0;Stadt Konstanz, Amt für Stadtplanung und Umwelt
06.02.2022 04:00;18;6;12;Bedeckt;1;-3;0;Stadt Konstanz, Amt für Stadtplanung und Umwelt
06.02.2022 05:00;26;10;16;Bedeckt;1;-2;0;Stadt Konstanz, Amt für Stadtplanung und Umwelt
06.02.2022 06:00;33;24;9;Bedeckt;2;-2;0;Stadt Konstanz, Amt für Stadtplanung und Umwelt
06.02.2022 07:00;37;12;25;Bedeckt;2;-2;0;Stadt Konstanz, Amt für Stadtplanung und Umwelt
06.02.2022 08:00;39;12;27;Bewoelkt;2;-2;0;Stadt Konstanz, Amt für Stadtplanung und Umwelt
06.02.2022 09:00;123;73;50;Bewoelkt;3;-2;0;Stadt Konstanz, Amt für Stadtplanung und Umwelt
06.02.2022 10:00;166;90;76;Bewoelkt;4;-1;0;Stadt Konstanz, Amt für Stadtplanung und Umwelt
06.02.2022 11:00;185;94;91;Bedeckt;4;0;0;Stadt Konstanz, Amt für Stadtplanung und Umwelt
06.02.2022 12:00;208;96;112;Bedeckt;5;1;0;Stadt Konstanz, Amt für Stadtplanung und Umwelt
06.02.2022 13:00;225;110;115;Bedeckt;6;2;0;Stadt Konstanz, Amt für Stadtplanung und Umwelt
06.02.2022 14:00;211;113;98;Bedeckt;6;2;0;Stadt Konstanz, Amt für Stadtplanung und Umwelt
06.02.2022 15:00;199;108;91;Bedeckt;7;2;0;Stadt Konstanz, Amt für Stadtplanung und Umwelt
06.02.2022 16:00;187;76;111;Bedeckt;7;2;0;Stadt Konstanz, Amt für Stadtplanung und Umwelt
06.02.2022 17:00;164;88;76;Stellenweiser Regenfall;7;2;0;Stadt Konstanz, Amt für Stadtplanung und Umwelt
06.02.2022 18:00;146;72;74;Stellenweiser Regenfall;7;2;0;Stadt Konstanz, Amt für Stadtplanung und Umwelt
06.02.2022 19:00;115;66;49;Stellenweiser Regenfall;6;1;0;Stadt Konstanz, Amt für Stadtplanung und Umwelt
06.02.2022 20:00;73;44;29;Bedeckt;6;1;0;Stadt Konstanz, Amt für Stadtplanung und Umwelt
06.02.2022 21:00;49;28;21;Bedeckt;5;0;0;Stadt Konstanz, Amt für Stadtplanung und Umwelt
06.02.2022 22:00;52;25;27;Bedeckt;6;1;0;Stadt Konstanz, Amt für Stadtplanung und Umwelt
06.02.2022 23:00;35;12;23;Nieselregen;6;1;0.1;Stadt Konstanz, Amt für Stadtplanung und Umwelt
07.02.2022 00:00;16;11;5;Nieselregen;7;1;0.3;Stadt Konstanz, Amt für Stadtplanung und Umwelt
07.02.2022 01:00;12;7;5;Nieselregen;6;0;0.1;Stadt Konstanz, Amt für Stadtplanung und Umwelt
07.02.2022 02:00;1;1;0;Leichter Eisregen;5;-1;0.8;Stadt Konstanz, Amt für Stadtplanung und Umwelt
07.02.2022 03:00;2;0;2;Leichter Eisregen;4;-2;1;Stadt Konstanz, Amt für Stadtplanung und Umwelt
07.02.2022 04:00;4;3;1;Leichter Eisregen;3;-3;0.5;Stadt Konstanz, Amt für Stadtplanung und Umwelt
07.02.2022 05:00;38;27;11;Starker Schneefall;2;-3;0.4;Stadt Konstanz, Amt für Stadtplanung und Umwelt
07.02.2022 06:00;106;62;44;Starker Schneefall;1;-4;0.5;Stadt Konstanz, Amt für Stadtplanung und Umwelt
07.02.2022 07:00;686;406;280;Starker Schneefall;1;-4;0.3;Stadt Konstanz, Amt für Stadtplanung und Umwelt
07.02.2022 08:00;542;289;253;Bewoelkt;1;-4;0;Stadt Konstanz, Amt für Stadtplanung und Umwelt
07.02.2022 09:00;456;256;200;Bewoelkt;1;-4;0;Stadt Konstanz, Amt für Stadtplanung und Umwelt
07.02.2022 10:00;307;171;136;Bewoelkt;2;-3;0;Stadt Konstanz, Amt für Stadtplanung und Umwelt
07.02.2022 11:00;371;174;197;Maessige bis starke Schneefaelle;3;-2;0;Stadt Konstanz, Amt für Stadtplanung und Umwelt
07.02.2022 12:00;409;187;222;Maessige bis starke Schneefaelle;4;-1;0;Stadt Konstanz, Amt für Stadtplanung und Umwelt
07.02.2022 13:00;699;333;366;Maessige bis starke Schneefaelle;4;-1;0;Stadt Konstanz, Amt für Stadtplanung und Umwelt
07.02.2022 14:00;478;219;259;Bewoelkt;4;-1;0;Stadt Konstanz, Amt für Stadtplanung und Umwelt
07.02.2022 15:00;629;303;326;Bewoelkt;4;-1;0;Stadt Konstanz, Amt für Stadtplanung und Umwelt
07.02.2022 16:00;608;270;338;Bewoelkt;3;-1;0;Stadt Konstanz, Amt für Stadtplanung und Umwelt
07.02.2022 17:00;660;285;375;Maessige bis starke Schneefaelle;3;-2;0.1;Stadt Konstanz, Amt für Stadtplanung und Umwelt
07.02.2022 18:00;558;292;266;Maessige bis starke Schneefaelle;2;-2;0.1;Stadt Konstanz, Amt für Stadtplanung und Umwelt
07.02.2022 19:00;383;166;217;Maessige bis starke Schneefaelle;1;-2;0;Stadt Konstanz, Amt für Stadtplanung und Umwelt
07.02.2022 20:00;281;133;148;Sonnig;1;-3;0;Stadt Konstanz, Amt für Stadtplanung und Umwelt
07.02.2022 21:00;150;79;71;Sonnig;0;-3;0;Stadt Konstanz, Amt für Stadtplanung und Umwelt
07.02.2022 22:00;111;57;54;Sonnig;-1;-4;0;Stadt Konstanz, Amt für Stadtplanung und Umwelt
07.02.2022 23:00;52;32;20;Sonnig;-1;-4;0;Stadt Konstanz, Amt für Stadtplanung und Umwelt
08.02.2022 00:00;24;6;18;Sonnig;-2;-5;0;Stadt Konstanz, Amt für Stadtplanung und Umwelt
08.02.2022 01:00;19;9;10;Sonnig;-2;-5;0;Stadt Konstanz, Amt für Stadtplanung und Umwelt
08.02.2022 02:00;7;3;4;Sonnig;-2;-5;0;Stadt Konstanz, Amt für Stadtplanung und Umwelt
08.02.2022 03:00;5;2;3;Sonnig;-2;-4;0;Stadt Konstanz, Amt für Stadtplanung und Umwelt
08.02.2022 04:00;4;3;1;Sonnig;-2;-4;0;Stadt Konstanz, Amt für Stadtplanung und Umwelt
08.02.2022 05:00;48;36;12;Bewoelkt;-2;-4;0;Stadt Konstanz, Amt für Stadtplanung und Umwelt
08.02.2022 06:00;137;78;59;Bewoelkt;-2;-4;0;Stadt Konstanz, Amt für Stadtplanung und Umwelt
08.02.2022 07:00;790;463;327;Bewoelkt;-1;-3;0;Stadt Konstanz, Amt für Stadtplanung und Umwelt
08.02.2022 08:00;630;298;332;Sonnig;-1;-3;0;Stadt Konstanz, Amt für Stadtplanung und Umwelt
08.02.2022 09:00;496;301;195;Sonnig;0;-2;0;Stadt Konstanz, Amt für Stadtplanung und Umwelt
08.02.2022 10:00;386;229;157;Sonnig;2;1;0;Stadt Konstanz, Amt für Stadtplanung und Umwelt
08.02.2022 11:00;438;208;230;Sonnig;4;3;0;Stadt Konstanz, Amt für Stadtplanung und Umwelt
08.02.2022 12:00;466;198;268;Sonnig;6;5;0;Stadt Konstanz, Amt für Stadtplanung und Umwelt
08.02.2022 13:00;763;341;422;Sonnig;6;6;0;Stadt Konstanz, Amt für Stadtplanung und Umwelt
08.02.2022 14:00;575;271;304;Sonnig;7;7;0;Stadt Konstanz, Amt für Stadtplanung und Umwelt
08.02.2022 15:00;751;358;393;Sonnig;8;8;0;Stadt Konstanz, Amt für Stadtplanung und Umwelt
08.02.2022 16:00;734;330;404;Sonnig;6;6;0;Stadt Konstanz, Amt für Stadtplanung und Umwelt
08.02.2022 17:00;837;404;433;Sonnig;4;4;0;Stadt Konstanz, Amt für Stadtplanung und Umwelt
08.02.2022 18:00;655;295;360;Sonnig;3;3;0;Stadt Konstanz, Amt für Stadtplanung und Umwelt
08.02.2022 19:00;439;203;236;Sonnig;2;2;0;Stadt Konstanz, Amt für Stadtplanung und Umwelt
08.02.2022 20:00;265;138;127;Leicht bewoelkt;1;1;0;Stadt Konstanz, Amt für Stadtplanung und Umwelt
08.02.2022 21:00;175;82;93;Leicht bewoelkt;0;0;0;Stadt Konstanz, Amt für Stadtplanung und Umwelt
08.02.2022 22:00;119;51;68;Leicht bewoelkt;0;0;0;Stadt Konstanz, Amt für Stadtplanung und Umwelt
08.02.2022 23:00;84;30;54;Sonnig;-1;-1;0;Stadt Konstanz, Amt für Stadtplanung und Umwelt
09.02.2022 00:00;48;23;25;Sonnig;-1;-1;0;Stadt Konstanz, Amt für Stadtplanung und Umwelt
09.02.2022 01:00;22;8;14;Sonnig;-1;-2;0;Stadt Konstanz, Amt für Stadtplanung und Umwelt
09.02.2022 02:00;26;15;11;Sonnig;-2;-2;0;Stadt Konstanz, Amt für Stadtplanung und Umwelt
09.02.2022 03:00;10;2;8;Sonnig;-2;-3;0;Stadt Konstanz, Amt für Stadtplanung und Umwelt
09.02.2022 04:00;7;6;1;Sonnig;-2;-2;0;Stadt Konstanz, Amt für Stadtplanung und Umwelt
09.02.2022 05:00;47;33;14;Sonnig;-2;-2;0;Stadt Konstanz, Amt für Stadtplanung und Umwelt
09.02.2022 06:00;135;77;58;Sonnig;-2;-2;0;Stadt Konstanz, Amt für Stadtplanung und Umwelt
09.02.2022 07:00;804;480;324;Sonnig;-1;-1;0;Stadt Konstanz, Amt für Stadtplanung und Umwelt
09.02.2022 08:00;627;346;281;Sonnig;-1;-1;0;Stadt Konstanz, Amt für Stadtplanung und Umwelt
09.02.2022 09:00;481;234;247;Sonnig;0;0;0;Stadt Konstanz, Amt für Stadtplanung und Umwelt
09.02.2022 10:00;348;201;147;Sonnig;2;2;0;Stadt Konstanz, Amt für Stadtplanung und Umwelt
09.02.2022 11:00;416;216;200;Sonnig;5;5;0;Stadt Konstanz, Amt für Stadtplanung und Umwelt
09.02.2022 12:00;528;255;273;Sonnig;7;7;0;Stadt Konstanz, Amt für Stadtplanung und Umwelt
09.02.2022 13:00;807;342;465;Sonnig;8;8;0;Stadt Konstanz, Amt für Stadtplanung und Umwelt
09.02.2022 14:00;559;269;290;Sonnig;9;9;0;Stadt Konstanz, Amt für Stadtplanung und Umwelt
09.02.2022 15:00;791;357;434;Sonnig;10;10;0;Stadt Konstanz, Amt für Stadtplanung und Umwelt
09.02.2022 16:00;689;321;368;Sonnig;8;8;0;Stadt Konstanz, Amt für Stadtplanung und Umwelt
09.02.2022 17:00;819;403;416;Sonnig;6;6;0;Stadt Konstanz, Amt für Stadtplanung und Umwelt
09.02.2022 18:00;583;257;326;Sonnig;4;4;0;Stadt Konstanz, Amt für Stadtplanung und Umwelt
09.02.2022 19:00;396;198;198;Sonnig;2;2;0;Stadt Konstanz, Amt für Stadtplanung und Umwelt
09.02.2022 20:00;274;129;145;Sonnig;1;1;0;Stadt Konstanz, Amt für Stadtplanung und Umwelt
09.02.2022 21:00;172;83;89;Sonnig;-1;-1;0;Stadt Konstanz, Amt für Stadtplanung und Umwelt
09.02.2022 22:00;141;77;64;Sonnig;-1;-1;0;Stadt Konstanz, Amt für Stadtplanung und Umwelt
09.02.2022 23:00;67;28;39;Sonnig;-1;-2;0;Stadt Konstanz, Amt für Stadtplanung und Umwelt
10.02.2022 00:00;53;14;39;Sonnig;-1;-2;0;Stadt Konstanz, Amt für Stadtplanung und Umwelt
10.02.2022 01:00;27;9;18;Sonnig;-1;-3;0;Stadt Konstanz, Amt für Stadtplanung und Umwelt
10.02.2022 02:00;4;3;1;Sonnig;-1;-3;0;Stadt Konstanz, Amt für Stadtplanung und Umwelt
10.02.2022 03:00;8;3;5;Sonnig;-1;-3;0;Stadt Konstanz, Amt für Stadtplanung und Umwelt
10.02.2022 04:00;5;4;1;Sonnig;-1;-3;0;Stadt Konstanz, Amt für Stadtplanung und Umwelt
10.02.2022 05:00;43;28;15;Sonnig;-1;-3;0;Stadt Konstanz, Amt für Stadtplanung und Umwelt
10.02.2022 06:00;122;65;57;Sonnig;-1;-3;0;Stadt Konstanz, Amt für Stadtplanung und Umwelt
10.02.2022 07:00;785;475;310;Sonnig;-1;-2;0;Stadt Konstanz, Amt für Stadtplanung und Umwelt
10.02.2022 08:00;660;347;313;Sonnig;0;-2;0;Stadt Konstanz, Amt für Stadtplanung und Umwelt
10.02.2022 09:00;518;247;271;Sonnig;1;-1;0;Stadt Konstanz, Amt für Stadtplanung und Umwelt
10.02.2022 10:00;369;189;180;Sonnig;4;2;0;Stadt Konstanz, Amt für Stadtplanung und Umwelt
10.02.2022 11:00;421;199;222;Sonnig;7;5;0;Stadt Konstanz, Amt für Stadtplanung und Umwelt
10.02.2022 12:00;537;263;274;Sonnig;10;9;0;Stadt Konstanz, Amt für Stadtplanung und Umwelt
10.02.2022 13:00;759;348;411;Sonnig;11;9;0;Stadt Konstanz, Amt für Stadtplanung und Umwelt
10.02.2022 14:00;539;243;296;Sonnig;11;10;0;Stadt Konstanz, Amt für Stadtplanung und Umwelt
10.02.2022 15:00;736;358;378;Sonnig;12;10;0;Stadt Konstanz, Amt für Stadtplanung und Umwelt
10.02.2022 16:00;798;399;399;Sonnig;9;8;0;Stadt Konstanz, Amt für Stadtplanung und Umwelt
10.02.2022 17:00;883;376;507;Sonnig;7;5;0;Stadt Konstanz, Amt für Stadtplanung und Umwelt
10.02.2022 18:00;625;271;354;Sonnig;4;2;0;Stadt Konstanz, Amt für Stadtplanung und Umwelt
10.02.2022 19:00;486;256;230;Sonnig;4;2;0;Stadt Konstanz, Amt für Stadtplanung und Umwelt
10.02.2022 20:00;281;133;148;Leicht bewoelkt;3;2;0;Stadt Konstanz, Amt für Stadtplanung und Umwelt
10.02.2022 21:00;167;72;95;Leicht bewoelkt;3;1;0;Stadt Konstanz, Amt für Stadtplanung und Umwelt
10.02.2022 22:00;152;61;91;Leicht bewoelkt;3;1;0;Stadt Konstanz, Amt für Stadtplanung und Umwelt
10.02.2022 23:00;136;51;85;Leicht bewoelkt;3;2;0;Stadt Konstanz, Amt für Stadtplanung und Umwelt
11.02.2022 00:00;44;17;27;Leicht bewoelkt;4;2;0;Stadt Konstanz, Amt für Stadtplanung und Umwelt
11.02.2022 01:00;26;7;19;Leicht bewoelkt;3;1;0;Stadt Konstanz, Amt für Stadtplanung und Umwelt
11.02.2022 02:00;21;13;8;Bedeckt;3;1;0;Stadt Konstanz, Amt für Stadtplanung und Umwelt
11.02.2022 03:00;2;0;2;Bedeckt;3;1;0;Stadt Konstanz, Amt für Stadtplanung und Umwelt
11.02.2022 04:00;5;2;3;Bedeckt;3;1;0;Stadt Konstanz, Amt für Stadtplanung und Umwelt
11.02.2022 05:00;29;22;7;Nieselregen;4;1;0.1;Stadt Konstanz, Amt für Stadtplanung und Umwelt
11.02.2022 06:00;98;58;40;Nieselregen;4;2;0.1;Stadt Konstanz, Amt für Stadtplanung und Umwelt
11.02.2022 07:00;635;378;257;Nieselregen;3;0;0.1;Stadt Konstanz, Amt für Stadtplanung und Umwelt
11.02.2022 08:00;531;297;234;Starker Schneefall;3;-1;0.5;Stadt Konstanz, Amt für Stadtplanung und Umwelt
11.02.2022 09:00;469;284;185;Starker Schneefall;2;-2;0.7;Stadt Konstanz, Amt für Stadtplanung und Umwelt
11.02.2022 10:00;387;223;164;Starker Schneefall;2;-1;0.3;Stadt Konstanz, Amt für Stadtplanung und Umwelt
11.02.2022 11:00;432;216;216;Starker Schneefall;2;0;0.5;Stadt Konstanz, Amt für Stadtplanung und Umwelt
11.02.2022 12:00;589;282;307;Starker Schneefall;2;1;0.6;Stadt Konstanz, Amt für Stadtplanung und Umwelt
11.02.2022 13:00;733;321;412;Starker Schneefall;2;1;0.3;Stadt Konstanz, Amt für Stadtplanung und Umwelt
11.02.2022 14:00;606;295;311;Leichte Schneeschauer;2;1;0;Stadt Konstanz, Amt für Stadtplanung und Umwelt
11.02.2022 15:00;595;290;305;Leichte Schneeschauer;3;2;0;Stadt Konstanz, Amt für Stadtplanung und Umwelt
11.02.2022 16:00;571;284;287;Leichte Schneeschauer;2;2;0;Stadt Konstanz, Amt für Stadtplanung und Umwelt
11.02.2022 17:00;627;274;353;Maessige bis starke Schneefaelle;2;2;0;Stadt Konstanz, Amt für Stadtplanung und Umwelt
11.02.2022 18:00;445;193;252;Maessige bis starke Schneefaelle;2;2;0;Stadt Konstanz, Amt für Stadtplanung und Umwelt
11.02.2022 19:00;399;213;186;Maessige bis starke Schneefaelle;1;1;0;Stadt Konstanz, Amt für Stadtplanung und Umwelt
11.02.2022 20:00;254;128;126;Bedeckt;0;0;0;Stadt Konstanz, Amt für Stadtplanung und Umwelt
11.02.2022 21:00;157;97;60;Bedeckt;-1;-1;0;Stadt Konstanz, Amt für Stadtplanung und Umwelt
11.02.2022 22:00;166;69;97;Bedeckt;-1;-2;0;Stadt Konstanz, Amt für Stadtplanung und Umwelt
11.02.2022 23:00;128;58;70;Sonnig;-2;-3;0;Stadt Konstanz, Amt für Stadtplanung und Umwelt
12.02.2022 00:00;110;40;70;Sonnig;-3;-5;0;Stadt Konstanz, Amt für Stadtplanung und Umwelt
12.02.2022 01:00;84;35;49;Sonnig;-3;-5;0;Stadt Konstanz, Amt für Stadtplanung und Umwelt
12.02.2022 02:00;44;12;32;Leicht bewoelkt;-3;-5;0;Stadt Konstanz, Amt für Stadtplanung und Umwelt
12.02.2022 03:00;36;8;28;Leicht bewoelkt;-3;-5;0;Stadt Konstanz, Amt für Stadtplanung und Umwelt
12.02.2022 04:00;20;9;11;Leicht bewoelkt;-4;-6;0;Stadt Konstanz, Amt für Stadtplanung und Umwelt
12.02.2022 05:00;22;8;14;Sonnig;-4;-7;0;Stadt Konstanz, Amt für Stadtplanung und Umwelt
12.02.2022 06:00;54;40;14;Sonnig;-5;-7;0;Stadt Konstanz, Amt für Stadtplanung und Umwelt
12.02.2022 07:00;59;27;32;Sonnig;-4;-7;0;Stadt Konstanz, Amt für Stadtplanung und Umwelt
12.02.2022 08:00;127;69;58;Sonnig;-3;-6;0;Stadt Konstanz, Amt für Stadtplanung und Umwelt
12.02.2022 09:00;282;152;130;Sonnig;-3;-5;0;Stadt Konstanz, Amt für Stadtplanung und Umwelt
12.02.2022 10:00;374;195;179;Sonnig;-1;-3;0;Stadt Konstanz, Amt für Stadtplanung und Umwelt
12.02.2022 11:00;409;212;197;Sonnig;1;-1;0;Stadt Konstanz, Amt für Stadtplanung und Umwelt
12.02.2022 12:00;454;230;224;Sonnig;3;1;0;Stadt Konstanz, Amt für Stadtplanung und Umwelt
12.02.2022 13:00;485;235;250;Sonnig;4;3;0;Stadt Konstanz, Amt für Stadtplanung und Umwelt
12.02.2022 14:00;512;259;253;Sonnig;5;4;0;Stadt Konstanz, Amt für Stadtplanung und Umwelt
12.02.2022 15:00;486;215;271;Sonnig;6;6;0;Stadt Konstanz, Amt für Stadtplanung und Umwelt
12.02.2022 16:00;426;187;239;Sonnig;4;3;0;Stadt Konstanz, Amt für Stadtplanung und Umwelt
12.02.2022 17:00;434;219;215;Sonnig;2;1;0;Stadt Konstanz, Amt für Stadtplanung und Umwelt
12.02.2022 18:00;337;164;173;Sonnig;0;-2;0;Stadt Konstanz, Amt für Stadtplanung und Umwelt
12.02.2022 19:00;277;146;131;Sonnig;-1;-2;0;Stadt Konstanz, Amt für Stadtplanung und Umwelt
12.02.2022 20:00;206;123;83;Sonnig;-2;-3;0;Stadt Konstanz, Amt für Stadtplanung und Umwelt
12.02.2022 21:00;142;75;67;Sonnig;-4;-4;0;Stadt Konstanz, Amt für Stadtplanung und Umwelt
12.02.2022 22:00;129;51;78;Sonnig;-3;-4;0;Stadt Konstanz, Amt für Stadtplanung und Umwelt
12.02.2022 23:00;93;32;61;Bedeckt;-3;-5;0;Stadt Konstanz, Amt für Stadtplanung und Umwelt
13.02.2022 00:00;92;34;58;Bedeckt;-3;-5;0;Stadt Konstanz, Amt für Stadtplanung und Umwelt
13.02.2022 01:00;90;32;58;Bedeckt;-3;-5;0;Stadt Konstanz, Amt für Stadtplanung und Umwelt
13.02.2022 02:00;59;22;37;Sonnig;-3;-6;0;Stadt Konstanz, Amt für Stadtplanung und Umwelt
13.02.2022 03:00;47;17;30;Sonnig;-3;-6;0;Stadt Konstanz, Amt für Stadtplanung und Umwelt
13.02.2022 04:00;9;5;4;Sonnig;-3;-6;0;Stadt Konstanz, Amt für Stadtplanung und Umwelt
13.02.2022 05:00;12;5;7;Sonnig;-3;-6;0;Stadt Konstanz, Amt für Stadtplanung und Umwelt
13.02.2022 06:00;28;22;6;Sonnig;-3;-6;0;Stadt Konstanz, Amt für Stadtplanung und Umwelt
13.02.2022 07:00;47;19;28;Sonnig;-2;-4;0;Stadt Konstanz, Amt für Stadtplanung und Umwelt
13.02.2022 08:00;68;33;35;Sonnig;-1;-3;0;Stadt Konstanz, Amt für Stadtplanung und Umwelt
13.02.2022 09:00;138;78;60;Sonnig;0;-2;0;Stadt Konstanz, Amt für Stadtplanung und Umwelt
13.02.2022 10:00;178;99;79;Sonnig;2;1;0;Stadt Konstanz, Amt für Stadtplanung und Umwelt
13.02.2022 11:00;263;129;134;Sonnig;5;4;0;Stadt Konstanz, Amt für Stadtplanung und Umwelt
13.02.2022 12:00;275;131;144;Sonnig;7;7;0;Stadt Konstanz, Amt für Stadtplanung und Umwelt
13.02.2022 13:00;359;181;178;Sonnig;8;8;0;Stadt Konstanz, Amt für Stadtplanung und Umwelt
13.02.2022 14:00;394;187;207;Sonnig;9;9;0;Stadt Konstanz, Amt für Stadtplanung und Umwelt
13.02.2022 15:00;395;194;201;Sonnig;9;10;0;Stadt Konstanz, Amt für Stadtplanung und Umwelt
13.02.2022 16:00;443;199;244;Sonnig;6;7;0;Stadt Konstanz, Amt für Stadtplanung und Umwelt
13.02.2022 17:00;393;179;214;Leicht bewoelkt;4;4;0;Stadt Konstanz, Amt für Stadtplanung und Umwelt
13.02.2022 18:00;274;119;155;Leicht bewoelkt;1;1;0;Stadt Konstanz, Amt für Stadtplanung und Umwelt
13.02.2022 19:00;152;80;72;Leicht bewoelkt;0;-1;0;Stadt Konstanz, Amt für Stadtplanung und Umwelt
13.02.2022 20:00;145;62;83;Sonnig;-1;-3;0;Stadt Konstanz, Amt für Stadtplanung und Umwelt
13.02.2022 21:00;83;48;35;Sonnig;-1;-4;0;Stadt Konstanz, Amt für Stadtplanung und Umwelt
13.02.2022 22:00;80;39;41;Sonnig;-2;-5;0;Stadt Konstanz, Amt für Stadtplanung und Umwelt
13.02.2022 23:00;51;25;26;Sonnig;-2;-5;0;Stadt Konstanz, Amt für Stadtplanung und Umwelt
14.02.2022 00:00;18;8;10;Sonnig;-3;-6;0;Stadt Konstanz, Amt für Stadtplanung und Umwelt
14.02.2022 01:00;14;12;2;Sonnig;-3;-6;0;Stadt Konstanz, Amt für Stadtplanung und Umwelt
14.02.2022 02:00;11;6;5;Sonnig;-3;-6;0;Stadt Konstanz, Amt für Stadtplanung und Umwelt
14.02.2022 03:00;3;1;2;Sonnig;-3;-6;0;Stadt Konstanz, Amt für Stadtplanung und Umwelt
14.02.2022 04:00;39;17;22;Sonnig;-3;-6;0;Stadt Konstanz, Amt für Stadtplanung und Umwelt
14.02.2022 05:00;48;28;20;Sonnig;-3;-6;0;Stadt Konstanz, Amt für Stadtplanung und Umwelt
14.02.2022 06:00;125;71;54;Sonnig;-3;-7;0;Stadt Konstanz, Amt für Stadtplanung und Umwelt
14.02.2022 07:00;809;467;342;Sonnig;-2;-5;0;Stadt Konstanz, Amt für Stadtplanung und Umwelt
14.02.2022 08:00;629;339;290;Sonnig;-1;-4;0;Stadt Konstanz, Amt für Stadtplanung und Umwelt
14.02.2022 09:00;444;253;191;Sonnig;0;-2;0;Stadt Konstanz, Amt für Stadtplanung und Umwelt
14.02.2022 10:00;315;163;152;Sonnig;2;0;0;Stadt Konstanz, Amt für Stadtplanung und Umwelt
14.02.2022 11:00;407;167;240;Sonnig;5;3;0;Stadt Konstanz, Amt für Stadtplanung und Umwelt
14.02.2022 12:00;490;211;279;Sonnig;7;6;0;Stadt Konstanz, Amt für Stadtplanung und Umwelt
14.02.2022 13:00;705;317;388;Sonnig;8;7;0;Stadt Konstanz, Amt für Stadtplanung und Umwelt
14.02.2022 14:00;474;234;240;Sonnig;9;8;0;Stadt Konstanz, Amt für Stadtplanung und Umwelt
14.02.2022 15:00;698;356;342;Sonnig;9;9;0;Stadt Konstanz, Amt für Stadtplanung und Umwelt
14.02.2022 16:00;639;302;337;Sonnig;7;7;0;Stadt Konstanz, Amt für Stadtplanung und Umwelt
14.02.2022 17:00;756;350;406;Leicht bewoelkt;4;4;0;Stadt Konstanz, Amt für Stadtplanung und Umwelt
14.02.2022 18:00;548;262;286;Leicht bewoelkt;2;1;0;Stadt Konstanz, Amt für Stadtplanung und Umwelt
14.02.2022 19:00;412;192;220;Leicht bewoelkt;2;1;0;Stadt Konstanz, Amt für Stadtplanung und Umwelt
14.02.2022 20:00;268;118;150;Bewoelkt;2;1;0;Stadt Konstanz, Amt für Stadtplanung und Umwelt
14.02.2022 21:00;143;69;74;Bewoelkt;2;0;0;Stadt Konstanz, Amt für Stadtplanung und Umwelt
14.02.2022 22:00;120;57;63;Bewoelkt;1;0;0;Stadt Konstanz, Amt für Stadtplanung und Umwelt
14.02.2022 23:00;65;38;27;Bewoelkt;1;-1;0;Stadt Konstanz, Amt für Stadtplanung und Umwelt
15.02.2022 00:00;33;17;16;Bewoelkt;0;-1;0;Stadt Konstanz, Amt für Stadtplanung und Umwelt
15.02.2022 01:00;23;3;20;Bewoelkt;1;-1;0;Stadt Konstanz, Amt für Stadtplanung und Umwelt
15.02.2022 02:00;7;1;6;Bedeckt;1;-1;0;Stadt Konstanz, Amt für Stadtplanung und Umwelt
15.02.2022 03:00;1;1;0;Bedeckt;1;0;0;Stadt Konstanz, Amt für Stadtplanung und Umwelt
15.02.2022 04:00;7;3;4;Bedeckt;1;0;0;Stadt Konstanz, Amt für Stadtplanung und Umwelt
15.02.2022 05:00;41;32;9;Nebel;2;0;0;Stadt Konstanz, Amt für Stadtplanung und Umwelt
15.02.2022 06:00;149;89;60;Nebel;2;0;0;Stadt Konstanz, Amt für Stadtplanung und Umwelt
15.02.2022 07:00;777;454;323;Nebel;2;1;0;Stadt Konstanz, Amt für Stadtplanung und Umwelt
15.02.2022 08:00;625;320;305;Nebel;2;1;0;Stadt Konstanz, Amt für Stadtplanung und Umwelt
15.02.2022 09:00;504;306;198;Nebel;2;2;0;Stadt Konstanz, Amt für Stadtplanung und Umwelt
15.02.2022 10:00;359;207;152;Nebel;3;2;0;Stadt Konstanz, Amt für Stadtplanung und Umwelt
15.02.2022 11:00;419;203;216;Nebel;3;2;0;Stadt Konstanz, Amt für Stadtplanung und Umwelt
15.02.2022 12:00;462;210;252;Nebel;3;3;0;Stadt Konstanz, Amt für Stadtplanung und Umwelt
15.02.2022 13:00;641;290;351;Nebel;3;2;0;Stadt Konstanz, Amt für Stadtplanung und Umwelt
15.02.2022 14:00;442;212;230;Leichter Nebel;4;2;0;Stadt Konstanz, Amt für Stadtplanung und Umwelt
15.02.2022 15:00;642;311;331;Leichter Nebel;4;2;0;Stadt Konstanz, Amt für Stadtplanung und Umwelt
15.02.2022 16:00;661;337;324;Leichter Nebel;3;2;0;Stadt Konstanz, Amt für Stadtplanung und Umwelt
15.02.2022 17:00;728;315;413;Nebel;3;2;0;Stadt Konstanz, Amt für Stadtplanung und Umwelt
15.02.2022 18:00;577;270;307;Nebel;3;1;0;Stadt Konstanz, Amt für Stadtplanung und Umwelt
15.02.2022 19:00;409;205;204;Nebel;3;1;0;Stadt Konstanz, Amt für Stadtplanung und Umwelt
15.02.2022 20:00;263;130;133;Leicht bewoelkt;3;0;0;Stadt Konstanz, Amt für Stadtplanung und Umwelt
15.02.2022 21:00;140;67;73;Leicht bewoelkt;3;0;0;Stadt Konstanz, Amt für Stadtplanung und Umwelt
15.02.2022 22:00;137;48;89;Leicht bewoelkt;2;-1;0;Stadt Konstanz, Amt für Stadtplanung und Umwelt
15.02.2022 23:00;81;33;48;Sonnig;1;-1;0;Stadt Konstanz, Amt für Stadtplanung und Umwelt
16.02.2022 00:00;34;12;22;Sonnig;0;-2;0;Stadt Konstanz, Amt für Stadtplanung und Umwelt
16.02.2022 01:00;19;8;11;Sonnig;0;-2;0;Stadt Konstanz, Amt für Stadtplanung und Umwelt
16.02.2022 02:00;6;0;6;Sonnig;0;-2;0;Stadt Konstanz, Amt für Stadtplanung und Umwelt
16.02.2022 03:00;7;2;5;Sonnig;0;-2;0;Stadt Konstanz, Amt für Stadtplanung und Umwelt
16.02.2022 04:00;4;4;0;Sonnig;0;-3;0;Stadt Konstanz, Amt für Stadtplanung und Umwelt
16.02.2022 05:00;45;35;10;Bedeckt;0;-3;0;Stadt Konstanz, Amt für Stadtplanung und Umwelt
16.02.2022 06:00;149;74;75;Bedeckt;1;-3;0;Stadt Konstanz, Amt für Stadtplanung und Umwelt
16.02.2022 07:00;777;441;336;Bedeckt;1;-2;0;Stadt Konstanz, Amt für Stadtplanung und Umwelt
16.02.2022 08:00;611;347;264;Bedeckt;2;-1;0;Stadt Konstanz, Amt für Stadtplanung und Umwelt
16.02.2022 09:00;467;281;186;Bedeckt;2;0;0;Stadt Konstanz, Amt für Stadtplanung und Umwelt
16.02.2022 10:00;347;179;168;Bedeckt;3;0;0;Stadt Konstanz, Amt für Stadtplanung und Umwelt
16.02.2022 11:00;345;168;177;Nieselregen;3;1;0.1;Stadt Konstanz, Amt für Stadtplanung und Umwelt
16.02.2022 12:00;435;206;229;Nieselregen;4;1;0.1;Stadt Konstanz, Amt für Stadtplanung und Umwelt
16.02.2022 13:00;740;299;441;Nieselregen;4;1;0;Stadt Konstanz, Amt für Stadtplanung und Umwelt
16.02.2022 14:00;429;190;239;Nieselregen;4;2;0.1;Stadt Konstanz, Amt für Stadtplanung und Umwelt
16.02.2022 15:00;546;259;287;Nieselregen;4;2;0.1;Stadt Konstanz, Amt für Stadtplanung und Umwelt
16.02.2022 16:00;587;294;293;Nieselregen;4;2;0;Stadt Konstanz, Amt für Stadtplanung und Umwelt
16.02.2022 17:00;614;294;320;Nieselregen;5;2;0.2;Stadt Konstanz, Amt für Stadtplanung und Umwelt
16.02.2022 18:00;488;214;274;Nieselregen;5;2;0.3;Stadt Konstanz, Amt für Stadtplanung und Umwelt
16.02.2022 19:00;342;174;168;Nieselregen;6;3;0.1;Stadt Konstanz, Amt für Stadtplanung und Umwelt
16.02.2022 20:00;281;139;142;Nieselregen;6;3;0.2;Stadt Konstanz, Amt für Stadtplanung und Umwelt
16.02.2022 21:00;140;68;72;Nieselregen;7;4;0.3;Stadt Konstanz, Amt für Stadtplanung und Umwelt
16.02.2022 22:00;115;66;49;Nieselregen;7;4;0.1;Stadt Konstanz, Amt für Stadtplanung und Umwelt
16.02.2022 23:00;95;36;59;Nieselregen;8;5;0.2;Stadt Konstanz, Amt für Stadtplanung und Umwelt
17.02.2022 00:00;52;19;33;Nieselregen;9;5;0.3;Stadt Konstanz, Amt für Stadtplanung und Umwelt
17.02.2022 01:00;25;4;21;Nieselregen;9;5;0.2;Stadt Konstanz, Amt für Stadtplanung und Umwelt
17.02.2022 02:00;17;7;10;Bewoelkt;9;6;0;Stadt Konstanz, Amt für Stadtplanung und Umwelt
17.02.2022 03:00;5;0;5;Bewoelkt;10;6;0;Stadt Konstanz, Amt für Stadtplanung und Umwelt
17.02.2022 04:00;9;6;3;Bewoelkt;10;6;0;Stadt Konstanz, Amt für Stadtplanung und Umwelt
17.02.2022 05:00;30;22;8;Bewoelkt;10;6;0;Stadt Konstanz, Amt für Stadtplanung und Umwelt
17.02.2022 06:00;110;62;48;Bewoelkt;10;7;0;Stadt Konstanz, Amt für Stadtplanung und Umwelt
17.02.2022 07:00;649;371;278;Bewoelkt;10;7;0;Stadt Konstanz, Amt für Stadtplanung und Umwelt
17.02.2022 08:00;491;266;225;Bedeckt;10;7;0;Stadt Konstanz, Amt für Stadtplanung und Umwelt
17.02.2022 09:00;367;201;166;Bedeckt;10;7;0;Stadt Konstanz, Amt für Stadtplanung und Umwelt
17.02.2022 10:00;279;167;112;Bedeckt;11;7;0;Stadt Konstanz, Amt für Stadtplanung und Umwelt
17.02.2022 11:00;343;183;160;Stellenweiser Regenfall;11;8;0;Stadt Konstanz, Amt für Stadtplanung und Umwelt
17.02.2022 12:00;402;175;227;Stellenweiser Regenfall;11;8;0;Stadt Konstanz, Amt für Stadtplanung und Umwelt
17.02.2022 13:00;599;249;350;Stellenweiser Regenfall;11;7;0;Stadt Konstanz, Amt für Stadtplanung und Umwelt
17.02.2022 14:00;411;209;202;Leichter Regenschauer;10;7;0.1;Stadt Konstanz, Amt für Stadtplanung und Umwelt
17.02.2022 15:00;614;269;345;Leichter Regenschauer;9;6;0.1;Stadt Konstanz, Amt für Stadtplanung und Umwelt
17.02.2022 16:00;501;261;240;Leichter Regenschauer;8;5;0;Stadt Konstanz, Amt für Stadtplanung und Umwelt
17.02.2022 17:00;673;284;389;Stellenweiser Regenfall;8;4;0;Stadt Konstanz, Amt für Stadtplanung und Umwelt
17.02.2022 18:00;549;251;298;Stellenweiser Regenfall;7;4;0;Stadt Konstanz, Amt für Stadtplanung und Umwelt
17.02.2022 19:00;417;212;205;Stellenweiser Regenfall;7;4;0;Stadt Konstanz, Amt für Stadtplanung und Umwelt
17.02.2022 20:00;260;109;151;Bedeckt;8;4;0;Stadt Konstanz, Amt für Stadtplanung und Umwelt
17.02.2022 21:00;159;76;83;Bedeckt;8;4;0;Stadt Konstanz, Amt für Stadtplanung und Umwelt
17.02.2022 22:00;139;70;69;Bedeckt;8;5;0;Stadt Konstanz, Amt für Stadtplanung und Umwelt
17.02.2022 23:00;102;48;54;Stellenweiser Regenfall;8;5;0;Stadt Konstanz, Amt für Stadtplanung und Umwelt
18.02.2022 00:00;44;22;22;Stellenweiser Regenfall;8;6;0.1;Stadt Konstanz, Amt für Stadtplanung und Umwelt
18.02.2022 01:00;45;16;29;Stellenweiser Regenfall;7;5;0;Stadt Konstanz, Amt für Stadtplanung und Umwelt
18.02.2022 02:00;12;5;7;Bedeckt;7;5;0;Stadt Konstanz, Amt für Stadtplanung und Umwelt
18.02.2022 03:00;10;4;6;Bedeckt;6;4;0;Stadt Konstanz, Amt für Stadtplanung und Umwelt
18.02.2022 04:00;13;9;4;Bedeckt;6;4;0;Stadt Konstanz, Amt für Stadtplanung und Umwelt
18.02.2022 05:00;35;24;11;Leicht bewoelkt;5;4;0;Stadt Konstanz, Amt für Stadtplanung und Umwelt
18.02.2022 06:00;143;86;57;Leicht bewoelkt;5;4;0;Stadt Konstanz, Amt für Stadtplanung und Umwelt
18.02.2022 07:00;704;400;304;Leicht bewoelkt;6;4;0;Stadt Konstanz, Amt für Stadtplanung und Umwelt
18.02.2022 08:00;569;313;256;Bedeckt;6;5;0;Stadt Konstanz, Amt für Stadtplanung und Umwelt
18.02.2022 09:00;562;353;209;Bedeckt;7;6;0;Stadt Konstanz, Amt für Stadtplanung und Umwelt
18.02.2022 10:00;413;216;197;Bedeckt;9;7;0;Stadt Konstanz, Amt für Stadtplanung und Umwelt
18.02.2022 11:00;509;251;258;Sonnig;10;9;0;Stadt Konstanz, Amt für Stadtplanung und Umwelt
18.02.2022 12:00;660;315;345;Sonnig;12;11;0;Stadt Konstanz, Amt für Stadtplanung und Umwelt
18.02.2022 13:00;745;271;474;Sonnig;12;11;0;Stadt Konstanz, Amt für Stadtplanung und Umwelt
18.02.2022 14:00;585;299;286;Leicht bewoelkt;12;12;0;Stadt Konstanz, Amt für Stadtplanung und Umwelt
18.02.2022 15:00;622;302;320;Leicht bewoelkt;13;13;0;Stadt Konstanz, Amt für Stadtplanung und Umwelt
18.02.2022 16:00;639;319;320;Leicht bewoelkt;12;11;0;Stadt Konstanz, Amt für Stadtplanung und Umwelt
18.02.2022 17:00;589;277;312;Sonnig;10;9;0;Stadt Konstanz, Amt für Stadtplanung und Umwelt
18.02.2022 18:00;549;250;299;Sonnig;9;8;0;Stadt Konstanz, Amt für Stadtplanung und Umwelt
18.02.2022 19:00;391;194;197;Sonnig;9;7;0;Stadt Konstanz, Amt für Stadtplanung und Umwelt
18.02.2022 20:00;296;174;122;Sonnig;9;7;0;Stadt Konstanz, Amt für Stadtplanung und Umwelt
18.02.2022 21:00;211;108;103;Sonnig;9;6;0;Stadt Konstanz, Amt für Stadtplanung und Umwelt
18.02.2022 22:00;176;80;96;Sonnig;8;5;0;Stadt Konstanz, Amt für Stadtplanung und Umwelt
18.02.2022 23:00;127;51;76;Leichter Regenfall;7;4;0.3;Stadt Konstanz, Amt für Stadtplanung und Umwelt
19.02.2022 00:00;103;41;62;Leichter Regenfall;7;3;0.5;Stadt Konstanz, Amt für Stadtplanung und Umwelt
19.02.2022 01:00;64;26;38;Leichter Regenfall;6;2;0.3;Stadt Konstanz, Amt für Stadtplanung und Umwelt
19.02.2022 02:00;54;18;36;Leichter Regenfall;5;1;0.4;Stadt Konstanz, Amt für Stadtplanung und Umwelt
19.02.2022 03:00;34;9;25;Leichter Regenfall;4;0;0.5;Stadt Konstanz, Amt für Stadtplanung und Umwelt
19.02.2022 04:00;35;17;18;Leichter Regenfall;4;0;0.3;Stadt Konstanz, Amt für Stadtplanung und Umwelt
19.02.2022 05:00;28;20;8;Leichte Eisregen;4;0;0.3;Stadt Konstanz, Amt für Stadtplanung und Umwelt
19.02.2022 06:00;36;20;16;Leichte Eisregen;4;0;0.4;Stadt Konstanz, Amt für Stadtplanung und Umwelt
19.02.2022 07:00;56;20;36;Leichte Eisregen;4;0;0.2;Stadt Konstanz, Amt für Stadtplanung und Umwelt
19.02.2022 08:00;124;69;55;Stellenweiser Regenfall;4;0;0;Stadt Konstanz, Amt für Stadtplanung und Umwelt
19.02.2022 09:00;237;130;107;Stellenweiser Regenfall;4;0;0;Stadt Konstanz, Amt für Stadtplanung und Umwelt
19.02.2022 10:00;297;164;133;Stellenweiser Regenfall;5;1;0;Stadt Konstanz, Amt für Stadtplanung und Umwelt
19.02.2022 11:00;404;229;175;Stellenweiser Regenfall;6;2;0;Stadt Konstanz, Amt für Stadtplanung und Umwelt
19.02.2022 12:00;454;249;205;Stellenweiser Regenfall;6;2;0;Stadt Konstanz, Amt für Stadtplanung und Umwelt
19.02.2022 13:00;445;218;227;Stellenweiser Regenfall;6;3;0;Stadt Konstanz, Amt für Stadtplanung und Umwelt
19.02.2022 14:00;461;231;230;Leicht bewoelkt;7;3;0;Stadt Konstanz, Amt für Stadtplanung und Umwelt
19.02.2022 15:00;484;232;252;Leicht bewoelkt;7;4;0;Stadt Konstanz, Amt für Stadtplanung und Umwelt
19.02.2022 16:00;453;226;227;Leicht bewoelkt;5;3;0;Stadt Konstanz, Amt für Stadtplanung und Umwelt
19.02.2022 17:00;427;179;248;Leicht bewoelkt;4;1;0;Stadt Konstanz, Amt für Stadtplanung und Umwelt
19.02.2022 18:00;400;174;226;Leicht bewoelkt;3;0;0;Stadt Konstanz, Amt für Stadtplanung und Umwelt
19.02.2022 19:00;285;160;125;Leicht bewoelkt;2;0;0;Stadt Konstanz, Amt für Stadtplanung und Umwelt
19.02.2022 20:00;228;100;128;Leicht bewoelkt;1;-1;0;Stadt Konstanz, Amt für Stadtplanung und Umwelt
19.02.2022 21:00;144;72;72;Leicht bewoelkt;0;-2;0;Stadt Konstanz, Amt für Stadtplanung und Umwelt
19.02.2022 22:00;118;46;72;Leicht bewoelkt;1;-2;0;Stadt Konstanz, Amt für Stadtplanung und Umwelt
19.02.2022 23:00;113;48;65;Leicht bewoelkt;1;-2;0;Stadt Konstanz, Amt für Stadtplanung und Umwelt
20.02.2022 00:00;68;26;42;Leicht bewoelkt;1;-3;0;Stadt Konstanz, Amt für Stadtplanung und Umwelt
20.02.2022 01:00;67;23;44;Leicht bewoelkt;2;-2;0;Stadt Konstanz, Amt für Stadtplanung und Umwelt
20.02.2022 02:00;44;9;35;Bedeckt;2;-2;0;Stadt Konstanz, Amt für Stadtplanung und Umwelt
20.02.2022 03:00;37;6;31;Bedeckt;3;-2;0;Stadt Konstanz, Amt für Stadtplanung und Umwelt
20.02.2022 04:00;22;7;15;Bedeckt;3;-2;0;Stadt Konstanz, Amt für Stadtplanung und Umwelt
20.02.2022 05:00;14;5;9;Bedeckt;3;-2;0;Stadt Konstanz, Amt für Stadtplanung und Umwelt
20.02.2022 06:00;17;10;7;Bedeckt;3;-2;0;Stadt Konstanz, Amt für Stadtplanung und Umwelt
20.02.2022 07:00;31;12;19;Bedeckt;3;-1;0;Stadt Konstanz, Amt für Stadtplanung und Umwelt
20.02.2022 08:00;45;21;24;Bedeckt;3;-1;0;Stadt Konstanz, Amt für Stadtplanung und Umwelt
20.02.2022 09:00;130;64;66;Bedeckt;3;-1;0;Stadt Konstanz, Amt für Stadtplanung und Umwelt
20.02.2022 10:00;169;93;76;Bedeckt;5;1;0;Stadt Konstanz, Amt für Stadtplanung und Umwelt
20.02.2022 11:00;231;115;116;Bedeckt;6;2;0;Stadt Konstanz, Amt für Stadtplanung und Umwelt
20.02.2022 12:00;240;105;135;Bedeckt;7;4;0;Stadt Konstanz, Amt für Stadtplanung und Umwelt
20.02.2022 13:00;250;122;128;Bedeckt;8;5;0;Stadt Konstanz, Amt für Stadtplanung und Umwelt
20.02.2022 14:00;277;148;129;Bewoelkt;8;5;0;Stadt Konstanz, Amt für Stadtplanung und Umwelt
20.02.2022 15:00;309;151;158;Bewoelkt;9;6;0;Stadt Konstanz, Amt für Stadtplanung und Umwelt
20.02.2022 16:00;266;114;152;Bewoelkt;8;5;0;Stadt Konstanz, Amt für Stadtplanung und Umwelt
20.02.2022 17:00;286;127;159;Bewoelkt;7;4;0;Stadt Konstanz, Amt für Stadtplanung und Umwelt
20.02.2022 18:00;225;114;111;Bewoelkt;7;4;0;Stadt Konstanz, Amt für Stadtplanung und Umwelt
20.02.2022 19:00;175;95;80;Bewoelkt;7;3;0;Stadt Konstanz, Amt für Stadtplanung und Umwelt
20.02.2022 20:00;124;68;56;Bewoelkt;6;3;0;Stadt Konstanz, Amt für Stadtplanung und Umwelt
20.02.2022 21:00;99;47;52;Bewoelkt;6;2;0;Stadt Konstanz, Amt für Stadtplanung und Umwelt
20.02.2022 22:00;81;29;52;Bewoelkt;6;3;0;Stadt Konstanz, Amt für Stadtplanung und Umwelt
20.02.2022 23:00;28;10;18;Bedeckt;7;3;0;Stadt Konstanz, Amt für Stadtplanung und Umwelt
21.02.2022 00:00;17;8;9;Bedeckt;7;3;0;Stadt Konstanz, Amt für Stadtplanung und Umwelt
21.02.2022 01:00;6;5;1;Bedeckt;7;3;0;Stadt Konstanz, Amt für Stadtplanung und Umwelt
21.02.2022 02:00;2;1;1;Bedeckt;7;3;0;Stadt Konstanz, Amt für Stadtplanung und Umwelt
21.02.2022 03:00;0;0;0;Bedeckt;8;3;0;Stadt Konstanz, Amt für Stadtplanung und Umwelt
21.02.2022 04:00;7;5;2;Bedeckt;8;3;0;Stadt Konstanz, Amt für Stadtplanung und Umwelt
21.02.2022 05:00;28;18;10;Stellenweiser Regenfall;8;3;0;Stadt Konstanz, Amt für Stadtplanung und Umwelt
21.02.2022 06:00;70;34;36;Stellenweiser Regenfall;8;3;0;Stadt Konstanz, Amt für Stadtplanung und Umwelt
21.02.2022 07:00;469;281;188;Stellenweiser Regenfall;6;1;0;Stadt Konstanz, Amt für Stadtplanung und Umwelt
21.02.2022 08:00;433;251;182;Stellenweise starker Schneefall;4;-1;0.6;Stadt Konstanz, Amt für Stadtplanung und Umwelt
21.02.2022 09:00;373;213;160;Stellenweise starker Schneefall;3;-3;0.8;Stadt Konstanz, Amt für Stadtplanung und Umwelt
21.02.2022 10:00;232;117;115;Stellenweise starker Schneefall;4;-1;0.4;Stadt Konstanz, Amt für Stadtplanung und Umwelt
21.02.2022 11:00;316;174;142;Stellenweiser Eisregen;5;0;0.3;Stadt Konstanz, Amt für Stadtplanung und Umwelt
21.02.2022 12:00;323;139;184;Stellenweiser Eisregen;6;1;0.4;Stadt Konstanz, Amt für Stadtplanung und Umwelt
21.02.2022 13:00;461;205;256;Stellenweiser Eisregen;6;1;0.2;Stadt Konstanz, Amt für Stadtplanung und Umwelt
21.02.2022 14:00;313;133;180;Stellenweiser Regenfall;6;1;0;Stadt Konstanz, Amt für Stadtplanung und Umwelt
21.02.2022 15:00;451;233;218;Stellenweiser Regenfall;5;0;0;Stadt Konstanz, Amt für Stadtplanung und Umwelt
21.02.2022 16:00;417;214;203;Stellenweiser Regenfall;5;0;0;Stadt Konstanz, Amt für Stadtplanung und Umwelt
21.02.2022 17:00;487;223;264;Maessige bis starke Schneefaelle;4;-1;0.1;Stadt Konstanz, Amt für Stadtplanung und Umwelt
21.02.2022 18:00;394;181;213;Maessige bis starke Schneefaelle;3;-2;0.1;Stadt Konstanz, Amt für Stadtplanung und Umwelt
21.02.2022 19:00;310;152;158;Maessige bis starke Schneefaelle;3;-2;0;Stadt Konstanz, Amt für Stadtplanung und Umwelt
21.02.2022 20:00;222;109;113;Leichter Eisregen;3;-2;0.3;Stadt Konstanz, Amt für Stadtplanung und Umwelt
21.02.2022 21:00;113;63;50;Leichter Eisregen;3;-2;0.4;Stadt Konstanz, Amt für Stadtplanung und Umwelt
21.02.2022 22:00;105;52;53;Leichter Eisregen;3;-2;0.2;Stadt Konstanz, Amt für Stadtplanung und Umwelt
21.02.2022 23:00;38;16;22;Maessige bis starke Schneefaelle;3;-2;0.2;Stadt Konstanz, Amt für Stadtplanung und Umwelt
22.02.2022 00:00;25;11;14;Maessige bis starke Schneefaelle;3;-2;0.4;Stadt Konstanz, Amt für Stadtplanung und Umwelt
22.02.2022 01:00;19;6;13;Maessige bis starke Schneefaelle;3;-2;0.2;Stadt Konstanz, Amt für Stadtplanung und Umwelt
22.02.2022 02:00;8;1;7;Bedeckt;2;-2;0;Stadt Konstanz, Amt für Stadtplanung und Umwelt
22.02.2022 03:00;10;0;10;Bedeckt;2;-2;0;Stadt Konstanz, Amt für Stadtplanung und Umwelt
22.02.2022 04:00;10;7;3;Bedeckt;2;-3;0;Stadt Konstanz, Amt für Stadtplanung und Umwelt
22.02.2022 05:00;50;38;12;Maessige bis starke Schneefaelle;2;-3;0;Stadt Konstanz, Amt für Stadtplanung und Umwelt
22.02.2022 06:00;133;79;54;Maessige bis starke Schneefaelle;2;-3;0;Stadt Konstanz, Amt für Stadtplanung und Umwelt
22.02.2022 07:00;740;435;305;Maessige bis starke Schneefaelle;2;-3;0;Stadt Konstanz, Amt für Stadtplanung und Umwelt
22.02.2022 08:00;628;337;291;Bedeckt;3;-2;0;Stadt Konstanz, Amt für Stadtplanung und Umwelt
22.02.2022 09:00;469;287;182;Bedeckt;3;-2;0;Stadt Konstanz, Amt für Stadtplanung und Umwelt
22.02.2022 10:00;396;217;179;Bedeckt;3;-2;0;Stadt Konstanz, Amt für Stadtplanung und Umwelt
22.02.2022 11:00;428;237;191;Stellenweiser Regenfall;4;-1;0;Stadt Konstanz, Amt für Stadtplanung und Umwelt
22.02.2022 12:00;491;193;298;Stellenweiser Regenfall;4;0;0;Stadt Konstanz, Amt für Stadtplanung und Umwelt
22.02.2022 13:00;612;253;359;Stellenweiser Regenfall;5;1;0;Stadt Konstanz, Amt für Stadtplanung und Umwelt
22.02.2022 14:00;490;246;244;Leicht bewoelkt;6;3;0;Stadt Konstanz, Amt für Stadtplanung und Umwelt
22.02.2022 15:00;727;346;381;Leicht bewoelkt;7;4;0;Stadt Konstanz, Amt für Stadtplanung und Umwelt
22.02.2022 16:00;656;333;323;Leicht bewoelkt;6;3;0;Stadt Konstanz, Amt für Stadtplanung und Umwelt
22.02.2022 17:00;778;325;453;Sonnig;5;2;0;Stadt Konstanz, Amt für Stadtplanung und Umwelt
22.02.2022 18:00;593;273;320;Sonnig;4;1;0;Stadt Konstanz, Amt für Stadtplanung und Umwelt
22.02.2022 19:00;405;186;219;Sonnig;4;1;0;Stadt Konstanz, Amt für Stadtplanung und Umwelt
22.02.2022 20:00;260;136;124;Leicht bewoelkt;4;1;0;Stadt Konstanz, Amt für Stadtplanung und Umwelt
22.02.2022 21:00;156;88;68;Leicht bewoelkt;4;1;0;Stadt Konstanz, Amt für Stadtplanung und Umwelt
22.02.2022 22:00;131;47;84;Leicht bewoelkt;4;1;0;Stadt Konstanz, Amt für Stadtplanung und Umwelt
22.02.2022 23:00;85;39;46;Sonnig;3;0;0;Stadt Konstanz, Amt für Stadtplanung und Umwelt
23.02.2022 00:00;45;14;31;Sonnig;3;0;0;Stadt Konstanz, Amt für Stadtplanung und Umwelt
23.02.2022 01:00;25;8;17;Sonnig;4;0;0;Stadt Konstanz, Amt für Stadtplanung und Umwelt
23.02.2022 02:00;7;6;1;Bewoelkt;4;1;0;Stadt Konstanz, Amt für Stadtplanung und Umwelt
23.02.2022 03:00;8;3;5;Bewoelkt;4;1;0;Stadt Konstanz, Amt für Stadtplanung und Umwelt
23.02.2022 04:00;9;6;3;Bewoelkt;5;1;0;Stadt Konstanz, Amt für Stadtplanung und Umwelt
23.02.2022 05:00;47;32;15;Stellenweiser Nieselregen;5;2;0.1;Stadt Konstanz, Amt für Stadtplanung und Umwelt
23.02.2022 06:00;139;67;72;Stellenweiser Nieselregen;5;2;0.1;Stadt Konstanz, Amt für Stadtplanung und Umwelt
23.02.2022 07:00;790;483;307;Stellenweiser Nieselregen;5;2;0;Stadt Konstanz, Amt für Stadtplanung und Umwelt
23.02.2022 08:00;602;315;287;Stellenweiser Regenfall;5;2;0;Stadt Konstanz, Amt für Stadtplanung und Umwelt
23.02.2022 09:00;449;247;202;Stellenweiser Regenfall;5;2;0;Stadt Konstanz, Amt für Stadtplanung und Umwelt
23.02.2022 10:00;331;187;144;Stellenweiser Regenfall;6;5;0;Stadt Konstanz, Amt für Stadtplanung und Umwelt
23.02.2022 11:00;403;188;215;Sonnig;8;7;0;Stadt Konstanz, Amt für Stadtplanung und Umwelt
23.02.2022 12:00;556;251;305;Sonnig;9;9;0;Stadt Konstanz, Amt für Stadtplanung und Umwelt
23.02.2022 13:00;755;358;397;Sonnig;10;10;0;Stadt Konstanz, Amt für Stadtplanung und Umwelt
23.02.2022 14:00;589;306;283;Sonnig;10;10;0;Stadt Konstanz, Amt für Stadtplanung und Umwelt
23.02.2022 15:00;765;340;425;Sonnig;11;11;0;Stadt Konstanz, Amt für Stadtplanung und Umwelt
23.02.2022 16:00;755;373;382;Sonnig;9;8;0;Stadt Konstanz, Amt für Stadtplanung und Umwelt
23.02.2022 17:00;930;405;525;Leicht bewoelkt;6;5;0;Stadt Konstanz, Amt für Stadtplanung und Umwelt
23.02.2022 18:00;659;290;369;Leicht bewoelkt;4;2;0;Stadt Konstanz, Amt für Stadtplanung und Umwelt
23.02.2022 19:00;449;245;204;Leicht bewoelkt;3;1;0;Stadt Konstanz, Amt für Stadtplanung und Umwelt
23.02.2022 20:00;285;143;142;Bedeckt;2;0;0;Stadt Konstanz, Amt für Stadtplanung und Umwelt
23.02.2022 21:00;209;86;123;Bedeckt;1;-1;0;Stadt Konstanz, Amt für Stadtplanung und Umwelt
23.02.2022 22:00;138;62;76;Bedeckt;1;-1;0;Stadt Konstanz, Amt für Stadtplanung und Umwelt
23.02.2022 23:00;108;37;71;Sonnig;1;-1;0;Stadt Konstanz, Amt für Stadtplanung und Umwelt
24.02.2022 00:00;64;33;31;Sonnig;1;-1;0;Stadt Konstanz, Amt für Stadtplanung und Umwelt
24.02.2022 01:00;47;7;40;Sonnig;1;-2;0;Stadt Konstanz, Amt für Stadtplanung und Umwelt
24.02.2022 02:00;27;9;18;Bedeckt;0;-2;0;Stadt Konstanz, Amt für Stadtplanung und Umwelt
24.02.2022 03:00;12;4;8;Bedeckt;0;-2;0;Stadt Konstanz, Amt für Stadtplanung und Umwelt
24.02.2022 04:00;23;11;12;Bedeckt;1;-2;0;Stadt Konstanz, Amt für Stadtplanung und Umwelt
24.02.2022 05:00;43;30;13;Bedeckt;1;-1;0;Stadt Konstanz, Amt für Stadtplanung und Umwelt
24.02.2022 06:00;130;74;56;Bedeckt;1;-1;0;Stadt Konstanz, Amt für Stadtplanung und Umwelt
24.02.2022 07:00;613;368;245;Bedeckt;2;0;0;Stadt Konstanz, Amt für Stadtplanung und Umwelt
24.02.2022 08:00;537;283;254;Bedeckt;3;1;0;Stadt Konstanz, Amt für Stadtplanung und Umwelt
24.02.2022 09:00;389;183;206;Bedeckt;4;2;0;Stadt Konstanz, Amt für Stadtplanung und Umwelt
24.02.2022 10:00;275;131;144;Bedeckt;6;4;0;Stadt Konstanz, Amt für Stadtplanung und Umwelt
24.02.2022 11:00;484;235;249;Sonnig;8;6;0;Stadt Konstanz, Amt für Stadtplanung und Umwelt
24.02.2022 12:00;644;357;287;Sonnig;10;9;0;Stadt Konstanz, Amt für Stadtplanung und Umwelt
24.02.2022 13:00;538;258;280;Sonnig;11;9;0;Stadt Konstanz, Amt für Stadtplanung und Umwelt
24.02.2022 14:00;529;311;218;Sonnig;11;9;0;Stadt Konstanz, Amt für Stadtplanung und Umwelt
24.02.2022 15:00;549;306;243;Sonnig;12;10;0;Stadt Konstanz, Amt für Stadtplanung und Umwelt
24.02.2022 16:00;491;269;222;Sonnig;10;8;0;Stadt Konstanz, Amt für Stadtplanung und Umwelt
24.02.2022 17:00;625;265;360;Bedeckt;9;7;0;Stadt Konstanz, Amt für Stadtplanung und Umwelt
24.02.2022 18:00;495;239;256;Bedeckt;8;6;0;Stadt Konstanz, Amt für Stadtplanung und Umwelt
24.02.2022 19:00;323;149;174;Bedeckt;7;5;0;Stadt Konstanz, Amt für Stadtplanung und Umwelt
24.02.2022 20:00;247;117;130;Leicht bewoelkt;6;4;0;Stadt Konstanz, Amt für Stadtplanung und Umwelt
24.02.2022 21:00;177;69;108;Leicht bewoelkt;6;3;0;Stadt Konstanz, Amt für Stadtplanung und Umwelt
24.02.2022 22:00;144;43;101;Leicht bewoelkt;6;3;0;Stadt Konstanz, Amt für Stadtplanung und Umwelt
24.02.2022 23:00;135;33;102;Stellenweiser Regenfall;6;3;0;Stadt Konstanz, Amt für Stadtplanung und Umwelt
25.02.2022 00:00;86;15;71;Stellenweiser Regenfall;6;3;0.1;Stadt Konstanz, Amt für Stadtplanung und Umwelt
25.02.2022 01:00;69;17;52;Stellenweiser Regenfall;5;2;0;Stadt Konstanz, Amt für Stadtplanung und Umwelt
25.02.2022 02:00;19;3;16;Starker Schneefall;4;1;0.2;Stadt Konstanz, Amt für Stadtplanung und Umwelt
25.02.2022 03:00;10;2;8;Starker Schneefall;3;0;0.3;Stadt Konstanz, Amt für Stadtplanung und Umwelt
25.02.2022 04:00;6;3;3;Starker Schneefall;2;0;0.1;Stadt Konstanz, Amt für Stadtplanung und Umwelt
25.02.2022 05:00;31;23;8;Starker Schneefall;2;-1;0.3;Stadt Konstanz, Amt für Stadtplanung und Umwelt
25.02.2022 06:00;98;61;37;Starker Schneefall;2;-2;0.4;Stadt Konstanz, Amt für Stadtplanung und Umwelt
25.02.2022 07:00;267;140;127;Starker Schneefall;2;-2;0.2;Stadt Konstanz, Amt für Stadtplanung und Umwelt
25.02.2022 08:00;383;218;165;Stellenweiser Schneefall;2;-2;0;Stadt Konstanz, Amt für Stadtplanung und Umwelt
25.02.2022 09:00;391;212;179;Stellenweiser Schneefall;2;-2;0;Stadt Konstanz, Amt für Stadtplanung und Umwelt
25.02.2022 10:00;393;222;171;Stellenweiser Schneefall;3;-1;0;Stadt Konstanz, Amt für Stadtplanung und Umwelt
25.02.2022 11:00;411;211;200;Bedeckt;4;0;0;Stadt Konstanz, Amt für Stadtplanung und Umwelt
25.02.2022 12:00;383;164;219;Bedeckt;5;1;0;Stadt Konstanz, Amt für Stadtplanung und Umwelt
25.02.2022 13:00;421;203;218;Bedeckt;5;1;0;Stadt Konstanz, Amt für Stadtplanung und Umwelt
25.02.2022 14:00;474;236;238;Leicht bewoelkt;5;2;0;Stadt Konstanz, Amt für Stadtplanung und Umwelt
25.02.2022 15:00;408;208;200;Leicht bewoelkt;6;2;0;Stadt Konstanz, Amt für Stadtplanung und Umwelt
25.02.2022 16:00;405;204;201;Leicht bewoelkt;5;1;0;Stadt Konstanz, Amt für Stadtplanung und Umwelt
25.02.2022 17:00;406;179;227;Maessige bis starke Schneefaelle;3;0;0.1;Stadt Konstanz, Amt für Stadtplanung und Umwelt
25.02.2022 18:00;362;164;198;Maessige bis starke Schneefaelle;2;-1;0.1;Stadt Konstanz, Amt für Stadtplanung und Umwelt
25.02.2022 19:00;314;145;169;Maessige bis starke Schneefaelle;1;-1;0;Stadt Konstanz, Amt für Stadtplanung und Umwelt
25.02.2022 20:00;161;82;79;Maessige bis starke Schneefaelle;0;-1;0.1;Stadt Konstanz, Amt für Stadtplanung und Umwelt
25.02.2022 21:00;151;78;73;Maessige bis starke Schneefaelle;-1;-2;0.1;Stadt Konstanz, Amt für Stadtplanung und Umwelt
25.02.2022 22:00;100;44;56;Maessige bis starke Schneefaelle;-1;-2;0;Stadt Konstanz, Amt für Stadtplanung und Umwelt
25.02.2022 23:00;91;38;53;Maessige bis starke Schneefaelle;-1;-3;0.1;Stadt Konstanz, Amt für Stadtplanung und Umwelt
26.02.2022 00:00;57;17;40;Maessige bis starke Schneefaelle;-2;-3;0.1;Stadt Konstanz, Amt für Stadtplanung und Umwelt
26.02.2022 01:00;52;15;37;Maessige bis starke Schneefaelle;-2;-3;0.1;Stadt Konstanz, Amt für Stadtplanung und Umwelt
26.02.2022 02:00;22;8;14;Eisnebel;-1;-3;0;Stadt Konstanz, Amt für Stadtplanung und Umwelt
26.02.2022 03:00;28;10;18;Eisnebel;-1;-3;0;Stadt Konstanz, Amt für Stadtplanung und Umwelt
26.02.2022 04:00;11;4;7;Eisnebel;-1;-3;0;Stadt Konstanz, Amt für Stadtplanung und Umwelt
26.02.2022 05:00;14;9;5;Maessige bis starke Schneefaelle;-1;-3;0.1;Stadt Konstanz, Amt für Stadtplanung und Umwelt
26.02.2022 06:00;39;21;18;Maessige bis starke Schneefaelle;-1;-3;0.1;Stadt Konstanz, Amt für Stadtplanung und Umwelt
26.02.2022 07:00;50;17;33;Maessige bis starke Schneefaelle;0;-2;0;Stadt Konstanz, Amt für Stadtplanung und Umwelt
26.02.2022 08:00;110;64;46;Stellenweise leichter Schneefall;0;-1;0;Stadt Konstanz, Amt für Stadtplanung und Umwelt
26.02.2022 09:00;175;89;86;Stellenweise leichter Schneefall;1;0;0;Stadt Konstanz, Amt für Stadtplanung und Umwelt
26.02.2022 10:00;284;140;144;Stellenweise leichter Schneefall;2;0;0;Stadt Konstanz, Amt für Stadtplanung und Umwelt
26.02.2022 11:00;366;202;164;Leichte Schneeschauer;3;0;0;Stadt Konstanz, Amt für Stadtplanung und Umwelt
26.02.2022 12:00;400;211;189;Leichte Schneeschauer;4;0;0;Stadt Konstanz, Amt für Stadtplanung und Umwelt
26.02.2022 13:00;410;211;199;Leichte Schneeschauer;4;1;0;Stadt Konstanz, Amt für Stadtplanung und Umwelt
26.02.2022 14:00;418;199;219;Sonnig;5;1;0;Stadt Konstanz, Amt für Stadtplanung und Umwelt
26.02.2022 15:00;384;193;191;Sonnig;5;2;0;Stadt Konstanz, Amt für Stadtplanung und Umwelt
26.02.2022 16:00;382;187;195;Sonnig;4;0;0;Stadt Konstanz, Amt für Stadtplanung und Umwelt
26.02.2022 17:00;543;359;184;Sonnig;3;-1;0;Stadt Konstanz, Amt für Stadtplanung und Umwelt
26.02.2022 18:00;400;222;178;Sonnig;2;-2;0;Stadt Konstanz, Amt für Stadtplanung und Umwelt
26.02.2022 19:00;397;89;308;Sonnig;1;-4;0;Stadt Konstanz, Amt für Stadtplanung und Umwelt
26.02.2022 20:00;194;104;90;Sonnig;0;-5;0;Stadt Konstanz, Amt für Stadtplanung und Umwelt
26.02.2022 21:00;150;64;86;Sonnig;-2;-7;0;Stadt Konstanz, Amt für Stadtplanung und Umwelt
26.02.2022 22:00;130;47;83;Sonnig;-2;-7;0;Stadt Konstanz, Amt für Stadtplanung und Umwelt
26.02.2022 23:00;78;21;57;Sonnig;-2;-7;0;Stadt Konstanz, Amt für Stadtplanung und Umwelt
27.02.2022 00:00;78;28;50;Sonnig;-2;-7;0;Stadt Konstanz, Amt für Stadtplanung und Umwelt
27.02.2022 01:00;85;19;66;Sonnig;-3;-7;0;Stadt Konstanz, Amt für Stadtplanung und Umwelt
27.02.2022 02:00;66;23;43;Sonnig;-3;-7;0;Stadt Konstanz, Amt für Stadtplanung und Umwelt
27.02.2022 03:00;33;11;22;Sonnig;-3;-7;0;Stadt Konstanz, Amt für Stadtplanung und Umwelt
27.02.2022 04:00;22;7;15;Sonnig;-3;-7;0;Stadt Konstanz, Amt für Stadtplanung und Umwelt
27.02.2022 05:00;16;8;8;Sonnig;-4;-7;0;Stadt Konstanz, Amt für Stadtplanung und Umwelt
27.02.2022 06:00;20;13;7;Sonnig;-4;-7;0;Stadt Konstanz, Amt für Stadtplanung und Umwelt
27.02.2022 07:00;27;13;14;Sonnig;-3;-6;0;Stadt Konstanz, Amt für Stadtplanung und Umwelt
27.02.2022 08:00;53;22;31;Sonnig;-3;-6;0;Stadt Konstanz, Amt für Stadtplanung und Umwelt
27.02.2022 09:00;113;57;56;Sonnig;-2;-5;0;Stadt Konstanz, Amt für Stadtplanung und Umwelt
27.02.2022 10:00;140;81;59;Sonnig;0;-3;0;Stadt Konstanz, Amt für Stadtplanung und Umwelt
27.02.2022 11:00;222;117;105;Sonnig;2;0;0;Stadt Konstanz, Amt für Stadtplanung und Umwelt
27.02.2022 12:00;259;121;138;Sonnig;4;2;0;Stadt Konstanz, Amt für Stadtplanung und Umwelt
27.02.2022 13:00;287;172;115;Sonnig;5;3;0;Stadt Konstanz, Amt für Stadtplanung und Umwelt
27.02.2022 14:00;291;143;148;Sonnig;6;4;0;Stadt Konstanz, Amt für Stadtplanung und Umwelt
27.02.2022 15:00;330;172;158;Sonnig;7;6;0;Stadt Konstanz, Amt für Stadtplanung und Umwelt
27.02.2022 16:00;311;135;176;Sonnig;5;4;0;Stadt Konstanz, Amt für Stadtplanung und Umwelt
27.02.2022 17:00;302;137;165;Sonnig;3;3;0;Stadt Konstanz, Amt für Stadtplanung und Umwelt
27.02.2022 18:00;221;117;104;Sonnig;1;1;0;Stadt Konstanz, Amt für Stadtplanung und Umwelt
27.02.2022 19:00;150;68;82;Sonnig;0;0;0;Stadt Konstanz, Amt für Stadtplanung und Umwelt
27.02.2022 20:00;125;76;49;Leicht bewoelkt;-1;-2;0;Stadt Konstanz, Amt für Stadtplanung und Umwelt
27.02.2022 21:00;59;24;35;Leicht bewoelkt;-2;-4;0;Stadt Konstanz, Amt für Stadtplanung und Umwelt
27.02.2022 22:00;63;23;40;Leicht bewoelkt;-3;-4;0;Stadt Konstanz, Amt für Stadtplanung und Umwelt
27.02.2022 23:00;39;15;24;Sonnig;-3;-4;0;Stadt Konstanz, Amt für Stadtplanung und Umwelt
28.02.2022 00:00;18;3;15;Sonnig;-4;-4;0;Stadt Konstanz, Amt für Stadtplanung und Umwelt
28.02.2022 01:00;27;9;18;Sonnig;-4;-4;0;Stadt Konstanz, Amt für Stadtplanung und Umwelt
28.02.2022 02:00;7;4;3;Sonnig;-4;-4;0;Stadt Konstanz, Amt für Stadtplanung und Umwelt
28.02.2022 03:00;7;5;2;Sonnig;-4;-4;0;Stadt Konstanz, Amt für Stadtplanung und Umwelt
28.02.2022 04:00;6;1;5;Sonnig;-4;-4;0;Stadt Konstanz, Amt für Stadtplanung und Umwelt
28.02.2022 05:00;24;14;10;Sonnig;-4;-4;0;Stadt Konstanz, Amt für Stadtplanung und Umwelt
28.02.2022 06:00;98;58;40;Sonnig;-4;-4;0;Stadt Konstanz, Amt für Stadtplanung und Umwelt
28.02.2022 07:00;241;132;109;Sonnig;-3;-3;0;Stadt Konstanz, Amt für Stadtplanung und Umwelt
28.02.2022 08:00;364;181;183;Sonnig;-2;-2;0;Stadt Konstanz, Amt für Stadtplanung und Umwelt
28.02.2022 09:00;277;149;128;Sonnig;0;-1;0;Stadt Konstanz, Amt für Stadtplanung und Umwelt
28.02.2022 10:00;280;143;137;Sonnig;2;1;0;Stadt Konstanz, Amt für Stadtplanung und Umwelt
28.02.2022 11:00;263;141;122;Sonnig;4;4;0;Stadt Konstanz, Amt für Stadtplanung und Umwelt
28.02.2022 12:00;367;170;197;Sonnig;7;7;0;Stadt Konstanz, Amt für Stadtplanung und Umwelt
28.02.2022 13:00;375;173;202;Sonnig;7;7;0;Stadt Konstanz, Amt für Stadtplanung und Umwelt
28.02.2022 14:00;407;219;188;Sonnig;8;8;0;Stadt Konstanz, Amt für Stadtplanung und Umwelt
28.02.2022 15:00;403;195;208;Sonnig;9;9;0;Stadt Konstanz, Amt für Stadtplanung und Umwelt
28.02.2022 16:00;548;235;313;Sonnig;7;7;0;Stadt Konstanz, Amt für Stadtplanung und Umwelt
28.02.2022 17:00;518;263;255;Sonnig;5;5;0;Stadt Konstanz, Amt für Stadtplanung und Umwelt
28.02.2022 18:00;447;209;238;Sonnig;3;3;0;Stadt Konstanz, Amt für Stadtplanung und Umwelt
28.02.2022 19:00;310;154;156;Sonnig;1;1;0;Stadt Konstanz, Amt für Stadtplanung und Umwelt
28.02.2022 20:00;193;98;95;Sonnig;0;0;0;Stadt Konstanz, Amt für Stadtplanung und Umwelt
28.02.2022 21:00;154;75;79;Sonnig;-2;-2;0;Stadt Konstanz, Amt für Stadtplanung und Umwelt
28.02.2022 22:00;121;41;80;Sonnig;-2;-3;0;Stadt Konstanz, Amt für Stadtplanung und Umwelt
28.02.2022 23:00;55;28;27;Sonnig;-2;-3;0;Stadt Konstanz, Amt für Stadtplanung und Umwelt
01.03.2022 00:00;49;15;34;Sonnig;-2;-4;0;Stadt Konstanz, Amt für Stadtplanung und Umwelt
01.03.2022 01:00;46;13;33;Sonnig;-3;-5;0;Stadt Konstanz, Amt für Stadtplanung und Umwelt
01.03.2022 02:00;21;6;15;Sonnig;-3;-5;0;Stadt Konstanz, Amt für Stadtplanung und Umwelt
01.03.2022 03:00;4;2;2;Sonnig;-3;-6;0;Stadt Konstanz, Amt für Stadtplanung und Umwelt
01.03.2022 04:00;14;10;4;Sonnig;-3;-6;0;Stadt Konstanz, Amt für Stadtplanung und Umwelt
01.03.2022 05:00;34;24;10;Sonnig;-3;-6;0;Stadt Konstanz, Amt für Stadtplanung und Umwelt
01.03.2022 06:00;120;73;47;Sonnig;-4;-6;0;Stadt Konstanz, Amt für Stadtplanung und Umwelt
01.03.2022 07:00;301;161;140;Sonnig;-3;-5;0;Stadt Konstanz, Amt für Stadtplanung und Umwelt
01.03.2022 08:00;492;254;238;Sonnig;-2;-3;0;Stadt Konstanz, Amt für Stadtplanung und Umwelt
01.03.2022 09:00;364;223;141;Sonnig;-1;-2;0;Stadt Konstanz, Amt für Stadtplanung und Umwelt
01.03.2022 10:00;338;187;151;Sonnig;1;0;0;Stadt Konstanz, Amt für Stadtplanung und Umwelt
01.03.2022 11:00;343;186;157;Sonnig;4;3;0;Stadt Konstanz, Amt für Stadtplanung und Umwelt
01.03.2022 12:00;399;159;240;Sonnig;6;6;0;Stadt Konstanz, Amt für Stadtplanung und Umwelt
01.03.2022 13:00;395;187;208;Sonnig;7;7;0;Stadt Konstanz, Amt für Stadtplanung und Umwelt
01.03.2022 14:00;465;227;238;Sonnig;8;8;0;Stadt Konstanz, Amt für Stadtplanung und Umwelt
01.03.2022 15:00;442;222;220;Sonnig;9;9;0;Stadt Konstanz, Amt für Stadtplanung und Umwelt
01.03.2022 16:00;558;248;310;Sonnig;7;7;0;Stadt Konstanz, Amt für Stadtplanung und Umwelt
01.03.2022 17:00;677;317;360;Sonnig;5;5;0;Stadt Konstanz, Amt für Stadtplanung und Umwelt
01.03.2022 18:00;529;239;290;Sonnig;3;3;0;Stadt Konstanz, Amt für Stadtplanung und Umwelt
01.03.2022 19:00;317;154;163;Sonnig;2;2;0;Stadt Konstanz, Amt für Stadtplanung und Umwelt
01.03.2022 20:00;203;96;107;Sonnig;0;0;0;Stadt Konstanz, Amt für Stadtplanung und Umwelt
01.03.2022 21:00;125;60;65;Sonnig;-2;-2;0;Stadt Konstanz, Amt für Stadtplanung und Umwelt
01.03.2022 22:00;129;47;82;Sonnig;-2;-2;0;Stadt Konstanz, Amt für Stadtplanung und Umwelt
01.03.2022 23:00;47;20;27;Sonnig;-3;-3;0;Stadt Konstanz, Amt für Stadtplanung und Umwelt
02.03.2022 00:00;26;13;13;Sonnig;-3;-3;0;Stadt Konstanz, Amt für Stadtplanung und Umwelt
02.03.2022 01:00;11;3;8;Sonnig;-4;-4;0;Stadt Konstanz, Amt für Stadtplanung und Umwelt
02.03.2022 02:00;5;4;1;Sonnig;-4;-4;0;Stadt Konstanz, Amt für Stadtplanung und Umwelt
02.03.2022 03:00;5;4;1;Sonnig;-4;-4;0;Stadt Konstanz, Amt für Stadtplanung und Umwelt
02.03.2022 04:00;6;4;2;Sonnig;-4;-4;0;Stadt Konstanz, Amt für Stadtplanung und Umwelt
02.03.2022 05:00;43;30;13;Sonnig;-4;-4;0;Stadt Konstanz, Amt für Stadtplanung und Umwelt
02.03.2022 06:00;120;73;47;Sonnig;-4;-4;0;Stadt Konstanz, Amt für Stadtplanung und Umwelt
02.03.2022 07:00;336;187;149;Sonnig;-2;-2;0;Stadt Konstanz, Amt für Stadtplanung und Umwelt
02.03.2022 08:00;481;241;240;Sonnig;0;0;0;Stadt Konstanz, Amt für Stadtplanung und Umwelt
02.03.2022 09:00;352;209;143;Sonnig;1;1;0;Stadt Konstanz, Amt für Stadtplanung und Umwelt
02.03.2022 10:00;328;166;162;Sonnig;3;3;0;Stadt Konstanz, Amt für Stadtplanung und Umwelt
02.03.2022 11:00;352;165;187;Sonnig;5;5;0;Stadt Konstanz, Amt für Stadtplanung und Umwelt
02.03.2022 12:00;414;189;225;Sonnig;7;7;0;Stadt Konstanz, Amt für Stadtplanung und Umwelt
02.03.2022 13:00;399;181;218;Sonnig;8;8;0;Stadt Konstanz, Amt für Stadtplanung und Umwelt
02.03.2022 14:00;414;227;187;Sonnig;8;8;0;Stadt Konstanz, Amt für Stadtplanung und Umwelt
02.03.2022 15:00;424;206;218;Sonnig;9;9;0;Stadt Konstanz, Amt für Stadtplanung und Umwelt
02.03.2022 16:00;537;235;302;Sonnig;6;6;0;Stadt Konstanz, Amt für Stadtplanung und Umwelt
02.03.2022 17:00;561;286;275;Leicht bewoelkt;4;3;0;Stadt Konstanz, Amt für Stadtplanung und Umwelt
02.03.2022 18:00;477;224;253;Leicht bewoelkt;2;1;0;Stadt Konstanz, Amt für Stadtplanung und Umwelt
02.03.2022 19:00;285;130;155;Leicht bewoelkt;1;1;0;Stadt Konstanz, Amt für Stadtplanung und Umwelt
02.03.2022 20:00;206;104;102;Bedeckt;1;0;0;Stadt Konstanz, Amt für Stadtplanung und Umwelt
02.03.2022 21:00;142;60;82;Bedeckt;0;0;0;Stadt Konstanz, Amt für Stadtplanung und Umwelt
02.03.2022 22:00;111;54;57;Bedeckt;0;0;0;Stadt Konstanz, Amt für Stadtplanung und Umwelt
02.03.2022 23:00;54;21;33;Sonnig;-1;-1;0;Stadt Konstanz, Amt für Stadtplanung und Umwelt
03.03.2022 00:00;39;10;29;Sonnig;-1;-1;0;Stadt Konstanz, Amt für Stadtplanung und Umwelt
03.03.2022 01:00;19;8;11;Sonnig;-2;-2;0;Stadt Konstanz, Amt für Stadtplanung und Umwelt
03.03.2022 02:00;7;2;5;Sonnig;-2;-2;0;Stadt Konstanz, Amt für Stadtplanung und Umwelt
03.03.2022 03:00;4;3;1;Sonnig;-3;-3;0;Stadt Konstanz, Amt für Stadtplanung und Umwelt
03.03.2022 04:00;4;4;0;Sonnig;-3;-3;0;Stadt Konstanz, Amt für Stadtplanung und Umwelt
03.03.2022 05:00;39;30;9;Sonnig;-3;-3;0;Stadt Konstanz, Amt für Stadtplanung und Umwelt
03.03.2022 06:00;124;72;52;Sonnig;-3;-3;0;Stadt Konstanz, Amt für Stadtplanung und Umwelt
03.03.2022 07:00;322;170;152;Sonnig;-1;-1;0;Stadt Konstanz, Amt für Stadtplanung und Umwelt
03.03.2022 08:00;505;266;239;Sonnig;0;0;0;Stadt Konstanz, Amt für Stadtplanung und Umwelt
03.03.2022 09:00;333;203;130;Sonnig;2;2;0;Stadt Konstanz, Amt für Stadtplanung und Umwelt
03.03.2022 10:00;335;183;152;Sonnig;5;5;0;Stadt Konstanz, Amt für Stadtplanung und Umwelt
03.03.2022 11:00;352;177;175;Sonnig;7;7;0;Stadt Konstanz, Amt für Stadtplanung und Umwelt
03.03.2022 12:00;446;202;244;Sonnig;9;9;0;Stadt Konstanz, Amt für Stadtplanung und Umwelt
03.03.2022 13:00;463;234;229;Sonnig;9;9;0;Stadt Konstanz, Amt für Stadtplanung und Umwelt
03.03.2022 14:00;482;233;249;Sonnig;9;9;0;Stadt Konstanz, Amt für Stadtplanung und Umwelt
03.03.2022 15:00;515;249;266;Sonnig;9;9;0;Stadt Konstanz, Amt für Stadtplanung und Umwelt
03.03.2022 16:00;606;269;337;Sonnig;7;6;0;Stadt Konstanz, Amt für Stadtplanung und Umwelt
03.03.2022 17:00;657;334;323;Sonnig;5;3;0;Stadt Konstanz, Amt für Stadtplanung und Umwelt
03.03.2022 18:00;557;228;329;Sonnig;3;0;0;Stadt Konstanz, Amt für Stadtplanung und Umwelt
03.03.2022 19:00;365;165;200;Sonnig;1;-1;0;Stadt Konstanz, Amt für Stadtplanung und Umwelt
03.03.2022 20:00;217;99;118;Sonnig;0;-3;0;Stadt Konstanz, Amt für Stadtplanung und Umwelt
03.03.2022 21:00;151;66;85;Sonnig;-1;-5;0;Stadt Konstanz, Amt für Stadtplanung und Umwelt
03.03.2022 22:00;90;28;62;Sonnig;-2;-5;0;Stadt Konstanz, Amt für Stadtplanung und Umwelt
03.03.2022 23:00;108;36;72;Sonnig;-2;-5;0;Stadt Konstanz, Amt für Stadtplanung und Umwelt
04.03.2022 00:00;34;6;28;Sonnig;-3;-5;0;Stadt Konstanz, Amt für Stadtplanung und Umwelt
04.03.2022 01:00;31;12;19;Sonnig;-3;-6;0;Stadt Konstanz, Amt für Stadtplanung und Umwelt
04.03.2022 02:00;5;1;4;Sonnig;-3;-6;0;Stadt Konstanz, Amt für Stadtplanung und Umwelt
04.03.2022 03:00;9;7;2;Sonnig;-4;-7;0;Stadt Konstanz, Amt für Stadtplanung und Umwelt
04.03.2022 04:00;5;2;3;Sonnig;-4;-7;0;Stadt Konstanz, Amt für Stadtplanung und Umwelt
04.03.2022 05:00;28;18;10;Sonnig;-4;-7;0;Stadt Konstanz, Amt für Stadtplanung und Umwelt
04.03.2022 06:00;116;75;41;Sonnig;-4;-7;0;Stadt Konstanz, Amt für Stadtplanung und Umwelt
04.03.2022 07:00;288;154;134;Sonnig;-3;-6;0;Stadt Konstanz, Amt für Stadtplanung und Umwelt
04.03.2022 08:00;429;236;193;Sonnig;-1;-4;0;Stadt Konstanz, Amt für Stadtplanung und Umwelt
04.03.2022 09:00;392;247;145;Sonnig;0;-3;0;Stadt Konstanz, Amt für Stadtplanung und Umwelt
04.03.2022 10:00;421;231;190;Sonnig;3;0;0;Stadt Konstanz, Amt für Stadtplanung und Umwelt
04.03.2022 11:00;430;234;196;Sonnig;5;3;0;Stadt Konstanz, Amt für Stadtplanung und Umwelt
04.03.2022 12:00;464;202;262;Sonnig;8;6;0;Stadt Konstanz, Amt für Stadtplanung und Umwelt
04.03.2022 13:00;508;225;283;Sonnig;8;5;0;Stadt Konstanz, Amt für Stadtplanung und Umwelt
04.03.2022 14:00;518;262;256;Sonnig;8;5;0;Stadt Konstanz, Amt für Stadtplanung und Umwelt
04.03.2022 15:00;545;285;260;Sonnig;8;5;0;Stadt Konstanz, Amt für Stadtplanung und Umwelt
04.03.2022 16:00;562;260;302;Sonnig;6;3;0;Stadt Konstanz, Amt für Stadtplanung und Umwelt
04.03.2022 17:00;544;245;299;Sonnig;5;1;0;Stadt Konstanz, Amt für Stadtplanung und Umwelt
04.03.2022 18:00;432;196;236;Sonnig;4;-1;0;Stadt Konstanz, Amt für Stadtplanung und Umwelt
04.03.2022 19:00;309;147;162;Sonnig;2;-3;0;Stadt Konstanz, Amt für Stadtplanung und Umwelt
04.03.2022 20:00;231;110;121;Sonnig;0;-4;0;Stadt Konstanz, Amt für Stadtplanung und Umwelt
04.03.2022 21:00;151;67;84;Sonnig;-1;-6;0;Stadt Konstanz, Amt für Stadtplanung und Umwelt
04.03.2022 22:00;124;41;83;Sonnig;-1;-6;0;Stadt Konstanz, Amt für Stadtplanung und Umwelt
04.03.2022 23:00;83;24;59;Sonnig;-1;-5;0;Stadt Konstanz, Amt für Stadtplanung und Umwelt
05.03.2022 00:00;60;18;42;Sonnig;-2;-5;0;Stadt Konstanz, Amt für Stadtplanung und Umwelt
05.03.2022 01:00;38;15;23;Sonnig;-2;-6;0;Stadt Konstanz, Amt für Stadtplanung und Umwelt
05.03.2022 02:00;26;9;17;Sonnig;-3;-6;0;Stadt Konstanz, Amt für Stadtplanung und Umwelt
05.03.2022 03:00;26;10;16;Sonnig;-3;-6;0;Stadt Konstanz, Amt für Stadtplanung und Umwelt
05.03.2022 04:00;9;6;3;Sonnig;-3;-7;0;Stadt Konstanz, Amt für Stadtplanung und Umwelt
05.03.2022 05:00;24;17;7;Sonnig;-3;-7;0;Stadt Konstanz, Amt für Stadtplanung und Umwelt
05.03.2022 06:00;45;24;21;Sonnig;-4;-7;0;Stadt Konstanz, Amt für Stadtplanung und Umwelt
05.03.2022 07:00;56;32;24;Sonnig;-2;-6;0;Stadt Konstanz, Amt für Stadtplanung und Umwelt
05.03.2022 08:00;128;61;67;Sonnig;-1;-5;0;Stadt Konstanz, Amt für Stadtplanung und Umwelt
05.03.2022 09:00;251;141;110;Sonnig;0;-3;0;Stadt Konstanz, Amt für Stadtplanung und Umwelt
05.03.2022 10:00;340;194;146;Sonnig;2;-1;0;Stadt Konstanz, Amt für Stadtplanung und Umwelt
05.03.2022 11:00;436;220;216;Sonnig;4;1;0;Stadt Konstanz, Amt für Stadtplanung und Umwelt
05.03.2022 12:00;393;203;190;Sonnig;6;4;0;Stadt Konstanz, Amt für Stadtplanung und Umwelt
05.03.2022 13:00;445;230;215;Sonnig;7;4;0;Stadt Konstanz, Amt für Stadtplanung und Umwelt
05.03.2022 14:00;513;261;252;Sonnig;7;4;0;Stadt Konstanz, Amt für Stadtplanung und Umwelt
05.03.2022 15:00;490;280;210;Sonnig;8;4;0;Stadt Konstanz, Amt für Stadtplanung und Umwelt
05.03.2022 16:00;410;174;236;Sonnig;6;3;0;Stadt Konstanz, Amt für Stadtplanung und Umwelt
05.03.2022 17:00;503;192;311;Sonnig;5;1;0;Stadt Konstanz, Amt für Stadtplanung und Umwelt
05.03.2022 18:00;370;142;228;Sonnig;4;-1;0;Stadt Konstanz, Amt für Stadtplanung und Umwelt
05.03.2022 19:00;262;166;96;Sonnig;2;-3;0;Stadt Konstanz, Amt für Stadtplanung und Umwelt
05.03.2022 20:00;173;91;82;Sonnig;0;-4;0;Stadt Konstanz, Amt für Stadtplanung und Umwelt
05.03.2022 21:00;145;55;90;Sonnig;-1;-6;0;Stadt Konstanz, Amt für Stadtplanung und Umwelt
05.03.2022 22:00;121;39;82;Sonnig;-2;-6;0;Stadt Konstanz, Amt für Stadtplanung und Umwelt
05.03.2022 23:00;100;30;70;Sonnig;-2;-6;0;Stadt Konstanz, Amt für Stadtplanung und Umwelt
06.03.2022 00:00;82;20;62;Sonnig;-3;-6;0;Stadt Konstanz, Amt für Stadtplanung und Umwelt
06.03.2022 01:00;49;14;35;Sonnig;-3;-6;0;Stadt Konstanz, Amt für Stadtplanung und Umwelt
06.03.2022 02:00;40;18;22;Sonnig;-4;-6;0;Stadt Konstanz, Amt für Stadtplanung und Umwelt
06.03.2022 03:00;32;11;21;Sonnig;-4;-7;0;Stadt Konstanz, Amt für Stadtplanung und Umwelt
06.03.2022 04:00;10;3;7;Sonnig;-4;-7;0;Stadt Konstanz, Amt für Stadtplanung und Umwelt
06.03.2022 05:00;25;14;11;Sonnig;-4;-7;0;Stadt Konstanz, Amt für Stadtplanung und Umwelt
06.03.2022 06:00;30;15;15;Sonnig;-4;-7;0;Stadt Konstanz, Amt für Stadtplanung und Umwelt
06.03.2022 07:00;25;10;15;Sonnig;-3;-6;0;Stadt Konstanz, Amt für Stadtplanung und Umwelt
06.03.2022 08:00;44;24;20;Sonnig;-2;-5;0;Stadt Konstanz, Amt für Stadtplanung und Umwelt
06.03.2022 09:00;139;71;68;Sonnig;0;-4;0;Stadt Konstanz, Amt für Stadtplanung und Umwelt
06.03.2022 10:00;141;63;78;Sonnig;1;-2;0;Stadt Konstanz, Amt für Stadtplanung und Umwelt
06.03.2022 11:00;182;82;100;Sonnig;3;0;0;Stadt Konstanz, Amt für Stadtplanung und Umwelt
06.03.2022 12:00;248;122;126;Sonnig;4;2;0;Stadt Konstanz, Amt für Stadtplanung und Umwelt
06.03.2022 13:00;271;129;142;Sonnig;5;2;0;Stadt Konstanz, Amt für Stadtplanung und Umwelt
06.03.2022 14:00;300;159;141;Sonnig;6;3;0;Stadt Konstanz, Amt für Stadtplanung und Umwelt
06.03.2022 15:00;329;172;157;Sonnig;6;4;0;Stadt Konstanz, Amt für Stadtplanung und Umwelt
06.03.2022 16:00;298;138;160;Sonnig;5;2;0;Stadt Konstanz, Amt für Stadtplanung und Umwelt
06.03.2022 17:00;300;162;138;Sonnig;3;0;0;Stadt Konstanz, Amt für Stadtplanung und Umwelt
06.03.2022 18:00;187;85;102;Sonnig;2;-2;0;Stadt Konstanz, Amt für Stadtplanung und Umwelt
06.03.2022 19:00;161;62;99;Sonnig;0;-4;0;Stadt Konstanz, Amt für Stadtplanung und Umwelt
06.03.2022 20:00;107;58;49;Sonnig;-1;-5;0;Stadt Konstanz, Amt für Stadtplanung und Umwelt
06.03.2022 21:00;68;24;44;Sonnig;-3;-7;0;Stadt Konstanz, Amt für Stadtplanung und Umwelt
06.03.2022 22:00;68;24;44;Sonnig;-3;-6;0;Stadt Konstanz, Amt für Stadtplanung und Umwelt
06.03.2022 23:00;35;12;23;Sonnig;-3;-6;0;Stadt Konstanz, Amt für Stadtplanung und Umwelt
07.03.2022 00:00;13;3;10;Sonnig;-4;-6;0;Stadt Konstanz, Amt für Stadtplanung und Umwelt
07.03.2022 01:00;5;2;3;Sonnig;-4;-6;0;Stadt Konstanz, Amt für Stadtplanung und Umwelt
07.03.2022 02:00;5;1;4;Sonnig;-4;-6;0;Stadt Konstanz, Amt für Stadtplanung und Umwelt
07.03.2022 03:00;4;2;2;Sonnig;-4;-6;0;Stadt Konstanz, Amt für Stadtplanung und Umwelt
07.03.2022 04:00;7;6;1;Sonnig;-4;-6;0;Stadt Konstanz, Amt für Stadtplanung und Umwelt
07.03.2022 05:00;47;28;19;Sonnig;-4;-7;0;Stadt Konstanz, Amt für Stadtplanung und Umwelt
07.03.2022 06:00;154;94;60;Sonnig;-4;-7;0;Stadt Konstanz, Amt für Stadtplanung und Umwelt
07.03.2022 07:00;806;505;301;Sonnig;-3;-5;0;Stadt Konstanz, Amt für Stadtplanung und Umwelt
07.03.2022 08:00;563;282;281;Sonnig;-1;-4;0;Stadt Konstanz, Amt für Stadtplanung und Umwelt
07.03.2022 09:00;427;238;189;Sonnig;1;-2;0;Stadt Konstanz, Amt für Stadtplanung und Umwelt
07.03.2022 10:00;300;143;157;Sonnig;2;0;0;Stadt Konstanz, Amt für Stadtplanung und Umwelt
07.03.2022 11:00;374;163;211;Sonnig;4;1;0;Stadt Konstanz, Amt für Stadtplanung und Umwelt
07.03.2022 12:00;433;189;244;Sonnig;5;3;0;Stadt Konstanz, Amt für Stadtplanung und Umwelt
07.03.2022 13:00;674;265;409;Sonnig;6;4;0;Stadt Konstanz, Amt für Stadtplanung und Umwelt
07.03.2022 14:00;454;238;216;Sonnig;7;5;0;Stadt Konstanz, Amt für Stadtplanung und Umwelt
07.03.2022 15:00;717;335;382;Sonnig;8;6;0;Stadt Konstanz, Amt für Stadtplanung und Umwelt
07.03.2022 16:00;635;310;325;Sonnig;7;4;0;Stadt Konstanz, Amt für Stadtplanung und Umwelt
07.03.2022 17:00;721;320;401;Sonnig;5;1;0;Stadt Konstanz, Amt für Stadtplanung und Umwelt
07.03.2022 18:00;562;282;280;Sonnig;3;-1;0;Stadt Konstanz, Amt für Stadtplanung und Umwelt
07.03.2022 19:00;365;171;194;Sonnig;2;-3;0;Stadt Konstanz, Amt für Stadtplanung und Umwelt
07.03.2022 20:00;228;101;127;Sonnig;0;-5;0;Stadt Konstanz, Amt für Stadtplanung und Umwelt
07.03.2022 21:00;138;64;74;Sonnig;-2;-7;0;Stadt Konstanz, Amt für Stadtplanung und Umwelt
07.03.2022 22:00;98;50;48;Sonnig;-2;-7;0;Stadt Konstanz, Amt für Stadtplanung und Umwelt
07.03.2022 23:00;48;15;33;Sonnig;-2;-7;0;Stadt Konstanz, Amt für Stadtplanung und Umwelt
08.03.2022 00:00;15;6;9;Sonnig;-3;-7;0;Stadt Konstanz, Amt für Stadtplanung und Umwelt
08.03.2022 01:00;18;8;10;Sonnig;-3;-8;0;Stadt Konstanz, Amt für Stadtplanung und Umwelt
08.03.2022 02:00;5;3;2;Sonnig;-4;-8;0;Stadt Konstanz, Amt für Stadtplanung und Umwelt
08.03.2022 03:00;3;2;1;Sonnig;-4;-8;0;Stadt Konstanz, Amt für Stadtplanung und Umwelt
08.03.2022 04:00;8;7;1;Sonnig;-4;-8;0;Stadt Konstanz, Amt für Stadtplanung und Umwelt
08.03.2022 05:00;38;23;15;Sonnig;-4;-8;0;Stadt Konstanz, Amt für Stadtplanung und Umwelt
08.03.2022 06:00;146;82;64;Sonnig;-4;-8;0;Stadt Konstanz, Amt für Stadtplanung und Umwelt
08.03.2022 07:00;730;442;288;Sonnig;-3;-7;0;Stadt Konstanz, Amt für Stadtplanung und Umwelt
08.03.2022 08:00;646;353;293;Sonnig;-1;-5;0;Stadt Konstanz, Amt für Stadtplanung und Umwelt
08.03.2022 09:00;496;297;199;Sonnig;0;-3;0;Stadt Konstanz, Amt für Stadtplanung und Umwelt
08.03.2022 10:00;350;180;170;Sonnig;2;-1;0;Stadt Konstanz, Amt für Stadtplanung und Umwelt
08.03.2022 11:00;383;196;187;Sonnig;4;1;0;Stadt Konstanz, Amt für Stadtplanung und Umwelt
08.03.2022 12:00;512;203;309;Sonnig;5;3;0;Stadt Konstanz, Amt für Stadtplanung und Umwelt
08.03.2022 13:00;627;270;357;Sonnig;6;4;0;Stadt Konstanz, Amt für Stadtplanung und Umwelt
08.03.2022 14:00;553;257;296;Sonnig;7;5;0;Stadt Konstanz, Amt für Stadtplanung und Umwelt
08.03.2022 15:00;712;335;377;Sonnig;8;6;0;Stadt Konstanz, Amt für Stadtplanung und Umwelt
08.03.2022 16:00;656;306;350;Sonnig;6;4;0;Stadt Konstanz, Amt für Stadtplanung und Umwelt
08.03.2022 17:00;779;362;417;Sonnig;4;2;0;Stadt Konstanz, Amt für Stadtplanung und Umwelt
08.03.2022 18:00;605;273;332;Sonnig;2;0;0;Stadt Konstanz, Amt für Stadtplanung und Umwelt
08.03.2022 19:00;395;190;205;Sonnig;1;-2;0;Stadt Konstanz, Amt für Stadtplanung und Umwelt
08.03.2022 20:00;247;112;135;Sonnig;-1;-3;0;Stadt Konstanz, Amt für Stadtplanung und Umwelt
08.03.2022 21:00;147;64;83;Sonnig;-3;-5;0;Stadt Konstanz, Amt für Stadtplanung und Umwelt
08.03.2022 22:00;117;47;70;Sonnig;-3;-4;0;Stadt Konstanz, Amt für Stadtplanung und Umwelt
08.03.2022 23:00;75;35;40;Sonnig;-3;-4;0;Stadt Konstanz, Amt für Stadtplanung und Umwelt
09.03.2022 00:00;27;7;20;Sonnig;-4;-4;0;Stadt Konstanz, Amt für Stadtplanung und Umwelt
09.03.2022 01:00;17;8;9;Sonnig;-4;-4;0;Stadt Konstanz, Amt für Stadtplanung und Umwelt
09.03.2022 02:00;7;4;3;Sonnig;-4;-4;0;Stadt Konstanz, Amt für Stadtplanung und Umwelt
09.03.2022 03:00;7;6;1;Sonnig;-4;-4;0;Stadt Konstanz, Amt für Stadtplanung und Umwelt
09.03.2022 04:00;5;3;2;Sonnig;-4;-4;0;Stadt Konstanz, Amt für Stadtplanung und Umwelt
09.03.2022 05:00;50;34;16;Sonnig;-4;-4;0;Stadt Konstanz, Amt für Stadtplanung und Umwelt
09.03.2022 06:00;135;79;56;Sonnig;-4;-4;0;Stadt Konstanz, Amt für Stadtplanung und Umwelt
09.03.2022 07:00;770;461;309;Sonnig;-2;-2;0;Stadt Konstanz, Amt für Stadtplanung und Umwelt
09.03.2022 08:00;629;348;281;Sonnig;0;0;0;Stadt Konstanz, Amt für Stadtplanung und Umwelt
09.03.2022 09:00;455;251;204;Sonnig;2;2;0;Stadt Konstanz, Amt für Stadtplanung und Umwelt
09.03.2022 10:00;317;175;142;Sonnig;5;5;0;Stadt Konstanz, Amt für Stadtplanung und Umwelt
09.03.2022 11:00;375;174;201;Sonnig;7;7;0;Stadt Konstanz, Amt für Stadtplanung und Umwelt
09.03.2022 12:00;533;247;286;Sonnig;10;10;0;Stadt Konstanz, Amt für Stadtplanung und Umwelt
09.03.2022 13:00;724;329;395;Sonnig;10;10;0;Stadt Konstanz, Amt für Stadtplanung und Umwelt
09.03.2022 14:00;596;273;323;Sonnig;11;11;0;Stadt Konstanz, Amt für Stadtplanung und Umwelt
09.03.2022 15:00;676;317;359;Sonnig;12;12;0;Stadt Konstanz, Amt für Stadtplanung und Umwelt
09.03.2022 16:00;708;313;395;Sonnig;10;10;0;Stadt Konstanz, Amt für Stadtplanung und Umwelt
09.03.2022 17:00;839;399;440;Sonnig;8;8;0;Stadt Konstanz, Amt für Stadtplanung und Umwelt
09.03.2022 18:00;604;260;344;Sonnig;6;6;0;Stadt Konstanz, Amt für Stadtplanung und Umwelt
09.03.2022 19:00;340;150;190;Sonnig;4;4;0;Stadt Konstanz, Amt für Stadtplanung und Umwelt
09.03.2022 20:00;288;148;140;Sonnig;2;2;0;Stadt Konstanz, Amt für Stadtplanung und Umwelt
09.03.2022 21:00;167;74;93;Sonnig;0;0;0;Stadt Konstanz, Amt für Stadtplanung und Umwelt
09.03.2022 22:00;143;58;85;Sonnig;-1;-1;0;Stadt Konstanz, Amt für Stadtplanung und Umwelt
09.03.2022 23:00;85;34;51;Sonnig;-2;-2;0;Stadt Konstanz, Amt für Stadtplanung und Umwelt
10.03.2022 00:00;46;15;31;Sonnig;-3;-3;0;Stadt Konstanz, Amt für Stadtplanung und Umwelt
10.03.2022 01:00;22;9;13;Sonnig;-3;-3;0;Stadt Konstanz, Amt für Stadtplanung und Umwelt
10.03.2022 02:00;6;0;6;Sonnig;-3;-3;0;Stadt Konstanz, Amt für Stadtplanung und Umwelt
10.03.2022 03:00;16;8;8;Sonnig;-3;-3;0;Stadt Konstanz, Amt für Stadtplanung und Umwelt
10.03.2022 04:00;8;5;3;Sonnig;-3;-3;0;Stadt Konstanz, Amt für Stadtplanung und Umwelt
10.03.2022 05:00;39;27;12;Sonnig;-4;-4;0;Stadt Konstanz, Amt für Stadtplanung und Umwelt
10.03.2022 06:00;144;89;55;Sonnig;-4;-4;0;Stadt Konstanz, Amt für Stadtplanung und Umwelt
10.03.2022 07:00;777;447;330;Sonnig;-2;-2;0;Stadt Konstanz, Amt für Stadtplanung und Umwelt
10.03.2022 08:00;626;334;292;Sonnig;0;0;0;Stadt Konstanz, Amt für Stadtplanung und Umwelt
10.03.2022 09:00;488;267;221;Sonnig;3;3;0;Stadt Konstanz, Amt für Stadtplanung und Umwelt
10.03.2022 10:00;315;171;144;Sonnig;5;5;0;Stadt Konstanz, Amt für Stadtplanung und Umwelt
10.03.2022 11:00;435;216;219;Sonnig;7;8;0;Stadt Konstanz, Amt für Stadtplanung und Umwelt
10.03.2022 12:00;527;230;297;Sonnig;10;10;0;Stadt Konstanz, Amt für Stadtplanung und Umwelt
10.03.2022 13:00;718;319;399;Sonnig;11;11;0;Stadt Konstanz, Amt für Stadtplanung und Umwelt
10.03.2022 14:00;602;286;316;Sonnig;12;12;0;Stadt Konstanz, Amt für Stadtplanung und Umwelt
10.03.2022 15:00;815;388;427;Sonnig;12;12;0;Stadt Konstanz, Amt für Stadtplanung und Umwelt
10.03.2022 16:00;721;351;370;Sonnig;10;10;0;Stadt Konstanz, Amt für Stadtplanung und Umwelt
10.03.2022 17:00;819;352;467;Sonnig;9;9;0;Stadt Konstanz, Amt für Stadtplanung und Umwelt
10.03.2022 18:00;700;301;399;Sonnig;7;7;0;Stadt Konstanz, Amt für Stadtplanung und Umwelt
10.03.2022 19:00;422;224;198;Sonnig;5;5;0;Stadt Konstanz, Amt für Stadtplanung und Umwelt
10.03.2022 20:00;283;157;126;Bedeckt;3;3;0;Stadt Konstanz, Amt für Stadtplanung und Umwelt
10.03.2022 21:00;165;74;91;Bedeckt;1;1;0;Stadt Konstanz, Amt für Stadtplanung und Umwelt
10.03.2022 22:00;157;54;103;Bedeckt;1;1;0;Stadt Konstanz, Amt für Stadtplanung und Umwelt
10.03.2022 23:00;70;30;40;Leicht bewoelkt;0;0;0;Stadt Konstanz, Amt für Stadtplanung und Umwelt
11.03.2022 00:00;42;15;27;Leicht bewoelkt;0;0;0;Stadt Konstanz, Amt für Stadtplanung und Umwelt
11.03.2022 01:00;34;12;22;Leicht bewoelkt;0;0;0;Stadt Konstanz, Amt für Stadtplanung und Umwelt
11.03.2022 02:00;16;7;9;Bewoelkt;0;0;0;Stadt Konstanz, Amt für Stadtplanung und Umwelt
11.03.2022 03:00;4;2;2;Bewoelkt;0;0;0;Stadt Konstanz, Amt für Stadtplanung und Umwelt
11.03.2022 04:00;8;5;3;Bewoelkt;0;0;0;Stadt Konstanz, Amt für Stadtplanung und Umwelt
11.03.2022 05:00;38;27;11;Bedeckt;0;0;0;Stadt Konstanz, Amt für Stadtplanung und Umwelt
11.03.2022 06:00;140;84;56;Bedeckt;0;0;0;Stadt Konstanz, Amt für Stadtplanung und Umwelt
11.03.2022 07:00;758;440;318;Bedeckt;2;2;0;Stadt Konstanz, Amt für Stadtplanung und Umwelt
11.03.2022 08:00;597;326;271;Leicht bewoelkt;3;3;0;Stadt Konstanz, Amt für Stadtplanung und Umwelt
11.03.2022 09:00;493;296;197;Leicht bewoelkt;5;5;0;Stadt Konstanz, Amt für Stadtplanung und Umwelt
11.03.2022 10:00;383;203;180;Leicht bewoelkt;7;7;0;Stadt Konstanz, Amt für Stadtplanung und Umwelt
11.03.2022 11:00;486;238;248;Leicht bewoelkt;9;9;0;Stadt Konstanz, Amt für Stadtplanung und Umwelt
11.03.2022 12:00;684;310;374;Leicht bewoelkt;11;11;0;Stadt Konstanz, Amt für Stadtplanung und Umwelt
11.03.2022 13:00;868;355;513;Leicht bewoelkt;12;12;0;Stadt Konstanz, Amt für Stadtplanung und Umwelt
11.03.2022 14:00;685;318;367;Leicht bewoelkt;12;12;0;Stadt Konstanz, Amt für Stadtplanung und Umwelt
11.03.2022 15:00;683;316;367;Leicht bewoelkt;12;13;0;Stadt Konstanz, Amt für Stadtplanung und Umwelt
11.03.2022 16:00;620;272;348;Leicht bewoelkt;11;11;0;Stadt Konstanz, Amt für Stadtplanung und Umwelt
11.03.2022 17:00;682;307;375;Sonnig;10;9;0;Stadt Konstanz, Amt für Stadtplanung und Umwelt
11.03.2022 18:00;518;233;285;Sonnig;8;8;0;Stadt Konstanz, Amt für Stadtplanung und Umwelt
11.03.2022 19:00;396;216;180;Sonnig;7;6;0;Stadt Konstanz, Amt für Stadtplanung und Umwelt
11.03.2022 20:00;262;140;122;Sonnig;5;5;0;Stadt Konstanz, Amt für Stadtplanung und Umwelt
11.03.2022 21:00;164;86;78;Sonnig;4;4;0;Stadt Konstanz, Amt für Stadtplanung und Umwelt
11.03.2022 22:00;183;78;105;Sonnig;3;3;0;Stadt Konstanz, Amt für Stadtplanung und Umwelt
11.03.2022 23:00;101;36;65;Sonnig;2;2;0;Stadt Konstanz, Amt für Stadtplanung und Umwelt
12.03.2022 00:00;91;41;50;Sonnig;2;1;0;Stadt Konstanz, Amt für Stadtplanung und Umwelt
12.03.2022 01:00;76;24;52;Sonnig;2;1;0;Stadt Konstanz, Amt für Stadtplanung und Umwelt
12.03.2022 02:00;41;12;29;Sonnig;1;1;0;Stadt Konstanz, Amt für Stadtplanung und Umwelt
12.03.2022 03:00;31;13;18;Sonnig;1;1;0;Stadt Konstanz, Amt für Stadtplanung und Umwelt
12.03.2022 04:00;17;8;9;Sonnig;1;1;0;Stadt Konstanz, Amt für Stadtplanung und Umwelt
12.03.2022 05:00;30;19;11;Sonnig;1;1;0;Stadt Konstanz, Amt für Stadtplanung und Umwelt
12.03.2022 06:00;54;32;22;Sonnig;1;1;0;Stadt Konstanz, Amt für Stadtplanung und Umwelt
12.03.2022 07:00;76;35;41;Sonnig;2;2;0;Stadt Konstanz, Amt für Stadtplanung und Umwelt
12.03.2022 08:00;157;88;69;Sonnig;3;3;0;Stadt Konstanz, Amt für Stadtplanung und Umwelt
12.03.2022 09:00;316;183;133;Sonnig;5;5;0;Stadt Konstanz, Amt für Stadtplanung und Umwelt
12.03.2022 10:00;432;235;197;Sonnig;7;7;0;Stadt Konstanz, Amt für Stadtplanung und Umwelt
12.03.2022 11:00;441;257;184;Sonnig;9;9;0;Stadt Konstanz, Amt für Stadtplanung und Umwelt
12.03.2022 12:00;552;292;260;Sonnig;11;11;0;Stadt Konstanz, Amt für Stadtplanung und Umwelt
12.03.2022 13:00;617;310;307;Sonnig;11;11;0;Stadt Konstanz, Amt für Stadtplanung und Umwelt
12.03.2022 14:00;735;375;360;Sonnig;12;12;0;Stadt Konstanz, Amt für Stadtplanung und Umwelt
12.03.2022 15:00;581;339;242;Sonnig;12;12;0;Stadt Konstanz, Amt für Stadtplanung und Umwelt
12.03.2022 16:00;653;317;336;Sonnig;10;10;0;Stadt Konstanz, Amt für Stadtplanung und Umwelt
12.03.2022 17:00;619;272;347;Sonnig;9;9;0;Stadt Konstanz, Amt für Stadtplanung und Umwelt
12.03.2022 18:00;535;229;306;Sonnig;7;7;0;Stadt Konstanz, Amt für Stadtplanung und Umwelt
12.03.2022 19:00;278;139;139;Sonnig;5;5;0;Stadt Konstanz, Amt für Stadtplanung und Umwelt
12.03.2022 20:00;273;138;135;Sonnig;4;4;0;Stadt Konstanz, Amt für Stadtplanung und Umwelt
12.03.2022 21:00;127;53;74;Sonnig;3;3;0;Stadt Konstanz, Amt für Stadtplanung und Umwelt
12.03.2022 22:00;134;54;80;Sonnig;2;1;0;Stadt Konstanz, Amt für Stadtplanung und Umwelt
12.03.2022 23:00;122;42;80;Sonnig;1;0;0;Stadt Konstanz, Amt für Stadtplanung und Umwelt
13.03.2022 00:00;107;43;64;Sonnig;0;-1;0;Stadt Konstanz, Amt für Stadtplanung und Umwelt
13.03.2022 01:00;66;25;41;Sonnig;0;-2;0;Stadt Konstanz, Amt für Stadtplanung und Umwelt
13.03.2022 02:00;42;19;23;Sonnig;0;-2;0;Stadt Konstanz, Amt für Stadtplanung und Umwelt
13.03.2022 03:00;25;3;22;Sonnig;-1;-2;0;Stadt Konstanz, Amt für Stadtplanung und Umwelt
13.03.2022 04:00;12;5;7;Sonnig;-1;-2;0;Stadt Konstanz, Amt für Stadtplanung und Umwelt
13.03.2022 05:00;19;15;4;Leicht bewoelkt;-1;-2;0;Stadt Konstanz, Amt für Stadtplanung und Umwelt
13.03.2022 06:00;27;19;8;Leicht bewoelkt;-1;-2;0;Stadt Konstanz, Amt für Stadtplanung und Umwelt
13.03.2022 07:00;40;14;26;Leicht bewoelkt;1;1;0;Stadt Konstanz, Amt für Stadtplanung und Umwelt
13.03.2022 08:00;77;36;41;Leicht bewoelkt;3;3;0;Stadt Konstanz, Amt für Stadtplanung und Umwelt
13.03.2022 09:00;179;91;88;Leicht bewoelkt;5;5;0;Stadt Konstanz, Amt für Stadtplanung und Umwelt
13.03.2022 10:00;231;115;116;Leicht bewoelkt;7;7;0;Stadt Konstanz, Amt für Stadtplanung und Umwelt
13.03.2022 11:00;339;174;165;Sonnig;9;10;0;Stadt Konstanz, Amt für Stadtplanung und Umwelt
13.03.2022 12:00;387;176;211;Sonnig;11;12;0;Stadt Konstanz, Amt für Stadtplanung und Umwelt
13.03.2022 13:00;519;262;257;Sonnig;12;13;0;Stadt Konstanz, Amt für Stadtplanung und Umwelt
13.03.2022 14:00;540;289;251;Sonnig;13;13;0;Stadt Konstanz, Amt für Stadtplanung und Umwelt
13.03.2022 15:00;511;279;232;Sonnig;14;14;0;Stadt Konstanz, Amt für Stadtplanung und Umwelt
13.03.2022 16:00;496;261;235;Sonnig;12;12;0;Stadt Konstanz, Amt für Stadtplanung und Umwelt
13.03.2022 17:00;528;278;250;Sonnig;10;10;0;Stadt Konstanz, Amt für Stadtplanung und Umwelt
13.03.2022 18:00;401;194;207;Sonnig;9;9;0;Stadt Konstanz, Amt für Stadtplanung und Umwelt
13.03.2022 19:00;199;91;108;Sonnig;7;7;0;Stadt Konstanz, Amt für Stadtplanung und Umwelt
13.03.2022 20:00;121;51;70;Sonnig;5;5;0;Stadt Konstanz, Amt für Stadtplanung und Umwelt
13.03.2022 21:00;90;27;63;Sonnig;3;3;0;Stadt Konstanz, Amt für Stadtplanung und Umwelt
13.03.2022 22:00;77;30;47;Sonnig;3;2;0;Stadt Konstanz, Amt für Stadtplanung und Umwelt
13.03.2022 23:00;48;19;29;Leicht bewoelkt;3;1;0;Stadt Konstanz, Amt für Stadtplanung und Umwelt
14.03.2022 00:00;26;7;19;Leicht bewoelkt;3;1;0;Stadt Konstanz, Amt für Stadtplanung und Umwelt
14.03.2022 01:00;16;13;3;Leicht bewoelkt;2;0;0;Stadt Konstanz, Amt für Stadtplanung und Umwelt
14.03.2022 02:00;3;2;1;Bedeckt;2;0;0;Stadt Konstanz, Amt für Stadtplanung und Umwelt
14.03.2022 03:00;4;3;1;Bedeckt;1;-1;0;Stadt Konstanz, Amt für Stadtplanung und Umwelt
14.03.2022 04:00;7;5;2;Bedeckt;1;-1;0;Stadt Konstanz, Amt für Stadtplanung und Umwelt
14.03.2022 05:00;51;31;20;Leicht bewoelkt;1;0;0;Stadt Konstanz, Amt für Stadtplanung und Umwelt
14.03.2022 06:00;154;92;62;Leicht bewoelkt;2;0;0;Stadt Konstanz, Amt für Stadtplanung und Umwelt
14.03.2022 07:00;955;581;374;Leicht bewoelkt;3;2;0;Stadt Konstanz, Amt für Stadtplanung und Umwelt
14.03.2022 08:00;630;341;289;Sonnig;5;5;0;Stadt Konstanz, Amt für Stadtplanung und Umwelt
14.03.2022 09:00;580;364;216;Sonnig;7;7;0;Stadt Konstanz, Amt für Stadtplanung und Umwelt
14.03.2022 10:00;421;224;197;Sonnig;9;9;0;Stadt Konstanz, Amt für Stadtplanung und Umwelt
14.03.2022 11:00;576;298;278;Sonnig;11;10;0;Stadt Konstanz, Amt für Stadtplanung und Umwelt
14.03.2022 12:00;560;232;328;Sonnig;12;12;0;Stadt Konstanz, Amt für Stadtplanung und Umwelt
14.03.2022 13:00;833;353;480;Sonnig;13;12;0;Stadt Konstanz, Amt für Stadtplanung und Umwelt
14.03.2022 14:00;648;331;317;Leicht bewoelkt;13;13;0;Stadt Konstanz, Amt für Stadtplanung und Umwelt
14.03.2022 15:00;898;408;490;Leicht bewoelkt;14;13;0;Stadt Konstanz, Amt für Stadtplanung und Umwelt
14.03.2022 16:00;775;350;425;Leicht bewoelkt;13;11;0;Stadt Konstanz, Amt für Stadtplanung und Umwelt
14.03.2022 17:00;897;382;515;Leicht bewoelkt;11;10;0;Stadt Konstanz, Amt für Stadtplanung und Umwelt
14.03.2022 18:00;764;331;433;Leicht bewoelkt;10;8;0;Stadt Konstanz, Amt für Stadtplanung und Umwelt
14.03.2022 19:00;497;255;242;Leicht bewoelkt;8;6;0;Stadt Konstanz, Amt für Stadtplanung und Umwelt
14.03.2022 20:00;281;130;151;Sonnig;7;5;0;Stadt Konstanz, Amt für Stadtplanung und Umwelt
14.03.2022 21:00;201;100;101;Sonnig;5;4;0;Stadt Konstanz, Amt für Stadtplanung und Umwelt
14.03.2022 22:00;127;51;76;Sonnig;5;4;0;Stadt Konstanz, Amt für Stadtplanung und Umwelt
14.03.2022 23:00;66;18;48;Leicht bewoelkt;5;4;0;Stadt Konstanz, Amt für Stadtplanung und Umwelt
15.03.2022 00:00;36;22;14;Leicht bewoelkt;4;4;0;Stadt Konstanz, Amt für Stadtplanung und Umwelt
15.03.2022 01:00;19;8;11;Leicht bewoelkt;4;4;0;Stadt Konstanz, Amt für Stadtplanung und Umwelt
15.03.2022 02:00;11;6;5;Bewoelkt;4;4;0;Stadt Konstanz, Amt für Stadtplanung und Umwelt
15.03.2022 03:00;11;8;3;Bewoelkt;4;4;0;Stadt Konstanz, Amt für Stadtplanung und Umwelt
15.03.2022 04:00;12;9;3;Bewoelkt;4;4;0;Stadt Konstanz, Amt für Stadtplanung und Umwelt
15.03.2022 05:00;39;27;12;Bedeckt;4;4;0;Stadt Konstanz, Amt für Stadtplanung und Umwelt
15.03.2022 06:00;154;85;69;Bedeckt;5;5;0;Stadt Konstanz, Amt für Stadtplanung und Umwelt
15.03.2022 07:00;853;559;294;Bedeckt;6;6;0;Stadt Konstanz, Amt für Stadtplanung und Umwelt
15.03.2022 08:00;610;316;294;Leicht bewoelkt;7;7;0;Stadt Konstanz, Amt für Stadtplanung und Umwelt
15.03.2022 09:00;515;298;217;Leicht bewoelkt;9;9;0;Stadt Konstanz, Amt für Stadtplanung und Umwelt
15.03.2022 10:00;320;178;142;Leicht bewoelkt;10;10;0;Stadt Konstanz, Amt für Stadtplanung und Umwelt
15.03.2022 11:00;462;256;206;Bedeckt;12;12;0;Stadt Konstanz, Amt für Stadtplanung und Umwelt
15.03.2022 12:00;531;217;314;Bedeckt;14;14;0;Stadt Konstanz, Amt für Stadtplanung und Umwelt
15.03.2022 13:00;679;306;373;Bedeckt;14;14;0;Stadt Konstanz, Amt für Stadtplanung und Umwelt
15.03.2022 14:00;515;263;252;Leicht bewoelkt;15;15;0;Stadt Konstanz, Amt für Stadtplanung und Umwelt
15.03.2022 15:00;850;397;453;Leicht bewoelkt;15;16;0;Stadt Konstanz, Amt für Stadtplanung und Umwelt
15.03.2022 16:00;629;264;365;Leicht bewoelkt;14;14;0;Stadt Konstanz, Amt für Stadtplanung und Umwelt
15.03.2022 17:00;782;360;422;Sonnig;12;12;0;Stadt Konstanz, Amt für Stadtplanung und Umwelt
15.03.2022 18:00;654;288;366;Sonnig;11;10;0;Stadt Konstanz, Amt für Stadtplanung und Umwelt
15.03.2022 19:00;418;197;221;Sonnig;9;9;0;Stadt Konstanz, Amt für Stadtplanung und Umwelt
15.03.2022 20:00;288;138;150;Leicht bewoelkt;8;7;0;Stadt Konstanz, Amt für Stadtplanung und Umwelt
15.03.2022 21:00;180;71;109;Leicht bewoelkt;7;6;0;Stadt Konstanz, Amt für Stadtplanung und Umwelt
15.03.2022 22:00;128;57;71;Leicht bewoelkt;7;6;0;Stadt Konstanz, Amt für Stadtplanung und Umwelt
15.03.2022 23:00;89;25;64;Leicht bewoelkt;7;6;0;Stadt Konstanz, Amt für Stadtplanung und Umwelt
16.03.2022 00:00;36;15;21;Leicht bewoelkt;8;7;0;Stadt Konstanz, Amt für Stadtplanung und Umwelt
16.03.2022 01:00;17;6;11;Leicht bewoelkt;7;6;0;Stadt Konstanz, Amt für Stadtplanung und Umwelt
16.03.2022 02:00;7;3;4;Sonnig;7;6;0;Stadt Konstanz, Amt für Stadtplanung und Umwelt
16.03.2022 03:00;10;5;5;Sonnig;7;6;0;Stadt Konstanz, Amt für Stadtplanung und Umwelt
16.03.2022 04:00;9;6;3;Sonnig;6;6;0;Stadt Konstanz, Amt für Stadtplanung und Umwelt
16.03.2022 05:00;57;37;20;Sonnig;6;6;0;Stadt Konstanz, Amt für Stadtplanung und Umwelt
16.03.2022 06:00;173;96;77;Sonnig;6;6;0;Stadt Konstanz, Amt für Stadtplanung und Umwelt
16.03.2022 07:00;983;661;322;Sonnig;8;7;0;Stadt Konstanz, Amt für Stadtplanung und Umwelt
16.03.2022 08:00;703;400;303;Sonnig;9;9;0;Stadt Konstanz, Amt für Stadtplanung und Umwelt
16.03.2022 09:00;644;392;252;Sonnig;11;11;0;Stadt Konstanz, Amt für Stadtplanung und Umwelt
16.03.2022 10:00;395;205;190;Sonnig;12;12;0;Stadt Konstanz, Amt für Stadtplanung und Umwelt
16.03.2022 11:00;597;254;343;Sonnig;14;14;0;Stadt Konstanz, Amt für Stadtplanung und Umwelt
16.03.2022 12:00;625;290;335;Sonnig;16;16;0;Stadt Konstanz, Amt für Stadtplanung und Umwelt
16.03.2022 13:00;1012;522;490;Sonnig;17;17;0;Stadt Konstanz, Amt für Stadtplanung und Umwelt
16.03.2022 14:00;635;289;346;Sonnig;19;19;0;Stadt Konstanz, Amt für Stadtplanung und Umwelt
16.03.2022 15:00;877;352;525;Sonnig;20;20;0;Stadt Konstanz, Amt für Stadtplanung und Umwelt
16.03.2022 16:00;797;367;430;Sonnig;19;19;0;Stadt Konstanz, Amt für Stadtplanung und Umwelt
16.03.2022 17:00;1021;452;569;Sonnig;17;17;0;Stadt Konstanz, Amt für Stadtplanung und Umwelt
16.03.2022 18:00;722;332;390;Sonnig;15;15;0;Stadt Konstanz, Amt für Stadtplanung und Umwelt
16.03.2022 19:00;472;240;232;Sonnig;13;13;0;Stadt Konstanz, Amt für Stadtplanung und Umwelt
16.03.2022 20:00;328;157;171;Sonnig;11;10;0;Stadt Konstanz, Amt für Stadtplanung und Umwelt
16.03.2022 21:00;225;103;122;Sonnig;9;7;0;Stadt Konstanz, Amt für Stadtplanung und Umwelt
16.03.2022 22:00;158;63;95;Sonnig;8;6;0;Stadt Konstanz, Amt für Stadtplanung und Umwelt
16.03.2022 23:00;95;39;56;Sonnig;7;6;0;Stadt Konstanz, Amt für Stadtplanung und Umwelt
17.03.2022 00:00;64;18;46;Sonnig;6;5;0;Stadt Konstanz, Amt für Stadtplanung und Umwelt
17.03.2022 01:00;23;4;19;Sonnig;6;4;0;Stadt Konstanz, Amt für Stadtplanung und Umwelt
17.03.2022 02:00;17;9;8;Leichter Nebel;5;4;0;Stadt Konstanz, Amt für Stadtplanung und Umwelt
17.03.2022 03:00;3;1;2;Leichter Nebel;5;3;0;Stadt Konstanz, Amt für Stadtplanung und Umwelt
17.03.2022 04:00;12;8;4;Leichter Nebel;4;3;0;Stadt Konstanz, Amt für Stadtplanung und Umwelt
17.03.2022 05:00;48;29;19;Leichter Nebel;4;3;0;Stadt Konstanz, Amt für Stadtplanung und Umwelt
17.03.2022 06:00;164;90;74;Leichter Nebel;3;3;0;Stadt Konstanz, Amt für Stadtplanung und Umwelt
17.03.2022 07:00;980;647;333;Leichter Nebel;4;4;0;Stadt Konstanz, Amt für Stadtplanung und Umwelt
17.03.2022 08:00;699;375;324;Bewoelkt;6;5;0;Stadt Konstanz, Amt für Stadtplanung und Umwelt
17.03.2022 09:00;673;383;290;Bewoelkt;7;6;0;Stadt Konstanz, Amt für Stadtplanung und Umwelt
17.03.2022 10:00;399;218;181;Bewoelkt;9;9;0;Stadt Konstanz, Amt für Stadtplanung und Umwelt
17.03.2022 11:00;590;303;287;Sonnig;11;11;0;Stadt Konstanz, Amt für Stadtplanung und Umwelt
17.03.2022 12:00;572;254;318;Sonnig;13;14;0;Stadt Konstanz, Amt für Stadtplanung und Umwelt
17.03.2022 13:00;816;384;432;Sonnig;13;14;0;Stadt Konstanz, Amt für Stadtplanung und Umwelt
17.03.2022 14:00;570;288;282;Sonnig;14;14;0;Stadt Konstanz, Amt für Stadtplanung und Umwelt
17.03.2022 15:00;835;376;459;Sonnig;14;14;0;Stadt Konstanz, Amt für Stadtplanung und Umwelt
17.03.2022 16:00;742;355;387;Sonnig;13;12;0;Stadt Konstanz, Amt für Stadtplanung und Umwelt
17.03.2022 17:00;874;350;524;Sonnig;12;11;0;Stadt Konstanz, Amt für Stadtplanung und Umwelt
17.03.2022 18:00;688;308;380;Sonnig;11;10;0;Stadt Konstanz, Amt für Stadtplanung und Umwelt
17.03.2022 19:00;497;252;245;Sonnig;9;8;0;Stadt Konstanz, Amt für Stadtplanung und Umwelt
17.03.2022 20:00;337;168;169;Sonnig;7;6;0;Stadt Konstanz, Amt für Stadtplanung und Umwelt
17.03.2022 21:00;234;96;138;Sonnig;5;3;0;Stadt Konstanz, Amt für Stadtplanung und Umwelt
17.03.2022 22:00;167;71;96;Sonnig;6;4;0;Stadt Konstanz, Amt für Stadtplanung und Umwelt
17.03.2022 23:00;111;41;70;Leicht bewoelkt;6;4;0;Stadt Konstanz, Amt für Stadtplanung und Umwelt
18.03.2022 00:00;84;41;43;Leicht bewoelkt;7;4;0;Stadt Konstanz, Amt für Stadtplanung und Umwelt
18.03.2022 01:00;39;11;28;Leicht bewoelkt;6;4;0;Stadt Konstanz, Amt für Stadtplanung und Umwelt
18.03.2022 02:00;13;10;3;Leicht bewoelkt;6;3;0;Stadt Konstanz, Amt für Stadtplanung und Umwelt
18.03.2022 03:00;10;6;4;Leicht bewoelkt;5;2;0;Stadt Konstanz, Amt für Stadtplanung und Umwelt
18.03.2022 04:00;9;6;3;Leicht bewoelkt;5;2;0;Stadt Konstanz, Amt für Stadtplanung und Umwelt
18.03.2022 05:00;40;29;11;Bedeckt;5;2;0;Stadt Konstanz, Amt für Stadtplanung und Umwelt
18.03.2022 06:00;155;97;58;Bedeckt;5;2;0;Stadt Konstanz, Amt für Stadtplanung und Umwelt
18.03.2022 07:00;860;556;304;Bedeckt;6;2;0;Stadt Konstanz, Amt für Stadtplanung und Umwelt
18.03.2022 08:00;582;327;255;Bedeckt;6;3;0;Stadt Konstanz, Amt für Stadtplanung und Umwelt
18.03.2022 09:00;595;367;228;Bedeckt;6;3;0;Stadt Konstanz, Amt für Stadtplanung und Umwelt
18.03.2022 10:00;412;225;187;Bedeckt;8;5;0;Stadt Konstanz, Amt für Stadtplanung und Umwelt
18.03.2022 11:00;563;284;279;Leicht bewoelkt;9;7;0;Stadt Konstanz, Amt für Stadtplanung und Umwelt
18.03.2022 12:00;657;289;368;Leicht bewoelkt;11;9;0;Stadt Konstanz, Amt für Stadtplanung und Umwelt
18.03.2022 13:00;907;350;557;Leicht bewoelkt;12;10;0;Stadt Konstanz, Amt für Stadtplanung und Umwelt
18.03.2022 14:00;626;292;334;Leicht bewoelkt;12;10;0;Stadt Konstanz, Amt für Stadtplanung und Umwelt
18.03.2022 15:00;734;328;406;Leicht bewoelkt;13;11;0;Stadt Konstanz, Amt für Stadtplanung und Umwelt
18.03.2022 16:00;649;298;351;Leicht bewoelkt;13;11;0;Stadt Konstanz, Amt für Stadtplanung und Umwelt
18.03.2022 17:00;678;311;367;Sonnig;12;10;0;Stadt Konstanz, Amt für Stadtplanung und Umwelt
18.03.2022 18:00;549;231;318;Sonnig;12;10;0;Stadt Konstanz, Amt für Stadtplanung und Umwelt
18.03.2022 19:00;428;233;195;Sonnig;11;8;0;Stadt Konstanz, Amt für Stadtplanung und Umwelt
18.03.2022 20:00;301;158;143;Sonnig;9;6;0;Stadt Konstanz, Amt für Stadtplanung und Umwelt
18.03.2022 21:00;209;111;98;Sonnig;8;4;0;Stadt Konstanz, Amt für Stadtplanung und Umwelt
18.03.2022 22:00;163;71;92;Sonnig;7;3;0;Stadt Konstanz, Amt für Stadtplanung und Umwelt
18.03.2022 23:00;139;69;70;Sonnig;6;2;0;Stadt Konstanz, Amt für Stadtplanung und Umwelt
19.03.2022 00:00;103;26;77;Sonnig;5;1;0;Stadt Konstanz, Amt für Stadtplanung und Umwelt
19.03.2022 01:00;69;29;40;Sonnig;5;0;0;Stadt Konstanz, Amt für Stadtplanung und Umwelt
19.03.2022 02:00;52;9;43;Sonnig;4;0;0;Stadt Konstanz, Amt für Stadtplanung und Umwelt
19.03.2022 03:00;31;4;27;Sonnig;4;-1;0;Stadt Konstanz, Amt für Stadtplanung und Umwelt
19.03.2022 04:00;20;9;11;Sonnig;3;-2;0;Stadt Konstanz, Amt für Stadtplanung und Umwelt
19.03.2022 05:00;34;20;14;Sonnig;2;-2;0;Stadt Konstanz, Amt für Stadtplanung und Umwelt
19.03.2022 06:00;37;18;19;Sonnig;2;-3;0;Stadt Konstanz, Amt für Stadtplanung und Umwelt
19.03.2022 07:00;66;29;37;Sonnig;3;-1;0;Stadt Konstanz, Amt für Stadtplanung und Umwelt
19.03.2022 08:00;161;90;71;Sonnig;4;1;0;Stadt Konstanz, Amt für Stadtplanung und Umwelt
19.03.2022 09:00;316;179;137;Sonnig;6;3;0;Stadt Konstanz, Amt für Stadtplanung und Umwelt
19.03.2022 10:00;417;229;188;Sonnig;8;6;0;Stadt Konstanz, Amt für Stadtplanung und Umwelt
19.03.2022 11:00;542;299;243;Sonnig;11;9;0;Stadt Konstanz, Amt für Stadtplanung und Umwelt
19.03.2022 12:00;546;299;247;Sonnig;13;12;0;Stadt Konstanz, Amt für Stadtplanung und Umwelt
19.03.2022 13:00;536;274;262;Sonnig;13;12;0;Stadt Konstanz, Amt für Stadtplanung und Umwelt
19.03.2022 14:00;562;279;283;Sonnig;13;12;0;Stadt Konstanz, Amt für Stadtplanung und Umwelt
19.03.2022 15:00;628;314;314;Sonnig;13;12;0;Stadt Konstanz, Amt für Stadtplanung und Umwelt
19.03.2022 16:00;556;274;282;Sonnig;12;10;0;Stadt Konstanz, Amt für Stadtplanung und Umwelt
19.03.2022 17:00;533;253;280;Sonnig;11;8;0;Stadt Konstanz, Amt für Stadtplanung und Umwelt
19.03.2022 18:00;474;240;234;Sonnig;9;7;0;Stadt Konstanz, Amt für Stadtplanung und Umwelt
19.03.2022 19:00;337;171;166;Sonnig;8;5;0;Stadt Konstanz, Amt für Stadtplanung und Umwelt
19.03.2022 20:00;257;138;119;Bewoelkt;6;3;0;Stadt Konstanz, Amt für Stadtplanung und Umwelt
19.03.2022 21:00;178;94;84;Bewoelkt;4;1;0;Stadt Konstanz, Amt für Stadtplanung und Umwelt
19.03.2022 22:00;135;48;87;Bewoelkt;4;1;0;Stadt Konstanz, Amt für Stadtplanung und Umwelt
19.03.2022 23:00;122;40;82;Sonnig;3;2;0;Stadt Konstanz, Amt für Stadtplanung und Umwelt
20.03.2022 00:00;87;30;57;Sonnig;3;3;0;Stadt Konstanz, Amt für Stadtplanung und Umwelt
20.03.2022 01:00;60;16;44;Sonnig;2;2;0;Stadt Konstanz, Amt für Stadtplanung und Umwelt
20.03.2022 02:00;55;20;35;Sonnig;2;2;0;Stadt Konstanz, Amt für Stadtplanung und Umwelt
20.03.2022 03:00;46;18;28;Sonnig;2;2;0;Stadt Konstanz, Amt für Stadtplanung und Umwelt
20.03.2022 04:00;38;17;21;Sonnig;1;1;0;Stadt Konstanz, Amt für Stadtplanung und Umwelt
20.03.2022 05:00;25;16;9;Sonnig;1;1;0;Stadt Konstanz, Amt für Stadtplanung und Umwelt
20.03.2022 06:00;42;24;18;Sonnig;1;1;0;Stadt Konstanz, Amt für Stadtplanung und Umwelt
20.03.2022 07:00;52;24;28;Sonnig;3;3;0;Stadt Konstanz, Amt für Stadtplanung und Umwelt
20.03.2022 08:00;71;34;37;Sonnig;5;5;0;Stadt Konstanz, Amt für Stadtplanung und Umwelt
20.03.2022 09:00;169;70;99;Sonnig;7;7;0;Stadt Konstanz, Amt für Stadtplanung und Umwelt
20.03.2022 10:00;210;112;98;Sonnig;9;9;0;Stadt Konstanz, Amt für Stadtplanung und Umwelt
20.03.2022 11:00;300;149;151;Sonnig;11;11;0;Stadt Konstanz, Amt für Stadtplanung und Umwelt
20.03.2022 12:00;393;190;203;Sonnig;13;13;0;Stadt Konstanz, Amt für Stadtplanung und Umwelt
20.03.2022 13:00;458;221;237;Sonnig;13;13;0;Stadt Konstanz, Amt für Stadtplanung und Umwelt
20.03.2022 14:00;512;269;243;Sonnig;13;13;0;Stadt Konstanz, Amt für Stadtplanung und Umwelt
20.03.2022 15:00;522;283;239;Sonnig;13;13;0;Stadt Konstanz, Amt für Stadtplanung und Umwelt
20.03.2022 16:00;504;259;245;Sonnig;12;11;0;Stadt Konstanz, Amt für Stadtplanung und Umwelt
20.03.2022 17:00;500;258;242;Sonnig;10;9;0;Stadt Konstanz, Amt für Stadtplanung und Umwelt
20.03.2022 18:00;416;183;233;Sonnig;9;8;0;Stadt Konstanz, Amt für Stadtplanung und Umwelt
20.03.2022 19:00;244;132;112;Sonnig;7;6;0;Stadt Konstanz, Amt für Stadtplanung und Umwelt
20.03.2022 20:00;181;76;105;Sonnig;6;4;0;Stadt Konstanz, Amt für Stadtplanung und Umwelt
20.03.2022 21:00;111;46;65;Sonnig;4;3;0;Stadt Konstanz, Amt für Stadtplanung und Umwelt
20.03.2022 22:00;73;37;36;Sonnig;3;2;0;Stadt Konstanz, Amt für Stadtplanung und Umwelt
20.03.2022 23:00;57;24;33;Sonnig;3;2;0;Stadt Konstanz, Amt für Stadtplanung und Umwelt
21.03.2022 00:00;19;6;13;Sonnig;2;2;0;Stadt Konstanz, Amt für Stadtplanung und Umwelt
21.03.2022 01:00;6;5;1;Sonnig;2;1;0;Stadt Konstanz, Amt für Stadtplanung und Umwelt
21.03.2022 02:00;9;4;5;Sonnig;1;0;0;Stadt Konstanz, Amt für Stadtplanung und Umwelt
21.03.2022 03:00;8;3;5;Sonnig;1;-1;0;Stadt Konstanz, Amt für Stadtplanung und Umwelt
21.03.2022 04:00;5;3;2;Sonnig;0;-1;0;Stadt Konstanz, Amt für Stadtplanung und Umwelt
21.03.2022 05:00;34;23;11;Sonnig;0;-1;0;Stadt Konstanz, Amt für Stadtplanung und Umwelt
21.03.2022 06:00;151;87;64;Sonnig;-1;-2;0;Stadt Konstanz, Amt für Stadtplanung und Umwelt
21.03.2022 07:00;965;624;341;Sonnig;2;1;0;Stadt Konstanz, Amt für Stadtplanung und Umwelt
21.03.2022 08:00;641;359;282;Sonnig;4;4;0;Stadt Konstanz, Amt für Stadtplanung und Umwelt
21.03.2022 09:00;630;379;251;Sonnig;7;7;0;Stadt Konstanz, Amt für Stadtplanung und Umwelt
21.03.2022 10:00;375;201;174;Sonnig;9;10;0;Stadt Konstanz, Amt für Stadtplanung und Umwelt
21.03.2022 11:00;565;311;254;Sonnig;12;12;0;Stadt Konstanz, Amt für Stadtplanung und Umwelt
21.03.2022 12:00;534;240;294;Sonnig;14;15;0;Stadt Konstanz, Amt für Stadtplanung und Umwelt
21.03.2022 13:00;916;391;525;Sonnig;14;14;0;Stadt Konstanz, Amt für Stadtplanung und Umwelt
21.03.2022 14:00;661;330;331;Sonnig;14;14;0;Stadt Konstanz, Amt für Stadtplanung und Umwelt
21.03.2022 15:00;966;421;545;Sonnig;14;14;0;Stadt Konstanz, Amt für Stadtplanung und Umwelt
21.03.2022 16:00;817;379;438;Sonnig;12;12;0;Stadt Konstanz, Amt für Stadtplanung und Umwelt
21.03.2022 17:00;984;438;546;Sonnig;11;10;0;Stadt Konstanz, Amt für Stadtplanung und Umwelt
21.03.2022 18:00;815;348;467;Sonnig;9;8;0;Stadt Konstanz, Amt für Stadtplanung und Umwelt
21.03.2022 19:00;503;219;284;Sonnig;8;6;0;Stadt Konstanz, Amt für Stadtplanung und Umwelt
21.03.2022 20:00;333;139;194;Sonnig;6;5;0;Stadt Konstanz, Amt für Stadtplanung und Umwelt
21.03.2022 21:00;190;78;112;Sonnig;5;3;0;Stadt Konstanz, Amt für Stadtplanung und Umwelt
21.03.2022 22:00;142;64;78;Sonnig;4;3;0;Stadt Konstanz, Amt für Stadtplanung und Umwelt
21.03.2022 23:00;60;21;39;Sonnig;3;2;0;Stadt Konstanz, Amt für Stadtplanung und Umwelt
22.03.2022 00:00;37;19;18;Sonnig;2;2;0;Stadt Konstanz, Amt für Stadtplanung und Umwelt
22.03.2022 01:00;13;7;6;Sonnig;1;1;0;Stadt Konstanz, Amt für Stadtplanung und Umwelt
22.03.2022 02:00;7;4;3;Sonnig;1;1;0;Stadt Konstanz, Amt für Stadtplanung und Umwelt
22.03.2022 03:00;7;5;2;Sonnig;1;1;0;Stadt Konstanz, Amt für Stadtplanung und Umwelt
22.03.2022 04:00;10;9;1;Sonnig;0;0;0;Stadt Konstanz, Amt für Stadtplanung und Umwelt
22.03.2022 05:00;49;33;16;Sonnig;0;0;0;Stadt Konstanz, Amt für Stadtplanung und Umwelt
22.03.2022 06:00;182;100;82;Sonnig;-1;-1;0;Stadt Konstanz, Amt für Stadtplanung und Umwelt
22.03.2022 07:00;1059;683;376;Sonnig;2;2;0;Stadt Konstanz, Amt für Stadtplanung und Umwelt
22.03.2022 08:00;704;393;311;Sonnig;4;4;0;Stadt Konstanz, Amt für Stadtplanung und Umwelt
22.03.2022 09:00;643;382;261;Sonnig;7;7;0;Stadt Konstanz, Amt für Stadtplanung und Umwelt
22.03.2022 10:00;429;242;187;Sonnig;9;9;0;Stadt Konstanz, Amt für Stadtplanung und Umwelt
22.03.2022 11:00;649;341;308;Sonnig;11;11;0;Stadt Konstanz, Amt für Stadtplanung und Umwelt
22.03.2022 12:00;658;306;352;Sonnig;14;14;0;Stadt Konstanz, Amt für Stadtplanung und Umwelt
22.03.2022 13:00;882;394;488;Sonnig;15;15;0;Stadt Konstanz, Amt für Stadtplanung und Umwelt
22.03.2022 14:00;647;350;297;Sonnig;15;15;0;Stadt Konstanz, Amt für Stadtplanung und Umwelt
22.03.2022 15:00;1022;477;545;Sonnig;16;16;0;Stadt Konstanz, Amt für Stadtplanung und Umwelt
22.03.2022 16:00;891;393;498;Sonnig;14;14;0;Stadt Konstanz, Amt für Stadtplanung und Umwelt
22.03.2022 17:00;1058;462;596;Sonnig;12;13;0;Stadt Konstanz, Amt für Stadtplanung und Umwelt
22.03.2022 18:00;830;358;472;Sonnig;11;11;0;Stadt Konstanz, Amt für Stadtplanung und Umwelt
22.03.2022 19:00;558;250;308;Sonnig;9;9;0;Stadt Konstanz, Amt für Stadtplanung und Umwelt
22.03.2022 20:00;365;162;203;Sonnig;7;7;0;Stadt Konstanz, Amt für Stadtplanung und Umwelt
22.03.2022 21:00;215;95;120;Sonnig;5;5;0;Stadt Konstanz, Amt für Stadtplanung und Umwelt
22.03.2022 22:00;166;69;97;Sonnig;4;4;0;Stadt Konstanz, Amt für Stadtplanung und Umwelt
22.03.2022 23:00;95;36;59;Sonnig;3;3;0;Stadt Konstanz, Amt für Stadtplanung und Umwelt
23.03.2022 00:00;47;18;29;Sonnig;3;3;0;Stadt Konstanz, Amt für Stadtplanung und Umwelt
23.03.2022 01:00;14;6;8;Sonnig;2;2;0;Stadt Konstanz, Amt für Stadtplanung und Umwelt
23.03.2022 02:00;13;6;7;Sonnig;2;2;0;Stadt Konstanz, Amt für Stadtplanung und Umwelt
23.03.2022 03:00;6;4;2;Sonnig;1;1;0;Stadt Konstanz, Amt für Stadtplanung und Umwelt
23.03.2022 04:00;9;7;2;Sonnig;1;1;0;Stadt Konstanz, Amt für Stadtplanung und Umwelt
23.03.2022 05:00;55;32;23;Sonnig;1;1;0;Stadt Konstanz, Amt für Stadtplanung und Umwelt
23.03.2022 06:00;187;108;79;Sonnig;0;0;0;Stadt Konstanz, Amt für Stadtplanung und Umwelt
23.03.2022 07:00;1067;712;355;Sonnig;3;3;0;Stadt Konstanz, Amt für Stadtplanung und Umwelt
23.03.2022 08:00;747;435;312;Sonnig;5;5;0;Stadt Konstanz, Amt für Stadtplanung und Umwelt
23.03.2022 09:00;694;415;279;Sonnig;8;8;0;Stadt Konstanz, Amt für Stadtplanung und Umwelt
23.03.2022 10:00;434;237;197;Sonnig;10;10;0;Stadt Konstanz, Amt für Stadtplanung und Umwelt
23.03.2022 11:00;635;284;351;Sonnig;12;12;0;Stadt Konstanz, Amt für Stadtplanung und Umwelt
23.03.2022 12:00;716;331;385;Sonnig;15;15;0;Stadt Konstanz, Amt für Stadtplanung und Umwelt
23.03.2022 13:00;1021;513;508;Sonnig;16;16;0;Stadt Konstanz, Amt für Stadtplanung und Umwelt
23.03.2022 14:00;652;320;332;Sonnig;16;16;0;Stadt Konstanz, Amt für Stadtplanung und Umwelt
23.03.2022 15:00;941;422;519;Sonnig;17;17;0;Stadt Konstanz, Amt für Stadtplanung und Umwelt
23.03.2022 16:00;922;424;498;Sonnig;15;15;0;Stadt Konstanz, Amt für Stadtplanung und Umwelt
23.03.2022 17:00;1109;524;585;Sonnig;13;13;0;Stadt Konstanz, Amt für Stadtplanung und Umwelt
23.03.2022 18:00;831;358;473;Sonnig;11;11;0;Stadt Konstanz, Amt für Stadtplanung und Umwelt
23.03.2022 19:00;557;233;324;Sonnig;9;9;0;Stadt Konstanz, Amt für Stadtplanung und Umwelt
23.03.2022 20:00;395;182;213;Sonnig;7;7;0;Stadt Konstanz, Amt für Stadtplanung und Umwelt
23.03.2022 21:00;221;79;142;Sonnig;6;6;0;Stadt Konstanz, Amt für Stadtplanung und Umwelt
23.03.2022 22:00;182;72;110;Sonnig;5;5;0;Stadt Konstanz, Amt für Stadtplanung und Umwelt
23.03.2022 23:00;114;44;70;Sonnig;4;4;0;Stadt Konstanz, Amt für Stadtplanung und Umwelt
24.03.2022 00:00;51;10;41;Sonnig;4;4;0;Stadt Konstanz, Amt für Stadtplanung und Umwelt
24.03.2022 01:00;28;8;20;Sonnig;3;3;0;Stadt Konstanz, Amt für Stadtplanung und Umwelt
24.03.2022 02:00;18;11;7;Sonnig;3;3;0;Stadt Konstanz, Amt für Stadtplanung und Umwelt
24.03.2022 03:00;13;4;9;Sonnig;2;2;0;Stadt Konstanz, Amt für Stadtplanung und Umwelt
24.03.2022 04:00;9;5;4;Sonnig;2;2;0;Stadt Konstanz, Amt für Stadtplanung und Umwelt
24.03.2022 05:00;61;39;22;Sonnig;2;2;0;Stadt Konstanz, Amt für Stadtplanung und Umwelt
24.03.2022 06:00;164;95;69;Sonnig;2;2;0;Stadt Konstanz, Amt für Stadtplanung und Umwelt
24.03.2022 07:00;1046;703;343;Sonnig;4;4;0;Stadt Konstanz, Amt für Stadtplanung und Umwelt
24.03.2022 08:00;748;424;324;Sonnig;6;6;0;Stadt Konstanz, Amt für Stadtplanung und Umwelt
24.03.2022 09:00;698;410;288;Sonnig;9;9;0;Stadt Konstanz, Amt für Stadtplanung und Umwelt
24.03.2022 10:00;433;238;195;Sonnig;11;11;0;Stadt Konstanz, Amt für Stadtplanung und Umwelt
24.03.2022 11:00;599;316;283;Sonnig;13;13;0;Stadt Konstanz, Amt für Stadtplanung und Umwelt
24.03.2022 12:00;716;301;415;Sonnig;15;16;0;Stadt Konstanz, Amt für Stadtplanung und Umwelt
24.03.2022 13:00;954;415;539;Sonnig;15;16;0;Stadt Konstanz, Amt für Stadtplanung und Umwelt
24.03.2022 14:00;632;296;336;Sonnig;16;16;0;Stadt Konstanz, Amt für Stadtplanung und Umwelt
24.03.2022 15:00;1001;480;521;Sonnig;16;16;0;Stadt Konstanz, Amt für Stadtplanung und Umwelt
24.03.2022 16:00;906;426;480;Sonnig;14;14;0;Stadt Konstanz, Amt für Stadtplanung und Umwelt
24.03.2022 17:00;1114;469;645;Sonnig;13;12;0;Stadt Konstanz, Amt für Stadtplanung und Umwelt
24.03.2022 18:00;868;400;468;Sonnig;11;11;0;Stadt Konstanz, Amt für Stadtplanung und Umwelt
24.03.2022 19:00;619;280;339;Sonnig;9;9;0;Stadt Konstanz, Amt für Stadtplanung und Umwelt
24.03.2022 20:00;356;177;179;Sonnig;8;7;0;Stadt Konstanz, Amt für Stadtplanung und Umwelt
24.03.2022 21:00;240;103;137;Sonnig;6;5;0;Stadt Konstanz, Amt für Stadtplanung und Umwelt
24.03.2022 22:00;208;82;126;Sonnig;5;5;0;Stadt Konstanz, Amt für Stadtplanung und Umwelt
24.03.2022 23:00;118;30;88;Sonnig;5;4;0;Stadt Konstanz, Amt für Stadtplanung und Umwelt
25.03.2022 00:00;54;21;33;Sonnig;4;4;0;Stadt Konstanz, Amt für Stadtplanung und Umwelt
25.03.2022 01:00;35;15;20;Sonnig;4;4;0;Stadt Konstanz, Amt für Stadtplanung und Umwelt
25.03.2022 02:00;19;12;7;Sonnig;3;3;0;Stadt Konstanz, Amt für Stadtplanung und Umwelt
25.03.2022 03:00;21;17;4;Sonnig;3;3;0;Stadt Konstanz, Amt für Stadtplanung und Umwelt
25.03.2022 04:00;15;11;4;Sonnig;2;2;0;Stadt Konstanz, Amt für Stadtplanung und Umwelt
25.03.2022 05:00;47;31;16;Sonnig;2;2;0;Stadt Konstanz, Amt für Stadtplanung und Umwelt
25.03.2022 06:00;178;102;76;Sonnig;2;2;0;Stadt Konstanz, Amt für Stadtplanung und Umwelt
25.03.2022 07:00;918;590;328;Sonnig;4;4;0;Stadt Konstanz, Amt für Stadtplanung und Umwelt
25.03.2022 08:00;641;359;282;Sonnig;7;7;0;Stadt Konstanz, Amt für Stadtplanung und Umwelt
25.03.2022 09:00;608;367;241;Sonnig;9;9;0;Stadt Konstanz, Amt für Stadtplanung und Umwelt
25.03.2022 10:00;520;290;230;Sonnig;11;11;0;Stadt Konstanz, Amt für Stadtplanung und Umwelt
25.03.2022 11:00;803;441;362;Sonnig;12;13;0;Stadt Konstanz, Amt für Stadtplanung und Umwelt
25.03.2022 12:00;815;333;482;Sonnig;14;14;0;Stadt Konstanz, Amt für Stadtplanung und Umwelt
25.03.2022 13:00;1028;400;628;Sonnig;14;15;0;Stadt Konstanz, Amt für Stadtplanung und Umwelt
25.03.2022 14:00;816;389;427;Sonnig;15;15;0;Stadt Konstanz, Amt für Stadtplanung und Umwelt
25.03.2022 15:00;919;441;478;Sonnig;15;15;0;Stadt Konstanz, Amt für Stadtplanung und Umwelt
25.03.2022 16:00;782;361;421;Sonnig;14;13;0;Stadt Konstanz, Amt für Stadtplanung und Umwelt
25.03.2022 17:00;893;451;442;Sonnig;12;11;0;Stadt Konstanz, Amt für Stadtplanung und Umwelt
25.03.2022 18:00;732;324;408;Sonnig;11;9;0;Stadt Konstanz, Amt für Stadtplanung und Umwelt
25.03.2022 19:00;534;226;308;Sonnig;9;8;0;Stadt Konstanz, Amt für Stadtplanung und Umwelt
25.03.2022 20:00;318;167;151;Sonnig;7;6;0;Stadt Konstanz, Amt für Stadtplanung und Umwelt
25.03.2022 21:00;240;128;112;Sonnig;6;5;0;Stadt Konstanz, Amt für Stadtplanung und Umwelt
25.03.2022 22:00;223;90;133;Sonnig;5;4;0;Stadt Konstanz, Amt für Stadtplanung und Umwelt
25.03.2022 23:00;161;68;93;Sonnig;4;3;0;Stadt Konstanz, Amt für Stadtplanung und Umwelt
26.03.2022 00:00;150;52;98;Sonnig;4;3;0;Stadt Konstanz, Amt für Stadtplanung und Umwelt
26.03.2022 01:00;80;30;50;Sonnig;3;2;0;Stadt Konstanz, Amt für Stadtplanung und Umwelt
26.03.2022 02:00;64;25;39;Sonnig;3;2;0;Stadt Konstanz, Amt für Stadtplanung und Umwelt
26.03.2022 03:00;25;10;15;Sonnig;3;1;0;Stadt Konstanz, Amt für Stadtplanung und Umwelt
26.03.2022 04:00;26;14;12;Sonnig;2;1;0;Stadt Konstanz, Amt für Stadtplanung und Umwelt
26.03.2022 05:00;29;13;16;Sonnig;2;0;0;Stadt Konstanz, Amt für Stadtplanung und Umwelt
26.03.2022 06:00;46;25;21;Sonnig;2;0;0;Stadt Konstanz, Amt für Stadtplanung und Umwelt
26.03.2022 07:00;65;25;40;Sonnig;4;3;0;Stadt Konstanz, Amt für Stadtplanung und Umwelt
26.03.2022 08:00;204;103;101;Sonnig;7;5;0;Stadt Konstanz, Amt für Stadtplanung und Umwelt
26.03.2022 09:00;384;221;163;Sonnig;9;8;0;Stadt Konstanz, Amt für Stadtplanung und Umwelt
26.03.2022 10:00;485;266;219;Sonnig;11;10;0;Stadt Konstanz, Amt für Stadtplanung und Umwelt
26.03.2022 11:00;520;321;199;Sonnig;13;12;0;Stadt Konstanz, Amt für Stadtplanung und Umwelt
26.03.2022 12:00;623;341;282;Sonnig;14;14;0;Stadt Konstanz, Amt für Stadtplanung und Umwelt
26.03.2022 13:00;717;346;371;Sonnig;15;15;0;Stadt Konstanz, Amt für Stadtplanung und Umwelt
26.03.2022 14:00;687;350;337;Sonnig;16;16;0;Stadt Konstanz, Amt für Stadtplanung und Umwelt
26.03.2022 15:00;674;335;339;Sonnig;17;17;0;Stadt Konstanz, Amt für Stadtplanung und Umwelt
26.03.2022 16:00;664;313;351;Sonnig;16;15;0;Stadt Konstanz, Amt für Stadtplanung und Umwelt
26.03.2022 17:00;700;338;362;Sonnig;14;13;0;Stadt Konstanz, Amt für Stadtplanung und Umwelt
26.03.2022 18:00;547;252;295;Sonnig;13;11;0;Stadt Konstanz, Amt für Stadtplanung und Umwelt
26.03.2022 19:00;391;213;178;Sonnig;11;9;0;Stadt Konstanz, Amt für Stadtplanung und Umwelt
26.03.2022 20:00;353;170;183;Sonnig;9;7;0;Stadt Konstanz, Amt für Stadtplanung und Umwelt
26.03.2022 21:00;275;140;135;Sonnig;8;5;0;Stadt Konstanz, Amt für Stadtplanung und Umwelt
26.03.2022 22:00;188;78;110;Sonnig;7;5;0;Stadt Konstanz, Amt für Stadtplanung und Umwelt
26.03.2022 23:00;134;51;83;Sonnig;6;5;0;Stadt Konstanz, Amt für Stadtplanung und Umwelt
27.03.2022 00:00;121;37;84;Sonnig;6;4;0;Stadt Konstanz, Amt für Stadtplanung und Umwelt
27.03.2022 01:00;93;41;52;Sonnig;5;4;0;Stadt Konstanz, Amt für Stadtplanung und Umwelt
27.03.2022 03:00;;;;weather_condition_null;;;;Stadt Konstanz, Amt für Stadtplanung und Umwelt
27.03.2022 03:00;78;26;52;Sonnig;3;3;0;Stadt Konstanz, Amt für Stadtplanung und Umwelt
27.03.2022 04:00;44;27;17;Sonnig;3;2;0;Stadt Konstanz, Amt für Stadtplanung und Umwelt
27.03.2022 05:00;35;14;21;Sonnig;2;2;0;Stadt Konstanz, Amt für Stadtplanung und Umwelt
27.03.2022 06:00;21;15;6;Sonnig;2;2;0;Stadt Konstanz, Amt für Stadtplanung und Umwelt
27.03.2022 07:00;38;13;25;Sonnig;4;4;0;Stadt Konstanz, Amt für Stadtplanung und Umwelt
27.03.2022 08:00;70;31;39;Sonnig;7;7;0;Stadt Konstanz, Amt für Stadtplanung und Umwelt
27.03.2022 09:00;176;94;82;Sonnig;9;9;0;Stadt Konstanz, Amt für Stadtplanung und Umwelt
27.03.2022 10:00;252;138;114;Sonnig;12;12;0;Stadt Konstanz, Amt für Stadtplanung und Umwelt
27.03.2022 11:00;403;207;196;Sonnig;14;14;0;Stadt Konstanz, Amt für Stadtplanung und Umwelt
27.03.2022 12:00;444;215;229;Sonnig;16;16;0;Stadt Konstanz, Amt für Stadtplanung und Umwelt
27.03.2022 13:00;528;225;303;Sonnig;17;17;0;Stadt Konstanz, Amt für Stadtplanung und Umwelt
27.03.2022 14:00;590;292;298;Sonnig;17;17;0;Stadt Konstanz, Amt für Stadtplanung und Umwelt
27.03.2022 15:00;625;314;311;Sonnig;18;18;0;Stadt Konstanz, Amt für Stadtplanung und Umwelt
27.03.2022 16:00;640;336;304;Sonnig;16;17;0;Stadt Konstanz, Amt für Stadtplanung und Umwelt
27.03.2022 17:00;564;278;286;Sonnig;15;15;0;Stadt Konstanz, Amt für Stadtplanung und Umwelt
27.03.2022 18:00;556;307;249;Sonnig;13;14;0;Stadt Konstanz, Amt für Stadtplanung und Umwelt
27.03.2022 19:00;447;220;227;Sonnig;11;11;0;Stadt Konstanz, Amt für Stadtplanung und Umwelt
27.03.2022 20:00;277;125;152;Sonnig;9;9;0;Stadt Konstanz, Amt für Stadtplanung und Umwelt
27.03.2022 21:00;144;74;70;Sonnig;7;7;0;Stadt Konstanz, Amt für Stadtplanung und Umwelt
27.03.2022 22:00;104;47;57;Sonnig;6;7;0;Stadt Konstanz, Amt für Stadtplanung und Umwelt
27.03.2022 23:00;63;21;42;Sonnig;6;6;0;Stadt Konstanz, Amt für Stadtplanung und Umwelt
28.03.2022 00:00;26;14;12;Sonnig;5;5;0;Stadt Konstanz, Amt für Stadtplanung und Umwelt
28.03.2022 01:00;15;7;8;Sonnig;5;5;0;Stadt Konstanz, Amt für Stadtplanung und Umwelt
28.03.2022 02:00;3;2;1;Sonnig;4;4;0;Stadt Konstanz, Amt für Stadtplanung und Umwelt
28.03.2022 03:00;4;1;3;Sonnig;4;4;0;Stadt Konstanz, Amt für Stadtplanung und Umwelt
28.03.2022 04:00;8;6;2;Sonnig;4;4;0;Stadt Konstanz, Amt für Stadtplanung und Umwelt
28.03.2022 05:00;49;28;21;Sonnig;3;3;0;Stadt Konstanz, Amt für Stadtplanung und Umwelt
28.03.2022 06:00;168;103;65;Sonnig;3;3;0;Stadt Konstanz, Amt für Stadtplanung und Umwelt
28.03.2022 07:00;975;624;351;Sonnig;5;5;0;Stadt Konstanz, Amt für Stadtplanung und Umwelt
28.03.2022 08:00;709;396;313;Sonnig;8;8;0;Stadt Konstanz, Amt für Stadtplanung und Umwelt
28.03.2022 09:00;654;421;233;Sonnig;11;11;0;Stadt Konstanz, Amt für Stadtplanung und Umwelt
28.03.2022 10:00;437;231;206;Sonnig;13;13;0;Stadt Konstanz, Amt für Stadtplanung und Umwelt
28.03.2022 11:00;621;301;320;Sonnig;15;15;0;Stadt Konstanz, Amt für Stadtplanung und Umwelt
28.03.2022 12:00;675;297;378;Sonnig;17;17;0;Stadt Konstanz, Amt für Stadtplanung und Umwelt
28.03.2022 13:00;993;457;536;Sonnig;17;17;0;Stadt Konstanz, Amt für Stadtplanung und Umwelt
28.03.2022 14:00;673;330;343;Sonnig;17;17;0;Stadt Konstanz, Amt für Stadtplanung und Umwelt
28.03.2022 15:00;995;462;533;Sonnig;18;18;0;Stadt Konstanz, Amt für Stadtplanung und Umwelt
28.03.2022 16:00;899;415;484;Sonnig;17;17;0;Stadt Konstanz, Amt für Stadtplanung und Umwelt
28.03.2022 17:00;1089;482;607;Sonnig;16;16;0;Stadt Konstanz, Amt für Stadtplanung und Umwelt
28.03.2022 18:00;900;422;478;Sonnig;15;15;0;Stadt Konstanz, Amt für Stadtplanung und Umwelt
28.03.2022 19:00;615;257;358;Sonnig;13;13;0;Stadt Konstanz, Amt für Stadtplanung und Umwelt
28.03.2022 20:00;429;202;227;Sonnig;10;10;0;Stadt Konstanz, Amt für Stadtplanung und Umwelt
28.03.2022 21:00;284;117;167;Sonnig;7;7;0;Stadt Konstanz, Amt für Stadtplanung und Umwelt
28.03.2022 22:00;183;80;103;Sonnig;7;7;0;Stadt Konstanz, Amt für Stadtplanung und Umwelt
28.03.2022 23:00;64;24;40;Sonnig;6;6;0;Stadt Konstanz, Amt für Stadtplanung und Umwelt
29.03.2022 00:00;24;11;13;Sonnig;6;6;0;Stadt Konstanz, Amt für Stadtplanung und Umwelt
29.03.2022 01:00;23;12;11;Sonnig;6;5;0;Stadt Konstanz, Amt für Stadtplanung und Umwelt
29.03.2022 02:00;27;19;8;Sonnig;5;5;0;Stadt Konstanz, Amt für Stadtplanung und Umwelt
29.03.2022 03:00;14;10;4;Sonnig;5;5;0;Stadt Konstanz, Amt für Stadtplanung und Umwelt
29.03.2022 04:00;11;7;4;Sonnig;5;5;0;Stadt Konstanz, Amt für Stadtplanung und Umwelt
29.03.2022 05:00;51;35;16;Sonnig;5;5;0;Stadt Konstanz, Amt für Stadtplanung und Umwelt
29.03.2022 06:00;169;105;64;Sonnig;5;5;0;Stadt Konstanz, Amt für Stadtplanung und Umwelt
29.03.2022 07:00;997;663;334;Sonnig;7;7;0;Stadt Konstanz, Amt für Stadtplanung und Umwelt
29.03.2022 08:00;757;411;346;Leicht bewoelkt;9;9;0;Stadt Konstanz, Amt für Stadtplanung und Umwelt
29.03.2022 09:00;693;428;265;Leicht bewoelkt;11;11;0;Stadt Konstanz, Amt für Stadtplanung und Umwelt
29.03.2022 10:00;479;270;209;Leicht bewoelkt;12;12;0;Stadt Konstanz, Amt für Stadtplanung und Umwelt
29.03.2022 11:00;650;324;326;Leicht bewoelkt;14;14;0;Stadt Konstanz, Amt für Stadtplanung und Umwelt
29.03.2022 12:00;703;322;381;Leicht bewoelkt;16;16;0;Stadt Konstanz, Amt für Stadtplanung und Umwelt
29.03.2022 13:00;943;422;521;Leicht bewoelkt;16;16;0;Stadt Konstanz, Amt für Stadtplanung und Umwelt
29.03.2022 14:00;662;306;356;Bedeckt;16;16;0;Stadt Konstanz, Amt für Stadtplanung und Umwelt
29.03.2022 15:00;938;437;501;Bedeckt;17;17;0;Stadt Konstanz, Amt für Stadtplanung und Umwelt
29.03.2022 16:00;845;368;477;Bedeckt;15;15;0;Stadt Konstanz, Amt für Stadtplanung und Umwelt
29.03.2022 17:00;1086;508;578;Leicht bewoelkt;14;14;0;Stadt Konstanz, Amt für Stadtplanung und Umwelt
29.03.2022 18:00;842;327;515;Leicht bewoelkt;13;13;0;Stadt Konstanz, Amt für Stadtplanung und Umwelt
29.03.2022 19:00;582;265;317;Leicht bewoelkt;12;12;0;Stadt Konstanz, Amt für Stadtplanung und Umwelt
29.03.2022 20:00;356;155;201;Leicht bewoelkt;11;11;0;Stadt Konstanz, Amt für Stadtplanung und Umwelt
29.03.2022 21:00;231;117;114;Leicht bewoelkt;10;9;0;Stadt Konstanz, Amt für Stadtplanung und Umwelt
29.03.2022 22:00;183;90;93;Leicht bewoelkt;9;9;0;Stadt Konstanz, Amt für Stadtplanung und Umwelt
29.03.2022 23:00;114;34;80;Leicht bewoelkt;9;9;0;Stadt Konstanz, Amt für Stadtplanung und Umwelt
30.03.2022 00:00;42;11;31;Leicht bewoelkt;8;8;0;Stadt Konstanz, Amt für Stadtplanung und Umwelt
30.03.2022 01:00;40;13;27;Leicht bewoelkt;8;8;0;Stadt Konstanz, Amt für Stadtplanung und Umwelt
30.03.2022 02:00;6;4;2;Bedeckt;8;8;0;Stadt Konstanz, Amt für Stadtplanung und Umwelt
30.03.2022 03:00;9;3;6;Bedeckt;8;8;0;Stadt Konstanz, Amt für Stadtplanung und Umwelt
30.03.2022 04:00;8;4;4;Bedeckt;8;8;0;Stadt Konstanz, Amt für Stadtplanung und Umwelt
30.03.2022 05:00;51;34;17;Bewoelkt;8;8;0;Stadt Konstanz, Amt für Stadtplanung und Umwelt
30.03.2022 06:00;156;98;58;Bewoelkt;8;8;0;Stadt Konstanz, Amt für Stadtplanung und Umwelt
30.03.2022 07:00;1016;680;336;Bewoelkt;9;9;0;Stadt Konstanz, Amt für Stadtplanung und Umwelt
30.03.2022 08:00;674;402;272;Bedeckt;10;9;0;Stadt Konstanz, Amt für Stadtplanung und Umwelt
30.03.2022 09:00;612;394;218;Bedeckt;11;10;0;Stadt Konstanz, Amt für Stadtplanung und Umwelt
30.03.2022 10:00;342;194;148;Bedeckt;11;10;0;Stadt Konstanz, Amt für Stadtplanung und Umwelt
30.03.2022 11:00;538;217;321;Bewoelkt;12;11;0;Stadt Konstanz, Amt für Stadtplanung und Umwelt
30.03.2022 12:00;562;230;332;Bewoelkt;12;11;0;Stadt Konstanz, Amt für Stadtplanung und Umwelt
30.03.2022 13:00;811;421;390;Bewoelkt;12;11;0;Stadt Konstanz, Amt für Stadtplanung und Umwelt
30.03.2022 14:00;480;229;251;Bewoelkt;12;11;0;Stadt Konstanz, Amt für Stadtplanung und Umwelt
30.03.2022 15:00;772;318;454;Bewoelkt;12;11;0;Stadt Konstanz, Amt für Stadtplanung und Umwelt
30.03.2022 16:00;750;359;391;Bewoelkt;11;10;0;Stadt Konstanz, Amt für Stadtplanung und Umwelt
30.03.2022 17:00;914;388;526;Stellenweiser Regenfall;10;10;0;Stadt Konstanz, Amt für Stadtplanung und Umwelt
30.03.2022 18:00;575;236;339;Stellenweiser Regenfall;10;9;0;Stadt Konstanz, Amt für Stadtplanung und Umwelt
30.03.2022 19:00;395;170;225;Stellenweiser Regenfall;9;9;0;Stadt Konstanz, Amt für Stadtplanung und Umwelt
30.03.2022 20:00;291;137;154;Nieselregen;9;9;0.1;Stadt Konstanz, Amt für Stadtplanung und Umwelt
30.03.2022 21:00;159;76;83;Nieselregen;8;8;0.2;Stadt Konstanz, Amt für Stadtplanung und Umwelt
30.03.2022 22:00;160;75;85;Nieselregen;8;8;0.1;Stadt Konstanz, Amt für Stadtplanung und Umwelt
30.03.2022 23:00;73;34;39;Bedeckt;8;8;0;Stadt Konstanz, Amt für Stadtplanung und Umwelt
31.03.2022 00:00;39;14;25;Bedeckt;7;7;0;Stadt Konstanz, Amt für Stadtplanung und Umwelt
31.03.2022 01:00;20;7;13;Bedeckt;7;7;0;Stadt Konstanz, Amt für Stadtplanung und Umwelt
31.03.2022 02:00;12;5;7;Bedeckt;7;7;0;Stadt Konstanz, Amt für Stadtplanung und Umwelt
31.03.2022 03:00;6;4;2;Bedeckt;7;7;0;Stadt Konstanz, Amt für Stadtplanung und Umwelt
31.03.2022 04:00;11;8;3;Bedeckt;7;7;0;Stadt Konstanz, Amt für Stadtplanung und Umwelt
31.03.2022 05:00;47;29;18;Leichter Nebel;6;6;0;Stadt Konstanz, Amt für Stadtplanung und Umwelt
31.03.2022 06:00;153;98;55;Leichter Nebel;6;6;0;Stadt Konstanz, Amt für Stadtplanung und Umwelt
31.03.2022 07:00;885;597;288;Leichter Nebel;7;7;0;Stadt Konstanz, Amt für Stadtplanung und Umwelt
31.03.2022 08:00;630;354;276;Bewoelkt;8;8;0;Stadt Konstanz, Amt für Stadtplanung und Umwelt
31.03.2022 09:00;577;347;230;Bewoelkt;8;9;0;Stadt Konstanz, Amt für Stadtplanung und Umwelt
31.03.2022 10:00;370;210;160;Bewoelkt;9;9;0;Stadt Konstanz, Amt für Stadtplanung und Umwelt
31.03.2022 11:00;565;303;262;Stellenweiser Regenfall;10;10;0;Stadt Konstanz, Amt für Stadtplanung und Umwelt
31.03.2022 12:00;627;272;355;Stellenweiser Regenfall;11;11;0;Stadt Konstanz, Amt für Stadtplanung und Umwelt
31.03.2022 13:00;879;376;503;Stellenweiser Regenfall;11;10;0;Stadt Konstanz, Amt für Stadtplanung und Umwelt
31.03.2022 14:00;600;285;315;Leichter Regenschauer;10;9;0.2;Stadt Konstanz, Amt für Stadtplanung und Umwelt
31.03.2022 15:00;832;362;470;Leichter Regenschauer;10;9;0.2;Stadt Konstanz, Amt für Stadtplanung und Umwelt
31.03.2022 16:00;705;332;373;Leichter Regenschauer;9;7;0.1;Stadt Konstanz, Amt für Stadtplanung und Umwelt
31.03.2022 17:00;849;326;523;Leichter Regenschauer;8;6;0.4;Stadt Konstanz, Amt für Stadtplanung und Umwelt
31.03.2022 18:00;585;254;331;Leichter Regenschauer;7;4;0.6;Stadt Konstanz, Amt für Stadtplanung und Umwelt
31.03.2022 19:00;404;191;213;Leichter Regenschauer;5;3;0.3;Stadt Konstanz, Amt für Stadtplanung und Umwelt
31.03.2022 20:00;327;174;153;Maessiger bis starker Eisregen;4;2;01. Apr;Stadt Konstanz, Amt für Stadtplanung und Umwelt
31.03.2022 21:00;193;70;123;Maessiger bis starker Eisregen;3;2;01. Aug;Stadt Konstanz, Amt für Stadtplanung und Umwelt
31.03.2022 22:00;160;71;89;Maessiger bis starker Eisregen;4;3;0.9;Stadt Konstanz, Amt für Stadtplanung und Umwelt
31.03.2022 23:00;94;35;59;Maessiger Regenfall;4;4;0.9;Stadt Konstanz, Amt für Stadtplanung und Umwelt
01.04.2022 00:00;34;13;21;Maessiger Regenfall;5;5;01. Sep;Stadt Konstanz, Amt für Stadtplanung und Umwelt
01.04.2022 01:00;36;14;22;Maessiger Regenfall;5;4;0.9;Stadt Konstanz, Amt für Stadtplanung und Umwelt
01.04.2022 02:00;14;4;10;Leichter Regenfall;4;4;0.4;Stadt Konstanz, Amt für Stadtplanung und Umwelt
01.04.2022 03:00;8;4;4;Leichter Regenfall;4;3;0.6;Stadt Konstanz, Amt für Stadtplanung und Umwelt
01.04.2022 04:00;7;5;2;Leichter Regenfall;4;3;0.3;Stadt Konstanz, Amt für Stadtplanung und Umwelt
01.04.2022 05:00;38;27;11;Leichter Eisregen;4;3;0.4;Stadt Konstanz, Amt für Stadtplanung und Umwelt
01.04.2022 06:00;108;63;45;Leichter Eisregen;3;2;0.5;Stadt Konstanz, Amt für Stadtplanung und Umwelt
01.04.2022 07:00;715;460;255;Leichter Eisregen;3;0;0.3;Stadt Konstanz, Amt für Stadtplanung und Umwelt
01.04.2022 08:00;469;273;196;Starker Schneefall;2;-2;0.4;Stadt Konstanz, Amt für Stadtplanung und Umwelt
01.04.2022 09:00;417;262;155;Starker Schneefall;1;-4;0.6;Stadt Konstanz, Amt für Stadtplanung und Umwelt
01.04.2022 10:00;268;133;135;Starker Schneefall;1;-3;0.3;Stadt Konstanz, Amt für Stadtplanung und Umwelt
01.04.2022 11:00;375;185;190;Starker Schneefall;2;-3;0.5;Stadt Konstanz, Amt für Stadtplanung und Umwelt
01.04.2022 12:00;451;199;252;Starker Schneefall;2;-3;0.7;Stadt Konstanz, Amt für Stadtplanung und Umwelt
01.04.2022 13:00;682;257;425;Starker Schneefall;2;-2;0.4;Stadt Konstanz, Amt für Stadtplanung und Umwelt
01.04.2022 14:00;420;218;202;Bedeckt;2;-2;0;Stadt Konstanz, Amt für Stadtplanung und Umwelt
01.04.2022 15:00;435;207;228;Bedeckt;2;-2;0;Stadt Konstanz, Amt für Stadtplanung und Umwelt
01.04.2022 16:00;373;152;221;Bedeckt;2;-2;0;Stadt Konstanz, Amt für Stadtplanung und Umwelt
01.04.2022 17:00;407;195;212;Maessige bis starke Schneefaelle;1;-2;0.1;Stadt Konstanz, Amt für Stadtplanung und Umwelt
01.04.2022 18:00;349;151;198;Maessige bis starke Schneefaelle;1;-2;0.1;Stadt Konstanz, Amt für Stadtplanung und Umwelt
01.04.2022 19:00;304;141;163;Maessige bis starke Schneefaelle;1;-2;0.1;Stadt Konstanz, Amt für Stadtplanung und Umwelt
01.04.2022 20:00;225;109;116;Leichter Nebel;0;-1;0;Stadt Konstanz, Amt für Stadtplanung und Umwelt
01.04.2022 21:00;156;87;69;Leichter Nebel;0;-1;0;Stadt Konstanz, Amt für Stadtplanung und Umwelt
01.04.2022 22:00;124;54;70;Leichter Nebel;-1;-2;0;Stadt Konstanz, Amt für Stadtplanung und Umwelt
01.04.2022 23:00;114;51;63;Maessige bis starke Schneefaelle;-2;-2;0.1;Stadt Konstanz, Amt für Stadtplanung und Umwelt
02.04.2022 00:00;96;31;65;Maessige bis starke Schneefaelle;-2;-2;0.1;Stadt Konstanz, Amt für Stadtplanung und Umwelt
02.04.2022 01:00;68;24;44;Maessige bis starke Schneefaelle;-3;-3;0.1;Stadt Konstanz, Amt für Stadtplanung und Umwelt
02.04.2022 02:00;46;21;25;Leichter Nebel;-3;-4;0;Stadt Konstanz, Amt für Stadtplanung und Umwelt
02.04.2022 03:00;39;23;16;Leichter Nebel;-3;-4;0;Stadt Konstanz, Amt für Stadtplanung und Umwelt
02.04.2022 04:00;18;13;5;Leichter Nebel;-3;-4;0;Stadt Konstanz, Amt für Stadtplanung und Umwelt
02.04.2022 05:00;23;12;11;Leichter Schneefall;-2;-3;0;Stadt Konstanz, Amt für Stadtplanung und Umwelt
02.04.2022 06:00;39;25;14;Leichter Schneefall;-2;-2;0;Stadt Konstanz, Amt für Stadtplanung und Umwelt
02.04.2022 07:00;41;13;28;Leichter Schneefall;-1;-2;0;Stadt Konstanz, Amt für Stadtplanung und Umwelt
02.04.2022 08:00;116;71;45;Bedeckt;0;-1;0;Stadt Konstanz, Amt für Stadtplanung und Umwelt
02.04.2022 09:00;151;90;61;Bedeckt;1;-1;0;Stadt Konstanz, Amt für Stadtplanung und Umwelt
02.04.2022 10:00;205;125;80;Bedeckt;2;0;0;Stadt Konstanz, Amt für Stadtplanung und Umwelt
02.04.2022 11:00;183;82;101;Maessige bis starke Schneefaelle;2;1;0.1;Stadt Konstanz, Amt für Stadtplanung und Umwelt
02.04.2022 12:00;233;140;93;Maessige bis starke Schneefaelle;3;2;0.1;Stadt Konstanz, Amt für Stadtplanung und Umwelt
02.04.2022 13:00;289;123;166;Maessige bis starke Schneefaelle;3;1;0;Stadt Konstanz, Amt für Stadtplanung und Umwelt
02.04.2022 14:00;240;112;128;Maessige bis starke Schneefaelle;3;1;0.1;Stadt Konstanz, Amt für Stadtplanung und Umwelt
02.04.2022 15:00;233;103;130;Maessige bis starke Schneefaelle;3;0;0.1;Stadt Konstanz, Amt für Stadtplanung und Umwelt
02.04.2022 16:00;205;86;119;Maessige bis starke Schneefaelle;3;-1;0;Stadt Konstanz, Amt für Stadtplanung und Umwelt
02.04.2022 17:00;222;110;112;Maessige bis starke Schneefaelle;2;-1;0.2;Stadt Konstanz, Amt für Stadtplanung und Umwelt
02.04.2022 18:00;221;98;123;Maessige bis starke Schneefaelle;2;-2;0.2;Stadt Konstanz, Amt für Stadtplanung und Umwelt
02.04.2022 19:00;161;74;87;Maessige bis starke Schneefaelle;1;-2;0.1;Stadt Konstanz, Amt für Stadtplanung und Umwelt
02.04.2022 20:00;139;63;76;Leichter Schneefall;1;-3;0;Stadt Konstanz, Amt für Stadtplanung und Umwelt
02.04.2022 21:00;110;56;54;Leichter Schneefall;0;-3;0;Stadt Konstanz, Amt für Stadtplanung und Umwelt
02.04.2022 22:00;86;47;39;Leichter Schneefall;-1;-5;0;Stadt Konstanz, Amt für Stadtplanung und Umwelt
02.04.2022 23:00;93;41;52;Maessiger Schneefall;-2;-6;0;Stadt Konstanz, Amt für Stadtplanung und Umwelt
03.04.2022 00:00;59;18;41;Maessiger Schneefall;-3;-8;0.1;Stadt Konstanz, Amt für Stadtplanung und Umwelt
03.04.2022 01:00;59;18;41;Maessiger Schneefall;-3;-8;0;Stadt Konstanz, Amt für Stadtplanung und Umwelt
03.04.2022 02:00;41;14;27;Leichter Schneefall;-4;-8;0;Stadt Konstanz, Amt für Stadtplanung und Umwelt
03.04.2022 03:00;30;14;16;Leichter Schneefall;-4;-9;0;Stadt Konstanz, Amt für Stadtplanung und Umwelt
03.04.2022 04:00;28;20;8;Leichter Schneefall;-4;-9;0;Stadt Konstanz, Amt für Stadtplanung und Umwelt
03.04.2022 05:00;20;9;11;Leichter Schneefall;-5;-9;0;Stadt Konstanz, Amt für Stadtplanung und Umwelt
03.04.2022 06:00;32;25;7;Leichter Schneefall;-5;-10;0;Stadt Konstanz, Amt für Stadtplanung und Umwelt
03.04.2022 07:00;27;14;13;Leichter Schneefall;-3;-8;0;Stadt Konstanz, Amt für Stadtplanung und Umwelt
03.04.2022 08:00;33;14;19;Bewoelkt;-2;-6;0;Stadt Konstanz, Amt für Stadtplanung und Umwelt
03.04.2022 09:00;86;33;53;Bewoelkt;0;-4;0;Stadt Konstanz, Amt für Stadtplanung und Umwelt
03.04.2022 10:00;128;76;52;Bewoelkt;0;-3;0;Stadt Konstanz, Amt für Stadtplanung und Umwelt
03.04.2022 11:00;146;73;73;Leichte Schneeschauer;1;-2;0;Stadt Konstanz, Amt für Stadtplanung und Umwelt
03.04.2022 12:00;181;79;102;Leichte Schneeschauer;2;-2;0;Stadt Konstanz, Amt für Stadtplanung und Umwelt
03.04.2022 13:00;177;86;91;Leichte Schneeschauer;2;-2;0;Stadt Konstanz, Amt für Stadtplanung und Umwelt
03.04.2022 14:00;214;116;98;Leichte Schneeschauer;2;-2;0;Stadt Konstanz, Amt für Stadtplanung und Umwelt
03.04.2022 15:00;217;123;94;Leichte Schneeschauer;3;-2;0;Stadt Konstanz, Amt für Stadtplanung und Umwelt
03.04.2022 16:00;212;94;118;Leichte Schneeschauer;2;-2;0;Stadt Konstanz, Amt für Stadtplanung und Umwelt
03.04.2022 17:00;276;115;161;Leichte Schneeschauer;2;-2;0;Stadt Konstanz, Amt für Stadtplanung und Umwelt
03.04.2022 18:00;184;89;95;Leichte Schneeschauer;1;-2;0;Stadt Konstanz, Amt für Stadtplanung und Umwelt
03.04.2022 19:00;184;93;91;Leichte Schneeschauer;0;-4;0;Stadt Konstanz, Amt für Stadtplanung und Umwelt
03.04.2022 20:00;132;71;61;Leichter Nebel;-2;-6;0;Stadt Konstanz, Amt für Stadtplanung und Umwelt
03.04.2022 21:00;92;45;47;Leichter Nebel;-4;-7;0;Stadt Konstanz, Amt für Stadtplanung und Umwelt
03.04.2022 22:00;63;28;35;Leichter Nebel;-6;-8;0;Stadt Konstanz, Amt für Stadtplanung und Umwelt
03.04.2022 23:00;32;17;15;Leichter Nebel;-7;-8;0;Stadt Konstanz, Amt für Stadtplanung und Umwelt
04.04.2022 00:00;29;11;18;Leichter Nebel;-9;-9;0;Stadt Konstanz, Amt für Stadtplanung und Umwelt
04.04.2022 01:00;16;9;7;Leichter Nebel;-9;-9;0;Stadt Konstanz, Amt für Stadtplanung und Umwelt
04.04.2022 02:00;7;4;3;Leichter Nebel;-10;-10;0;Stadt Konstanz, Amt für Stadtplanung und Umwelt
04.04.2022 03:00;3;0;3;Leichter Nebel;-10;-10;0;Stadt Konstanz, Amt für Stadtplanung und Umwelt
04.04.2022 04:00;4;2;2;Leichter Nebel;-11;-11;0;Stadt Konstanz, Amt für Stadtplanung und Umwelt
04.04.2022 05:00;46;30;16;Eisnebel;-11;-11;0;Stadt Konstanz, Amt für Stadtplanung und Umwelt
04.04.2022 06:00;134;79;55;Eisnebel;-11;-11;0;Stadt Konstanz, Amt für Stadtplanung und Umwelt
04.04.2022 07:00;873;549;324;Eisnebel;-8;-8;0;Stadt Konstanz, Amt für Stadtplanung und Umwelt
04.04.2022 08:00;646;339;307;Leicht bewoelkt;-5;-6;0;Stadt Konstanz, Amt für Stadtplanung und Umwelt
04.04.2022 09:00;550;338;212;Leicht bewoelkt;-2;-3;0;Stadt Konstanz, Amt für Stadtplanung und Umwelt
04.04.2022 10:00;347;177;170;Leicht bewoelkt;0;-2;0;Stadt Konstanz, Amt für Stadtplanung und Umwelt
04.04.2022 11:00;520;276;244;Sonnig;2;-1;0;Stadt Konstanz, Amt für Stadtplanung und Umwelt
04.04.2022 12:00;542;270;272;Sonnig;3;0;0;Stadt Konstanz, Amt für Stadtplanung und Umwelt
04.04.2022 13:00;800;358;442;Sonnig;4;1;0;Stadt Konstanz, Amt für Stadtplanung und Umwelt
04.04.2022 14:00;537;248;289;Leicht bewoelkt;5;2;0;Stadt Konstanz, Amt für Stadtplanung und Umwelt
04.04.2022 15:00;833;402;431;Leicht bewoelkt;6;2;0;Stadt Konstanz, Amt für Stadtplanung und Umwelt
04.04.2022 16:00;759;362;397;Leicht bewoelkt;5;2;0;Stadt Konstanz, Amt für Stadtplanung und Umwelt
04.04.2022 17:00;964;450;514;Bedeckt;5;1;0;Stadt Konstanz, Amt für Stadtplanung und Umwelt
04.04.2022 18:00;732;338;394;Bedeckt;4;1;0;Stadt Konstanz, Amt für Stadtplanung und Umwelt
04.04.2022 19:00;546;252;294;Bedeckt;3;0;0;Stadt Konstanz, Amt für Stadtplanung und Umwelt
04.04.2022 20:00;371;133;238;Leicht bewoelkt;3;-1;0;Stadt Konstanz, Amt für Stadtplanung und Umwelt
04.04.2022 21:00;216;105;111;Leicht bewoelkt;2;-1;0;Stadt Konstanz, Amt für Stadtplanung und Umwelt
04.04.2022 22:00;131;65;66;Leicht bewoelkt;2;-1;0;Stadt Konstanz, Amt für Stadtplanung und Umwelt
04.04.2022 23:00;62;26;36;Leicht bewoelkt;3;0;0;Stadt Konstanz, Amt für Stadtplanung und Umwelt
05.04.2022 00:00;41;19;22;Leicht bewoelkt;3;0;0;Stadt Konstanz, Amt für Stadtplanung und Umwelt
05.04.2022 01:00;22;17;5;Leicht bewoelkt;3;0;0;Stadt Konstanz, Amt für Stadtplanung und Umwelt
05.04.2022 02:00;17;8;9;Leicht bewoelkt;3;0;0;Stadt Konstanz, Amt für Stadtplanung und Umwelt
05.04.2022 03:00;10;9;1;Leicht bewoelkt;3;0;0;Stadt Konstanz, Amt für Stadtplanung und Umwelt
05.04.2022 04:00;7;6;1;Leicht bewoelkt;3;-1;0;Stadt Konstanz, Amt für Stadtplanung und Umwelt
05.04.2022 05:00;45;32;13;Leichter Eisregen;3;-1;0.1;Stadt Konstanz, Amt für Stadtplanung und Umwelt
05.04.2022 06:00;128;74;54;Leichter Eisregen;2;-1;0.1;Stadt Konstanz, Amt für Stadtplanung und Umwelt
05.04.2022 07:00;840;514;326;Leichter Eisregen;3;-1;0;Stadt Konstanz, Amt für Stadtplanung und Umwelt
05.04.2022 08:00;698;392;306;Nieselregen;3;-1;0.1;Stadt Konstanz, Amt für Stadtplanung und Umwelt
05.04.2022 09:00;537;348;189;Nieselregen;3;0;0.1;Stadt Konstanz, Amt für Stadtplanung und Umwelt
05.04.2022 10:00;368;205;163;Nieselregen;3;0;0.1;Stadt Konstanz, Amt für Stadtplanung und Umwelt
05.04.2022 11:00;520;291;229;Nieselregen;4;1;0.1;Stadt Konstanz, Amt für Stadtplanung und Umwelt
05.04.2022 12:00;584;259;325;Nieselregen;4;1;0.1;Stadt Konstanz, Amt für Stadtplanung und Umwelt
05.04.2022 13:00;720;338;382;Nieselregen;4;2;0.1;Stadt Konstanz, Amt für Stadtplanung und Umwelt
05.04.2022 14:00;515;273;242;Bedeckt;5;2;0;Stadt Konstanz, Amt für Stadtplanung und Umwelt
05.04.2022 15:00;846;397;449;Bedeckt;5;3;0;Stadt Konstanz, Amt für Stadtplanung und Umwelt
05.04.2022 16:00;742;357;385;Bedeckt;5;3;0;Stadt Konstanz, Amt für Stadtplanung und Umwelt
05.04.2022 17:00;854;353;501;Nieselregen;5;3;0.1;Stadt Konstanz, Amt für Stadtplanung und Umwelt
05.04.2022 18:00;759;322;437;Nieselregen;5;4;0.1;Stadt Konstanz, Amt für Stadtplanung und Umwelt
05.04.2022 19:00;561;248;313;Nieselregen;5;4;0.1;Stadt Konstanz, Amt für Stadtplanung und Umwelt
05.04.2022 20:00;355;164;191;Nieselregen;5;4;0.1;Stadt Konstanz, Amt für Stadtplanung und Umwelt
05.04.2022 21:00;227;88;139;Nieselregen;5;4;0.1;Stadt Konstanz, Amt für Stadtplanung und Umwelt
05.04.2022 22:00;176;78;98;Nieselregen;5;4;0;Stadt Konstanz, Amt für Stadtplanung und Umwelt
05.04.2022 23:00;104;44;60;Nieselregen;5;4;0.1;Stadt Konstanz, Amt für Stadtplanung und Umwelt
06.04.2022 00:00;45;19;26;Nieselregen;5;4;0.1;Stadt Konstanz, Amt für Stadtplanung und Umwelt
06.04.2022 01:00;30;8;22;Nieselregen;5;4;0.1;Stadt Konstanz, Amt für Stadtplanung und Umwelt
06.04.2022 02:00;16;8;8;Leicht bewoelkt;5;3;0;Stadt Konstanz, Amt für Stadtplanung und Umwelt
06.04.2022 03:00;4;1;3;Leicht bewoelkt;4;3;0;Stadt Konstanz, Amt für Stadtplanung und Umwelt
06.04.2022 04:00;10;7;3;Leicht bewoelkt;4;3;0;Stadt Konstanz, Amt für Stadtplanung und Umwelt
06.04.2022 05:00;50;34;16;Bewoelkt;4;3;0;Stadt Konstanz, Amt für Stadtplanung und Umwelt
06.04.2022 06:00;175;98;77;Bewoelkt;4;3;0;Stadt Konstanz, Amt für Stadtplanung und Umwelt
06.04.2022 07:00;986;660;326;Bewoelkt;5;4;0;Stadt Konstanz, Amt für Stadtplanung und Umwelt
06.04.2022 08:00;776;457;319;Bewoelkt;6;6;0;Stadt Konstanz, Amt für Stadtplanung und Umwelt
06.04.2022 09:00;638;388;250;Bewoelkt;8;7;0;Stadt Konstanz, Amt für Stadtplanung und Umwelt
06.04.2022 10:00;409;225;184;Bewoelkt;9;8;0;Stadt Konstanz, Amt für Stadtplanung und Umwelt
06.04.2022 11:00;647;286;361;Leicht bewoelkt;10;9;0;Stadt Konstanz, Amt für Stadtplanung und Umwelt
06.04.2022 12:00;622;270;352;Leicht bewoelkt;12;10;0;Stadt Konstanz, Amt für Stadtplanung und Umwelt
06.04.2022 13:00;983;472;511;Leicht bewoelkt;12;11;0;Stadt Konstanz, Amt für Stadtplanung und Umwelt
06.04.2022 14:00;634;328;306;Stellenweiser Regenfall;13;11;0;Stadt Konstanz, Amt für Stadtplanung und Umwelt
06.04.2022 15:00;915;394;521;Stellenweiser Regenfall;13;12;0;Stadt Konstanz, Amt für Stadtplanung und Umwelt
06.04.2022 16:00;843;441;402;Stellenweiser Regenfall;12;11;0;Stadt Konstanz, Amt für Stadtplanung und Umwelt
06.04.2022 17:00;1047;464;583;Stellenweiser Regenfall;12;10;0.1;Stadt Konstanz, Amt für Stadtplanung und Umwelt
06.04.2022 18:00;804;381;423;Stellenweiser Regenfall;11;9;0.1;Stadt Konstanz, Amt für Stadtplanung und Umwelt
06.04.2022 19:00;582;277;305;Stellenweiser Regenfall;9;7;0;Stadt Konstanz, Amt für Stadtplanung und Umwelt
06.04.2022 20:00;441;178;263;Bedeckt;8;5;0;Stadt Konstanz, Amt für Stadtplanung und Umwelt
06.04.2022 21:00;306;116;190;Bedeckt;7;4;0;Stadt Konstanz, Amt für Stadtplanung und Umwelt
06.04.2022 22:00;218;111;107;Bedeckt;7;4;0;Stadt Konstanz, Amt für Stadtplanung und Umwelt
06.04.2022 23:00;158;49;109;Stellenweiser Regenfall;7;4;0;Stadt Konstanz, Amt für Stadtplanung und Umwelt
07.04.2022 00:00;72;21;51;Stellenweiser Regenfall;7;4;0.1;Stadt Konstanz, Amt für Stadtplanung und Umwelt
07.04.2022 01:00;69;12;57;Stellenweiser Regenfall;7;4;0;Stadt Konstanz, Amt für Stadtplanung und Umwelt
07.04.2022 02:00;12;4;8;Bedeckt;7;4;0;Stadt Konstanz, Amt für Stadtplanung und Umwelt
07.04.2022 03:00;7;2;5;Bedeckt;7;4;0;Stadt Konstanz, Amt für Stadtplanung und Umwelt
07.04.2022 04:00;6;4;2;Bedeckt;7;3;0;Stadt Konstanz, Amt für Stadtplanung und Umwelt
07.04.2022 05:00;40;27;13;Stellenweiser Regenfall;7;3;0;Stadt Konstanz, Amt für Stadtplanung und Umwelt
07.04.2022 06:00;137;71;66;Stellenweiser Regenfall;7;3;0;Stadt Konstanz, Amt für Stadtplanung und Umwelt
07.04.2022 07:00;879;575;304;Stellenweiser Regenfall;8;4;0;Stadt Konstanz, Amt für Stadtplanung und Umwelt
07.04.2022 08:00;733;390;343;Leicht bewoelkt;9;5;0;Stadt Konstanz, Amt für Stadtplanung und Umwelt
07.04.2022 09:00;666;426;240;Leicht bewoelkt;10;7;0;Stadt Konstanz, Amt für Stadtplanung und Umwelt
07.04.2022 10:00;340;185;155;Leicht bewoelkt;11;8;0;Stadt Konstanz, Amt für Stadtplanung und Umwelt
07.04.2022 11:00;525;250;275;Leicht bewoelkt;13;10;0;Stadt Konstanz, Amt für Stadtplanung und Umwelt
07.04.2022 12:00;548;223;325;Leicht bewoelkt;14;12;0;Stadt Konstanz, Amt für Stadtplanung und Umwelt
07.04.2022 13:00;768;330;438;Leicht bewoelkt;13;11;0;Stadt Konstanz, Amt für Stadtplanung und Umwelt
07.04.2022 14:00;464;222;242;Bedeckt;12;10;0;Stadt Konstanz, Amt für Stadtplanung und Umwelt
07.04.2022 15:00;691;323;368;Bedeckt;11;9;0;Stadt Konstanz, Amt für Stadtplanung und Umwelt
07.04.2022 16:00;689;314;375;Bedeckt;11;8;0;Stadt Konstanz, Amt für Stadtplanung und Umwelt
07.04.2022 17:00;758;320;438;Nieselregen;10;7;0.1;Stadt Konstanz, Amt für Stadtplanung und Umwelt
07.04.2022 18:00;614;253;361;Nieselregen;9;6;0.2;Stadt Konstanz, Amt für Stadtplanung und Umwelt
07.04.2022 19:00;386;171;215;Nieselregen;9;6;0.1;Stadt Konstanz, Amt für Stadtplanung und Umwelt
07.04.2022 20:00;297;155;142;Bedeckt;9;6;0;Stadt Konstanz, Amt für Stadtplanung und Umwelt
07.04.2022 21:00;150;84;66;Bedeckt;9;6;0;Stadt Konstanz, Amt für Stadtplanung und Umwelt
07.04.2022 22:00;139;53;86;Bedeckt;9;6;0;Stadt Konstanz, Amt für Stadtplanung und Umwelt
07.04.2022 23:00;96;44;52;Nieselregen;9;6;0.2;Stadt Konstanz, Amt für Stadtplanung und Umwelt
08.04.2022 00:00;48;20;28;Nieselregen;10;6;0.3;Stadt Konstanz, Amt für Stadtplanung und Umwelt
08.04.2022 01:00;44;23;21;Nieselregen;9;6;0.2;Stadt Konstanz, Amt für Stadtplanung und Umwelt
08.04.2022 02:00;17;3;14;Stellenweiser Regenfall;9;6;0;Stadt Konstanz, Amt für Stadtplanung und Umwelt
08.04.2022 03:00;4;1;3;Stellenweiser Regenfall;9;6;0;Stadt Konstanz, Amt für Stadtplanung und Umwelt
08.04.2022 04:00;5;3;2;Stellenweiser Regenfall;9;6;0;Stadt Konstanz, Amt für Stadtplanung und Umwelt
08.04.2022 05:00;33;21;12;Nieselregen;9;6;0.2;Stadt Konstanz, Amt für Stadtplanung und Umwelt
08.04.2022 06:00;120;65;55;Nieselregen;9;6;0.2;Stadt Konstanz, Amt für Stadtplanung und Umwelt
08.04.2022 07:00;711;420;291;Nieselregen;9;6;0.1;Stadt Konstanz, Amt für Stadtplanung und Umwelt
08.04.2022 08:00;515;269;246;Nieselregen;9;6;0.1;Stadt Konstanz, Amt für Stadtplanung und Umwelt
08.04.2022 09:00;487;320;167;Nieselregen;9;7;0.1;Stadt Konstanz, Amt für Stadtplanung und Umwelt
08.04.2022 10:00;317;184;133;Nieselregen;10;8;0.1;Stadt Konstanz, Amt für Stadtplanung und Umwelt
08.04.2022 11:00;454;231;223;Stellenweiser Nieselregen;12;9;0.1;Stadt Konstanz, Amt für Stadtplanung und Umwelt
08.04.2022 12:00;519;263;256;Stellenweiser Nieselregen;13;10;0.1;Stadt Konstanz, Amt für Stadtplanung und Umwelt
08.04.2022 13:00;719;267;452;Stellenweiser Nieselregen;13;10;0.1;Stadt Konstanz, Amt für Stadtplanung und Umwelt
08.04.2022 14:00;516;252;264;Bedeckt;12;9;0;Stadt Konstanz, Amt für Stadtplanung und Umwelt
08.04.2022 15:00;541;258;283;Bedeckt;12;9;0;Stadt Konstanz, Amt für Stadtplanung und Umwelt
08.04.2022 16:00;444;205;239;Bedeckt;12;9;0;Stadt Konstanz, Amt für Stadtplanung und Umwelt
08.04.2022 17:00;440;178;262;Stellenweiser Regenfall;12;9;0.1;Stadt Konstanz, Amt für Stadtplanung und Umwelt
08.04.2022 18:00;421;185;236;Stellenweiser Regenfall;13;10;0.1;Stadt Konstanz, Amt für Stadtplanung und Umwelt
08.04.2022 19:00;399;201;198;Stellenweiser Regenfall;12;9;0.1;Stadt Konstanz, Amt für Stadtplanung und Umwelt
08.04.2022 20:00;244;120;124;Sonnig;12;9;0;Stadt Konstanz, Amt für Stadtplanung und Umwelt
08.04.2022 21:00;163;96;67;Sonnig;11;9;0;Stadt Konstanz, Amt für Stadtplanung und Umwelt
08.04.2022 22:00;136;60;76;Sonnig;10;8;0;Stadt Konstanz, Amt für Stadtplanung und Umwelt
08.04.2022 23:00;146;42;104;Leicht bewoelkt;10;7;0;Stadt Konstanz, Amt für Stadtplanung und Umwelt
09.04.2022 00:00;78;32;46;Leicht bewoelkt;9;6;0;Stadt Konstanz, Amt für Stadtplanung und Umwelt
09.04.2022 01:00;72;42;30;Leicht bewoelkt;9;6;0;Stadt Konstanz, Amt für Stadtplanung und Umwelt
09.04.2022 02:00;62;31;31;Bedeckt;9;6;0;Stadt Konstanz, Amt für Stadtplanung und Umwelt
09.04.2022 03:00;61;33;28;Bedeckt;9;5;0;Stadt Konstanz, Amt für Stadtplanung und Umwelt
09.04.2022 04:00;35;18;17;Bedeckt;6;3;0;Stadt Konstanz, Amt für Stadtplanung und Umwelt
09.04.2022 05:00;27;17;10;Starker Schneefall;4;1;0.3;Stadt Konstanz, Amt für Stadtplanung und Umwelt
09.04.2022 06:00;43;25;18;Starker Schneefall;2;-1;0.4;Stadt Konstanz, Amt für Stadtplanung und Umwelt
09.04.2022 07:00;51;25;26;Starker Schneefall;2;-1;0.2;Stadt Konstanz, Amt für Stadtplanung und Umwelt
09.04.2022 08:00;136;65;71;Maessige bis starke Schneefaelle;2;-1;0.2;Stadt Konstanz, Amt für Stadtplanung und Umwelt
09.04.2022 09:00;238;140;98;Maessige bis starke Schneefaelle;3;-1;0.2;Stadt Konstanz, Amt für Stadtplanung und Umwelt
09.04.2022 10:00;227;139;88;Maessige bis starke Schneefaelle;4;1;0.1;Stadt Konstanz, Amt für Stadtplanung und Umwelt
09.04.2022 11:00;367;191;176;Leichte Eisregen;4;2;0.2;Stadt Konstanz, Amt für Stadtplanung und Umwelt
09.04.2022 12:00;436;240;196;Leichte Eisregen;5;3;0.2;Stadt Konstanz, Amt für Stadtplanung und Umwelt
09.04.2022 13:00;432;220;212;Leichte Eisregen;6;3;0.1;Stadt Konstanz, Amt für Stadtplanung und Umwelt
09.04.2022 14:00;491;249;242;Stellenweiser Regenfall;6;4;0;Stadt Konstanz, Amt für Stadtplanung und Umwelt
09.04.2022 15:00;462;251;211;Stellenweiser Regenfall;7;4;0;Stadt Konstanz, Amt für Stadtplanung und Umwelt
09.04.2022 16:00;423;192;231;Stellenweiser Regenfall;6;3;0;Stadt Konstanz, Amt für Stadtplanung und Umwelt
09.04.2022 17:00;464;179;285;Leichter Regenschauer;5;3;0.1;Stadt Konstanz, Amt für Stadtplanung und Umwelt
09.04.2022 18:00;432;213;219;Leichter Regenschauer;5;2;0.2;Stadt Konstanz, Amt für Stadtplanung und Umwelt
09.04.2022 19:00;359;223;136;Leichter Regenschauer;3;1;0.1;Stadt Konstanz, Amt für Stadtplanung und Umwelt
09.04.2022 20:00;271;134;137;Leichter Eisregen;2;0;0;Stadt Konstanz, Amt für Stadtplanung und Umwelt
09.04.2022 21:00;227;105;122;Leichter Eisregen;1;-2;0;Stadt Konstanz, Amt für Stadtplanung und Umwelt
09.04.2022 22:00;173;70;103;Leichter Eisregen;0;-1;0;Stadt Konstanz, Amt für Stadtplanung und Umwelt
09.04.2022 23:00;136;45;91;Maessige bis starke Schneefaelle;0;-1;0.1;Stadt Konstanz, Amt für Stadtplanung und Umwelt
10.04.2022 00:00;140;40;100;Maessige bis starke Schneefaelle;0;-1;0.2;Stadt Konstanz, Amt für Stadtplanung und Umwelt
10.04.2022 01:00;97;37;60;Maessige bis starke Schneefaelle;0;-1;0.1;Stadt Konstanz, Amt für Stadtplanung und Umwelt
10.04.2022 02:00;75;38;37;Leichter Nebel;1;-1;0;Stadt Konstanz, Amt für Stadtplanung und Umwelt
10.04.2022 03:00;72;36;36;Leichter Nebel;1;-1;0;Stadt Konstanz, Amt für Stadtplanung und Umwelt
10.04.2022 04:00;23;12;11;Leichter Nebel;1;-1;0;Stadt Konstanz, Amt für Stadtplanung und Umwelt
10.04.2022 05:00;20;16;4;Maessige bis starke Schneefaelle;1;-2;0.1;Stadt Konstanz, Amt für Stadtplanung und Umwelt
10.04.2022 06:00;37;24;13;Maessige bis starke Schneefaelle;1;-2;0.1;Stadt Konstanz, Amt für Stadtplanung und Umwelt
10.04.2022 07:00;38;19;19;Maessige bis starke Schneefaelle;2;-1;0.1;Stadt Konstanz, Amt für Stadtplanung und Umwelt
10.04.2022 08:00;52;29;23;Leichter Schneefall;2;0;0;Stadt Konstanz, Amt für Stadtplanung und Umwelt
10.04.2022 09:00;169;67;102;Leichter Schneefall;3;1;0;Stadt Konstanz, Amt für Stadtplanung und Umwelt
10.04.2022 10:00;159;80;79;Leichter Schneefall;4;2;0;Stadt Konstanz, Amt für Stadtplanung und Umwelt
10.04.2022 11:00;276;132;144;Stellenweiser Regenfall;5;4;0;Stadt Konstanz, Amt für Stadtplanung und Umwelt
10.04.2022 12:00;293;121;172;Stellenweiser Regenfall;6;6;0;Stadt Konstanz, Amt für Stadtplanung und Umwelt
10.04.2022 13:00;348;185;163;Stellenweiser Regenfall;7;6;0;Stadt Konstanz, Amt für Stadtplanung und Umwelt
10.04.2022 14:00;425;196;229;Leicht bewoelkt;7;6;0;Stadt Konstanz, Amt für Stadtplanung und Umwelt
10.04.2022 15:00;381;196;185;Leicht bewoelkt;8;7;0;Stadt Konstanz, Amt für Stadtplanung und Umwelt
10.04.2022 16:00;372;195;177;Leicht bewoelkt;7;7;0;Stadt Konstanz, Amt für Stadtplanung und Umwelt
10.04.2022 17:00;407;218;189;Stellenweiser Regenfall;7;7;0;Stadt Konstanz, Amt für Stadtplanung und Umwelt
10.04.2022 18:00;354;166;188;Stellenweiser Regenfall;7;7;0;Stadt Konstanz, Amt für Stadtplanung und Umwelt
10.04.2022 19:00;315;161;154;Stellenweiser Regenfall;5;4;0;Stadt Konstanz, Amt für Stadtplanung und Umwelt
10.04.2022 20:00;201;88;113;Leicht bewoelkt;2;2;0;Stadt Konstanz, Amt für Stadtplanung und Umwelt
10.04.2022 21:00;121;57;64;Leicht bewoelkt;0;-1;0;Stadt Konstanz, Amt für Stadtplanung und Umwelt
10.04.2022 22:00;103;39;64;Leicht bewoelkt;-1;-2;0;Stadt Konstanz, Amt für Stadtplanung und Umwelt
10.04.2022 23:00;71;22;49;Sonnig;-2;-3;0;Stadt Konstanz, Amt für Stadtplanung und Umwelt
11.04.2022 00:00;24;15;9;Sonnig;-3;-4;0;Stadt Konstanz, Amt für Stadtplanung und Umwelt
11.04.2022 01:00;20;12;8;Sonnig;-3;-4;0;Stadt Konstanz, Amt für Stadtplanung und Umwelt
11.04.2022 02:00;13;4;9;Sonnig;-3;-4;0;Stadt Konstanz, Amt für Stadtplanung und Umwelt
11.04.2022 03:00;4;1;3;Sonnig;-3;-4;0;Stadt Konstanz, Amt für Stadtplanung und Umwelt
11.04.2022 04:00;10;8;2;Sonnig;-3;-4;0;Stadt Konstanz, Amt für Stadtplanung und Umwelt
11.04.2022 05:00;37;20;17;Bedeckt;-3;-4;0;Stadt Konstanz, Amt für Stadtplanung und Umwelt
11.04.2022 06:00;157;99;58;Bedeckt;-3;-3;0;Stadt Konstanz, Amt für Stadtplanung und Umwelt
11.04.2022 07:00;987;604;383;Bedeckt;0;-1;0;Stadt Konstanz, Amt für Stadtplanung und Umwelt
11.04.2022 08:00;701;395;306;Bewoelkt;3;2;0;Stadt Konstanz, Amt für Stadtplanung und Umwelt
11.04.2022 09:00;682;414;268;Bewoelkt;6;5;0;Stadt Konstanz, Amt für Stadtplanung und Umwelt
11.04.2022 10:00;470;274;196;Bewoelkt;7;7;0;Stadt Konstanz, Amt für Stadtplanung und Umwelt
11.04.2022 11:00;591;288;303;Sonnig;9;8;0;Stadt Konstanz, Amt für Stadtplanung und Umwelt
11.04.2022 12:00;615;293;322;Sonnig;11;10;0;Stadt Konstanz, Amt für Stadtplanung und Umwelt
11.04.2022 13:00;982;460;522;Sonnig;12;11;0;Stadt Konstanz, Amt für Stadtplanung und Umwelt
11.04.2022 14:00;691;365;326;Sonnig;12;12;0;Stadt Konstanz, Amt für Stadtplanung und Umwelt
11.04.2022 15:00;987;482;505;Sonnig;13;13;0;Stadt Konstanz, Amt für Stadtplanung und Umwelt
11.04.2022 16:00;917;425;492;Sonnig;12;12;0;Stadt Konstanz, Amt für Stadtplanung und Umwelt
11.04.2022 17:00;1122;519;603;Sonnig;11;11;0;Stadt Konstanz, Amt für Stadtplanung und Umwelt
11.04.2022 18:00;870;416;454;Sonnig;11;11;0;Stadt Konstanz, Amt für Stadtplanung und Umwelt
11.04.2022 19:00;671;313;358;Sonnig;8;8;0;Stadt Konstanz, Amt für Stadtplanung und Umwelt
11.04.2022 20:00;455;170;285;Sonnig;6;6;0;Stadt Konstanz, Amt für Stadtplanung und Umwelt
11.04.2022 21:00;300;139;161;Sonnig;4;4;0;Stadt Konstanz, Amt für Stadtplanung und Umwelt
11.04.2022 22:00;165;66;99;Sonnig;4;4;0;Stadt Konstanz, Amt für Stadtplanung und Umwelt
11.04.2022 23:00;115;54;61;Sonnig;4;3;0;Stadt Konstanz, Amt für Stadtplanung und Umwelt
12.04.2022 00:00;67;34;33;Sonnig;3;3;0;Stadt Konstanz, Amt für Stadtplanung und Umwelt
12.04.2022 01:00;24;14;10;Sonnig;3;3;0;Stadt Konstanz, Amt für Stadtplanung und Umwelt
12.04.2022 02:00;31;18;13;Sonnig;3;3;0;Stadt Konstanz, Amt für Stadtplanung und Umwelt
12.04.2022 03:00;9;6;3;Sonnig;2;2;0;Stadt Konstanz, Amt für Stadtplanung und Umwelt
12.04.2022 04:00;26;19;7;Sonnig;2;2;0;Stadt Konstanz, Amt für Stadtplanung und Umwelt
12.04.2022 05:00;44;30;14;Leicht bewoelkt;2;2;0;Stadt Konstanz, Amt für Stadtplanung und Umwelt
12.04.2022 06:00;177;104;73;Leicht bewoelkt;2;2;0;Stadt Konstanz, Amt für Stadtplanung und Umwelt
12.04.2022 07:00;969;668;301;Leicht bewoelkt;5;5;0;Stadt Konstanz, Amt für Stadtplanung und Umwelt
12.04.2022 08:00;672;383;289;Leicht bewoelkt;8;8;0;Stadt Konstanz, Amt für Stadtplanung und Umwelt
12.04.2022 09:00;686;425;261;Leicht bewoelkt;11;11;0;Stadt Konstanz, Amt für Stadtplanung und Umwelt
12.04.2022 10:00;505;313;192;Leicht bewoelkt;13;13;0;Stadt Konstanz, Amt für Stadtplanung und Umwelt
12.04.2022 11:00;726;383;343;Sonnig;15;15;0;Stadt Konstanz, Amt für Stadtplanung und Umwelt
12.04.2022 12:00;700;305;395;Sonnig;17;17;0;Stadt Konstanz, Amt für Stadtplanung und Umwelt
12.04.2022 13:00;927;432;495;Sonnig;17;17;0;Stadt Konstanz, Amt für Stadtplanung und Umwelt
12.04.2022 14:00;792;382;410;Leicht bewoelkt;18;18;0;Stadt Konstanz, Amt für Stadtplanung und Umwelt
12.04.2022 15:00;1099;536;563;Leicht bewoelkt;19;19;0;Stadt Konstanz, Amt für Stadtplanung und Umwelt
12.04.2022 16:00;1102;488;614;Leicht bewoelkt;17;17;0;Stadt Konstanz, Amt für Stadtplanung und Umwelt
12.04.2022 17:00;1226;606;620;Leicht bewoelkt;16;16;0;Stadt Konstanz, Amt für Stadtplanung und Umwelt
12.04.2022 18:00;1075;486;589;Leicht bewoelkt;14;15;0;Stadt Konstanz, Amt für Stadtplanung und Umwelt
12.04.2022 19:00;769;365;404;Leicht bewoelkt;12;13;0;Stadt Konstanz, Amt für Stadtplanung und Umwelt
12.04.2022 20:00;568;280;288;Leicht bewoelkt;11;11;0;Stadt Konstanz, Amt für Stadtplanung und Umwelt
12.04.2022 21:00;397;169;228;Leicht bewoelkt;9;9;0;Stadt Konstanz, Amt für Stadtplanung und Umwelt
12.04.2022 22:00;299;78;221;Leicht bewoelkt;9;9;0;Stadt Konstanz, Amt für Stadtplanung und Umwelt
12.04.2022 23:00;235;82;153;Bedeckt;9;9;0;Stadt Konstanz, Amt für Stadtplanung und Umwelt
13.04.2022 00:00;82;24;58;Bedeckt;8;8;0;Stadt Konstanz, Amt für Stadtplanung und Umwelt
13.04.2022 01:00;84;39;45;Bedeckt;8;8;0;Stadt Konstanz, Amt für Stadtplanung und Umwelt
13.04.2022 02:00;17;9;8;Bedeckt;8;8;0;Stadt Konstanz, Amt für Stadtplanung und Umwelt
13.04.2022 03:00;6;3;3;Bedeckt;7;7;0;Stadt Konstanz, Amt für Stadtplanung und Umwelt
13.04.2022 04:00;14;8;6;Bedeckt;7;7;0;Stadt Konstanz, Amt für Stadtplanung und Umwelt
13.04.2022 05:00;41;25;16;Bedeckt;7;7;0;Stadt Konstanz, Amt für Stadtplanung und Umwelt
13.04.2022 06:00;172;106;66;Bedeckt;7;7;0;Stadt Konstanz, Amt für Stadtplanung und Umwelt
13.04.2022 07:00;792;435;357;Bedeckt;9;9;0;Stadt Konstanz, Amt für Stadtplanung und Umwelt
13.04.2022 08:00;841;517;324;Leicht bewoelkt;12;12;0;Stadt Konstanz, Amt für Stadtplanung und Umwelt
13.04.2022 09:00;1027;681;346;Leicht bewoelkt;14;15;0;Stadt Konstanz, Amt für Stadtplanung und Umwelt
13.04.2022 10:00;545;290;255;Leicht bewoelkt;15;16;0;Stadt Konstanz, Amt für Stadtplanung und Umwelt
13.04.2022 11:00;775;347;428;Leicht bewoelkt;17;17;0;Stadt Konstanz, Amt für Stadtplanung und Umwelt
13.04.2022 12:00;832;351;481;Leicht bewoelkt;18;18;0;Stadt Konstanz, Amt für Stadtplanung und Umwelt
13.04.2022 13:00;1200;548;652;Leicht bewoelkt;18;18;0;Stadt Konstanz, Amt für Stadtplanung und Umwelt
13.04.2022 14:00;877;422;455;Leicht bewoelkt;19;19;0;Stadt Konstanz, Amt für Stadtplanung und Umwelt
13.04.2022 15:00;998;539;459;Leicht bewoelkt;19;19;0;Stadt Konstanz, Amt für Stadtplanung und Umwelt
13.04.2022 16:00;1019;479;540;Leicht bewoelkt;18;18;0;Stadt Konstanz, Amt für Stadtplanung und Umwelt
13.04.2022 17:00;1153;500;653;Leicht bewoelkt;16;16;0;Stadt Konstanz, Amt für Stadtplanung und Umwelt
13.04.2022 18:00;1003;466;537;Leicht bewoelkt;15;15;0;Stadt Konstanz, Amt für Stadtplanung und Umwelt
13.04.2022 19:00;675;321;354;Leicht bewoelkt;13;13;0;Stadt Konstanz, Amt für Stadtplanung und Umwelt
13.04.2022 20:00;573;252;321;Leicht bewoelkt;12;12;0;Stadt Konstanz, Amt für Stadtplanung und Umwelt
13.04.2022 21:00;376;166;210;Leicht bewoelkt;10;10;0;Stadt Konstanz, Amt für Stadtplanung und Umwelt
13.04.2022 22:00;248;100;148;Leicht bewoelkt;9;10;0;Stadt Konstanz, Amt für Stadtplanung und Umwelt
13.04.2022 23:00;153;59;94;Bewoelkt;9;9;0;Stadt Konstanz, Amt für Stadtplanung und Umwelt
14.04.2022 00:00;120;43;77;Bewoelkt;8;9;0;Stadt Konstanz, Amt für Stadtplanung und Umwelt
14.04.2022 01:00;81;27;54;Bewoelkt;8;8;0;Stadt Konstanz, Amt für Stadtplanung und Umwelt
14.04.2022 02:00;35;20;15;Leichter Nebel;8;8;0;Stadt Konstanz, Amt für Stadtplanung und Umwelt
14.04.2022 03:00;18;10;8;Leichter Nebel;7;7;0;Stadt Konstanz, Amt für Stadtplanung und Umwelt
14.04.2022 04:00;21;15;6;Leichter Nebel;7;7;0;Stadt Konstanz, Amt für Stadtplanung und Umwelt
14.04.2022 05:00;47;29;18;Leichter Nebel;7;7;0;Stadt Konstanz, Amt für Stadtplanung und Umwelt
14.04.2022 06:00;149;88;61;Leichter Nebel;7;7;0;Stadt Konstanz, Amt für Stadtplanung und Umwelt
14.04.2022 07:00;519;288;231;Leichter Nebel;9;9;0;Stadt Konstanz, Amt für Stadtplanung und Umwelt
14.04.2022 08:00;606;348;258;Leicht bewoelkt;12;12;0;Stadt Konstanz, Amt für Stadtplanung und Umwelt
14.04.2022 09:00;700;399;301;Leicht bewoelkt;14;14;0;Stadt Konstanz, Amt für Stadtplanung und Umwelt
14.04.2022 10:00;586;322;264;Leicht bewoelkt;16;16;0;Stadt Konstanz, Amt für Stadtplanung und Umwelt
14.04.2022 11:00;809;454;355;Leicht bewoelkt;17;17;0;Stadt Konstanz, Amt für Stadtplanung und Umwelt
14.04.2022 12:00;744;316;428;Leicht bewoelkt;18;18;0;Stadt Konstanz, Amt für Stadtplanung und Umwelt
14.04.2022 13:00;817;417;400;Leicht bewoelkt;18;18;0;Stadt Konstanz, Amt für Stadtplanung und Umwelt
14.04.2022 14:00;784;397;387;Stellenweise Gewitter und Niederschlaege;18;18;0;Stadt Konstanz, Amt für Stadtplanung und Umwelt
14.04.2022 15:00;862;446;416;Stellenweise Gewitter und Niederschlaege;19;19;0;Stadt Konstanz, Amt für Stadtplanung und Umwelt
14.04.2022 16:00;936;447;489;Stellenweise Gewitter und Niederschlaege;18;18;0;Stadt Konstanz, Amt für Stadtplanung und Umwelt
14.04.2022 17:00;965;456;509;Sonnig;17;17;0;Stadt Konstanz, Amt für Stadtplanung und Umwelt
14.04.2022 18:00;857;372;485;Sonnig;16;16;0;Stadt Konstanz, Amt für Stadtplanung und Umwelt
14.04.2022 19:00;589;272;317;Sonnig;15;15;0;Stadt Konstanz, Amt für Stadtplanung und Umwelt
14.04.2022 20:00;426;204;222;Leicht bewoelkt;13;13;0;Stadt Konstanz, Amt für Stadtplanung und Umwelt
14.04.2022 21:00;308;163;145;Leicht bewoelkt;11;11;0;Stadt Konstanz, Amt für Stadtplanung und Umwelt
14.04.2022 22:00;183;76;107;Leicht bewoelkt;11;11;0;Stadt Konstanz, Amt für Stadtplanung und Umwelt
14.04.2022 23:00;182;74;108;Leichter Nebel;10;10;0;Stadt Konstanz, Amt für Stadtplanung und Umwelt
15.04.2022 00:00;126;41;85;Leichter Nebel;9;9;0.1;Stadt Konstanz, Amt für Stadtplanung und Umwelt
15.04.2022 01:00;91;21;70;Leichter Nebel;8;8;0;Stadt Konstanz, Amt für Stadtplanung und Umwelt
15.04.2022 02:00;42;15;27;Leichter Nebel;8;8;0;Stadt Konstanz, Amt für Stadtplanung und Umwelt
15.04.2022 03:00;29;12;17;Leichter Nebel;8;8;0;Stadt Konstanz, Amt für Stadtplanung und Umwelt
15.04.2022 04:00;15;4;11;Leichter Nebel;8;8;0;Stadt Konstanz, Amt für Stadtplanung und Umwelt
15.04.2022 05:00;15;7;8;Leichter Nebel;8;8;0;Stadt Konstanz, Amt für Stadtplanung und Umwelt
15.04.2022 06:00;31;17;14;Leichter Nebel;7;7;0;Stadt Konstanz, Amt für Stadtplanung und Umwelt
15.04.2022 07:00;27;16;11;Leichter Nebel;9;9;0;Stadt Konstanz, Amt für Stadtplanung und Umwelt
15.04.2022 08:00;72;35;37;Bedeckt;10;10;0;Stadt Konstanz, Amt für Stadtplanung und Umwelt
15.04.2022 09:00;171;89;82;Bedeckt;12;12;0;Stadt Konstanz, Amt für Stadtplanung und Umwelt
15.04.2022 10:00;261;129;132;Bedeckt;13;13;0;Stadt Konstanz, Amt für Stadtplanung und Umwelt
15.04.2022 11:00;303;128;175;Stellenweiser Regenfall;14;14;0;Stadt Konstanz, Amt für Stadtplanung und Umwelt
15.04.2022 12:00;355;189;166;Stellenweiser Regenfall;15;15;0;Stadt Konstanz, Amt für Stadtplanung und Umwelt
15.04.2022 13:00;446;186;260;Stellenweiser Regenfall;15;15;0;Stadt Konstanz, Amt für Stadtplanung und Umwelt
15.04.2022 14:00;431;213;218;Stellenweiser Regenfall;15;15;0;Stadt Konstanz, Amt für Stadtplanung und Umwelt
15.04.2022 15:00;537;298;239;Stellenweiser Regenfall;16;16;0;Stadt Konstanz, Amt für Stadtplanung und Umwelt
15.04.2022 16:00;485;271;214;Stellenweiser Regenfall;15;15;0;Stadt Konstanz, Amt für Stadtplanung und Umwelt
15.04.2022 17:00;411;186;225;Stellenweiser Regenfall;15;15;0;Stadt Konstanz, Amt für Stadtplanung und Umwelt
15.04.2022 18:00;465;226;239;Stellenweiser Regenfall;14;14;0;Stadt Konstanz, Amt für Stadtplanung und Umwelt
15.04.2022 19:00;325;165;160;Stellenweiser Regenfall;12;12;0;Stadt Konstanz, Amt für Stadtplanung und Umwelt
15.04.2022 20:00;239;119;120;Leicht bewoelkt;10;10;0;Stadt Konstanz, Amt für Stadtplanung und Umwelt
15.04.2022 21:00;206;93;113;Leicht bewoelkt;8;7;0;Stadt Konstanz, Amt für Stadtplanung und Umwelt
15.04.2022 22:00;147;62;85;Leicht bewoelkt;8;7;0;Stadt Konstanz, Amt für Stadtplanung und Umwelt
15.04.2022 23:00;95;32;63;Sonnig;8;6;0;Stadt Konstanz, Amt für Stadtplanung und Umwelt
16.04.2022 00:00;69;27;42;Sonnig;8;6;0;Stadt Konstanz, Amt für Stadtplanung und Umwelt
16.04.2022 01:00;41;16;25;Sonnig;7;5;0;Stadt Konstanz, Amt für Stadtplanung und Umwelt
16.04.2022 02:00;31;12;19;Leicht bewoelkt;7;5;0;Stadt Konstanz, Amt für Stadtplanung und Umwelt
16.04.2022 03:00;15;6;9;Leicht bewoelkt;6;4;0;Stadt Konstanz, Amt für Stadtplanung und Umwelt
16.04.2022 04:00;22;4;18;Leicht bewoelkt;6;4;0;Stadt Konstanz, Amt für Stadtplanung und Umwelt
16.04.2022 05:00;23;11;12;Sonnig;6;3;0;Stadt Konstanz, Amt für Stadtplanung und Umwelt
16.04.2022 06:00;45;24;21;Sonnig;6;3;0;Stadt Konstanz, Amt für Stadtplanung und Umwelt
16.04.2022 07:00;73;37;36;Sonnig;7;4;0;Stadt Konstanz, Amt für Stadtplanung und Umwelt
16.04.2022 08:00;184;94;90;Leicht bewoelkt;8;6;0;Stadt Konstanz, Amt für Stadtplanung und Umwelt
16.04.2022 09:00;389;225;164;Leicht bewoelkt;9;7;0;Stadt Konstanz, Amt für Stadtplanung und Umwelt
16.04.2022 10:00;576;314;262;Leicht bewoelkt;10;8;0;Stadt Konstanz, Amt für Stadtplanung und Umwelt
16.04.2022 11:00;657;385;272;Leicht bewoelkt;11;8;0;Stadt Konstanz, Amt für Stadtplanung und Umwelt
16.04.2022 12:00;610;357;253;Leicht bewoelkt;11;9;0;Stadt Konstanz, Amt für Stadtplanung und Umwelt
16.04.2022 13:00;551;266;285;Leicht bewoelkt;11;9;0;Stadt Konstanz, Amt für Stadtplanung und Umwelt
16.04.2022 14:00;656;308;348;Bewoelkt;11;8;0;Stadt Konstanz, Amt für Stadtplanung und Umwelt
16.04.2022 15:00;560;251;309;Bewoelkt;10;8;0;Stadt Konstanz, Amt für Stadtplanung und Umwelt
16.04.2022 16:00;511;230;281;Bewoelkt;10;7;0;Stadt Konstanz, Amt für Stadtplanung und Umwelt
16.04.2022 17:00;462;187;275;Leicht bewoelkt;10;7;0;Stadt Konstanz, Amt für Stadtplanung und Umwelt
16.04.2022 18:00;389;176;213;Leicht bewoelkt;9;7;0;Stadt Konstanz, Amt für Stadtplanung und Umwelt
16.04.2022 19:00;298;140;158;Leicht bewoelkt;8;4;0;Stadt Konstanz, Amt für Stadtplanung und Umwelt
16.04.2022 20:00;246;115;131;Sonnig;6;2;0;Stadt Konstanz, Amt für Stadtplanung und Umwelt
16.04.2022 21:00;181;103;78;Sonnig;4;0;0;Stadt Konstanz, Amt für Stadtplanung und Umwelt
16.04.2022 22:00;141;38;103;Sonnig;4;0;0;Stadt Konstanz, Amt für Stadtplanung und Umwelt
16.04.2022 23:00;105;37;68;Sonnig;4;0;0;Stadt Konstanz, Amt für Stadtplanung und Umwelt
17.04.2022 00:00;69;28;41;Sonnig;4;0;0;Stadt Konstanz, Amt für Stadtplanung und Umwelt
17.04.2022 01:00;42;15;27;Sonnig;3;-1;0;Stadt Konstanz, Amt für Stadtplanung und Umwelt
17.04.2022 02:00;36;11;25;Sonnig;2;-1;0;Stadt Konstanz, Amt für Stadtplanung und Umwelt
17.04.2022 03:00;21;6;15;Sonnig;2;-2;0;Stadt Konstanz, Amt für Stadtplanung und Umwelt
17.04.2022 04:00;25;14;11;Sonnig;1;-3;0;Stadt Konstanz, Amt für Stadtplanung und Umwelt
17.04.2022 05:00;21;15;6;Sonnig;1;-3;0;Stadt Konstanz, Amt für Stadtplanung und Umwelt
17.04.2022 06:00;40;23;17;Sonnig;1;-3;0;Stadt Konstanz, Amt für Stadtplanung und Umwelt
17.04.2022 07:00;26;11;15;Sonnig;3;-1;0;Stadt Konstanz, Amt für Stadtplanung und Umwelt
17.04.2022 08:00;57;29;28;Sonnig;5;2;0;Stadt Konstanz, Amt für Stadtplanung und Umwelt
17.04.2022 09:00;179;85;94;Sonnig;8;5;0;Stadt Konstanz, Amt für Stadtplanung und Umwelt
17.04.2022 10:00;225;106;119;Sonnig;10;9;0;Stadt Konstanz, Amt für Stadtplanung und Umwelt
17.04.2022 11:00;351;173;178;Sonnig;13;12;0;Stadt Konstanz, Amt für Stadtplanung und Umwelt
17.04.2022 12:00;358;168;190;Sonnig;16;16;0;Stadt Konstanz, Amt für Stadtplanung und Umwelt
17.04.2022 13:00;374;188;186;Sonnig;16;16;0;Stadt Konstanz, Amt für Stadtplanung und Umwelt
17.04.2022 14:00;404;200;204;Sonnig;17;17;0;Stadt Konstanz, Amt für Stadtplanung und Umwelt
17.04.2022 15:00;395;197;198;Sonnig;17;17;0;Stadt Konstanz, Amt für Stadtplanung und Umwelt
17.04.2022 16:00;393;170;223;Sonnig;16;15;0;Stadt Konstanz, Amt für Stadtplanung und Umwelt
17.04.2022 17:00;364;190;174;Sonnig;14;13;0;Stadt Konstanz, Amt für Stadtplanung und Umwelt
17.04.2022 18:00;292;149;143;Sonnig;13;11;0;Stadt Konstanz, Amt für Stadtplanung und Umwelt
17.04.2022 19:00;281;144;137;Sonnig;10;8;0;Stadt Konstanz, Amt für Stadtplanung und Umwelt
17.04.2022 20:00;194;91;103;Sonnig;7;5;0;Stadt Konstanz, Amt für Stadtplanung und Umwelt
17.04.2022 21:00;110;51;59;Sonnig;5;2;0;Stadt Konstanz, Amt für Stadtplanung und Umwelt
17.04.2022 22:00;84;45;39;Sonnig;4;1;0;Stadt Konstanz, Amt für Stadtplanung und Umwelt
17.04.2022 23:00;76;35;41;Sonnig;3;0;0;Stadt Konstanz, Amt für Stadtplanung und Umwelt
18.04.2022 00:00;30;12;18;Sonnig;2;-1;0;Stadt Konstanz, Amt für Stadtplanung und Umwelt
18.04.2022 01:00;28;17;11;Sonnig;1;-1;0;Stadt Konstanz, Amt für Stadtplanung und Umwelt
18.04.2022 02:00;17;8;9;Sonnig;0;-2;0;Stadt Konstanz, Amt für Stadtplanung und Umwelt
18.04.2022 03:00;4;3;1;Sonnig;-1;-3;0;Stadt Konstanz, Amt für Stadtplanung und Umwelt
18.04.2022 04:00;18;16;2;Sonnig;-1;-3;0;Stadt Konstanz, Amt für Stadtplanung und Umwelt
18.04.2022 05:00;10;5;5;Sonnig;-2;-4;0;Stadt Konstanz, Amt für Stadtplanung und Umwelt
18.04.2022 06:00;29;21;8;Sonnig;-2;-4;0;Stadt Konstanz, Amt für Stadtplanung und Umwelt
18.04.2022 07:00;28;12;16;Sonnig;1;-1;0;Stadt Konstanz, Amt für Stadtplanung und Umwelt
18.04.2022 08:00;68;32;36;Sonnig;4;3;0;Stadt Konstanz, Amt für Stadtplanung und Umwelt
18.04.2022 09:00;156;76;80;Sonnig;7;6;0;Stadt Konstanz, Amt für Stadtplanung und Umwelt
18.04.2022 10:00;279;148;131;Sonnig;9;8;0;Stadt Konstanz, Amt für Stadtplanung und Umwelt
18.04.2022 11:00;367;177;190;Sonnig;10;10;0;Stadt Konstanz, Amt für Stadtplanung und Umwelt
18.04.2022 12:00;423;188;235;Sonnig;12;11;0;Stadt Konstanz, Amt für Stadtplanung und Umwelt
18.04.2022 13:00;485;225;260;Sonnig;13;12;0;Stadt Konstanz, Amt für Stadtplanung und Umwelt
18.04.2022 14:00;455;236;219;Sonnig;13;13;0;Stadt Konstanz, Amt für Stadtplanung und Umwelt
18.04.2022 15:00;528;303;225;Sonnig;14;13;0;Stadt Konstanz, Amt für Stadtplanung und Umwelt
18.04.2022 16:00;515;286;229;Sonnig;13;12;0;Stadt Konstanz, Amt für Stadtplanung und Umwelt
18.04.2022 17:00;489;242;247;Leicht bewoelkt;12;11;0;Stadt Konstanz, Amt für Stadtplanung und Umwelt
18.04.2022 18:00;440;265;175;Leicht bewoelkt;11;10;0;Stadt Konstanz, Amt für Stadtplanung und Umwelt
18.04.2022 19:00;332;163;169;Leicht bewoelkt;9;8;0;Stadt Konstanz, Amt für Stadtplanung und Umwelt
18.04.2022 20:00;266;102;164;Bedeckt;7;6;0;Stadt Konstanz, Amt für Stadtplanung und Umwelt
18.04.2022 21:00;144;59;85;Bedeckt;5;4;0;Stadt Konstanz, Amt für Stadtplanung und Umwelt
18.04.2022 22:00;116;62;54;Bedeckt;4;3;0;Stadt Konstanz, Amt für Stadtplanung und Umwelt
18.04.2022 23:00;68;31;37;Sonnig;3;2;0;Stadt Konstanz, Amt für Stadtplanung und Umwelt
19.04.2022 00:00;44;22;22;Sonnig;2;2;0;Stadt Konstanz, Amt für Stadtplanung und Umwelt
19.04.2022 01:00;31;18;13;Sonnig;1;1;0;Stadt Konstanz, Amt für Stadtplanung und Umwelt
19.04.2022 02:00;10;5;5;Sonnig;1;1;0;Stadt Konstanz, Amt für Stadtplanung und Umwelt
19.04.2022 03:00;5;5;0;Sonnig;0;0;0;Stadt Konstanz, Amt für Stadtplanung und Umwelt
19.04.2022 04:00;9;6;3;Sonnig;0;0;0;Stadt Konstanz, Amt für Stadtplanung und Umwelt
19.04.2022 05:00;39;27;12;Sonnig;0;0;0;Stadt Konstanz, Amt für Stadtplanung und Umwelt
19.04.2022 06:00;168;109;59;Sonnig;1;1;0;Stadt Konstanz, Amt für Stadtplanung und Umwelt
19.04.2022 07:00;476;296;180;Sonnig;3;3;0;Stadt Konstanz, Amt für Stadtplanung und Umwelt
19.04.2022 08:00;597;331;266;Sonnig;6;6;0;Stadt Konstanz, Amt für Stadtplanung und Umwelt
19.04.2022 09:00;632;385;247;Sonnig;9;9;0;Stadt Konstanz, Amt für Stadtplanung und Umwelt
19.04.2022 10:00;569;306;263;Sonnig;10;10;0;Stadt Konstanz, Amt für Stadtplanung und Umwelt
19.04.2022 11:00;672;374;298;Sonnig;12;12;0;Stadt Konstanz, Amt für Stadtplanung und Umwelt
19.04.2022 12:00;675;337;338;Sonnig;14;14;0;Stadt Konstanz, Amt für Stadtplanung und Umwelt
19.04.2022 13:00;826;418;408;Sonnig;14;14;0;Stadt Konstanz, Amt für Stadtplanung und Umwelt
19.04.2022 14:00;671;336;335;Sonnig;14;14;0;Stadt Konstanz, Amt für Stadtplanung und Umwelt
19.04.2022 15:00;760;383;377;Sonnig;15;14;0;Stadt Konstanz, Amt für Stadtplanung und Umwelt
19.04.2022 16:00;878;426;452;Sonnig;14;14;0;Stadt Konstanz, Amt für Stadtplanung und Umwelt
19.04.2022 17:00;1014;458;556;Sonnig;14;13;0;Stadt Konstanz, Amt für Stadtplanung und Umwelt
19.04.2022 18:00;870;387;483;Sonnig;14;13;0;Stadt Konstanz, Amt für Stadtplanung und Umwelt
19.04.2022 19:00;611;290;321;Sonnig;11;10;0;Stadt Konstanz, Amt für Stadtplanung und Umwelt
19.04.2022 20:00;436;189;247;Sonnig;9;7;0;Stadt Konstanz, Amt für Stadtplanung und Umwelt
19.04.2022 21:00;243;107;136;Sonnig;6;4;0;Stadt Konstanz, Amt für Stadtplanung und Umwelt
19.04.2022 22:00;215;87;128;Sonnig;7;5;0;Stadt Konstanz, Amt für Stadtplanung und Umwelt
19.04.2022 23:00;118;47;71;Leicht bewoelkt;7;6;0;Stadt Konstanz, Amt für Stadtplanung und Umwelt
20.04.2022 00:00;89;48;41;Leicht bewoelkt;8;8;0;Stadt Konstanz, Amt für Stadtplanung und Umwelt
20.04.2022 01:00;24;9;15;Leicht bewoelkt;7;7;0;Stadt Konstanz, Amt für Stadtplanung und Umwelt
20.04.2022 02:00;17;12;5;Sonnig;6;6;0;Stadt Konstanz, Amt für Stadtplanung und Umwelt
20.04.2022 03:00;9;6;3;Sonnig;6;5;0;Stadt Konstanz, Amt für Stadtplanung und Umwelt
20.04.2022 04:00;10;8;2;Sonnig;5;4;0;Stadt Konstanz, Amt für Stadtplanung und Umwelt
20.04.2022 05:00;51;26;25;Sonnig;5;3;0;Stadt Konstanz, Amt für Stadtplanung und Umwelt
20.04.2022 06:00;153;89;64;Sonnig;4;3;0;Stadt Konstanz, Amt für Stadtplanung und Umwelt
20.04.2022 07:00;556;344;212;Sonnig;6;4;0;Stadt Konstanz, Amt für Stadtplanung und Umwelt
20.04.2022 08:00;632;366;266;Sonnig;8;5;0;Stadt Konstanz, Amt für Stadtplanung und Umwelt
20.04.2022 09:00;718;426;292;Sonnig;9;7;0;Stadt Konstanz, Amt für Stadtplanung und Umwelt
20.04.2022 10:00;536;285;251;Sonnig;11;9;0;Stadt Konstanz, Amt für Stadtplanung und Umwelt
20.04.2022 11:00;687;317;370;Sonnig;12;10;0;Stadt Konstanz, Amt für Stadtplanung und Umwelt
20.04.2022 12:00;722;336;386;Sonnig;14;12;0;Stadt Konstanz, Amt für Stadtplanung und Umwelt
20.04.2022 13:00;784;413;371;Sonnig;14;12;0;Stadt Konstanz, Amt für Stadtplanung und Umwelt
20.04.2022 14:00;721;383;338;Leicht bewoelkt;14;13;0;Stadt Konstanz, Amt für Stadtplanung und Umwelt
20.04.2022 15:00;835;425;410;Leicht bewoelkt;15;13;0;Stadt Konstanz, Amt für Stadtplanung und Umwelt
20.04.2022 16:00;943;462;481;Leicht bewoelkt;14;13;0;Stadt Konstanz, Amt für Stadtplanung und Umwelt
20.04.2022 17:00;1120;528;592;Sonnig;14;13;0;Stadt Konstanz, Amt für Stadtplanung und Umwelt
20.04.2022 18:00;975;428;547;Sonnig;14;12;0;Stadt Konstanz, Amt für Stadtplanung und Umwelt
20.04.2022 19:00;638;316;322;Sonnig;11;9;0;Stadt Konstanz, Amt für Stadtplanung und Umwelt
20.04.2022 20:00;488;209;279;Sonnig;9;6;0;Stadt Konstanz, Amt für Stadtplanung und Umwelt
20.04.2022 21:00;297;124;173;Sonnig;6;3;0;Stadt Konstanz, Amt für Stadtplanung und Umwelt
20.04.2022 22:00;239;98;141;Sonnig;5;2;0;Stadt Konstanz, Amt für Stadtplanung und Umwelt
20.04.2022 23:00;133;61;72;Sonnig;4;2;0;Stadt Konstanz, Amt für Stadtplanung und Umwelt
21.04.2022 00:00;94;41;53;Sonnig;2;1;0;Stadt Konstanz, Amt für Stadtplanung und Umwelt
21.04.2022 01:00;35;17;18;Sonnig;2;1;0;Stadt Konstanz, Amt für Stadtplanung und Umwelt
21.04.2022 02:00;18;10;8;Leicht bewoelkt;2;0;0;Stadt Konstanz, Amt für Stadtplanung und Umwelt
21.04.2022 03:00;10;4;6;Leicht bewoelkt;1;0;0;Stadt Konstanz, Amt für Stadtplanung und Umwelt
21.04.2022 04:00;14;12;2;Leicht bewoelkt;1;0;0;Stadt Konstanz, Amt für Stadtplanung und Umwelt
21.04.2022 05:00;38;26;12;Leicht bewoelkt;1;0;0;Stadt Konstanz, Amt für Stadtplanung und Umwelt
21.04.2022 06:00;171;104;67;Leicht bewoelkt;1;0;0;Stadt Konstanz, Amt für Stadtplanung und Umwelt
21.04.2022 07:00;562;314;248;Leicht bewoelkt;4;2;0;Stadt Konstanz, Amt für Stadtplanung und Umwelt
21.04.2022 08:00;620;349;271;Leicht bewoelkt;6;5;0;Stadt Konstanz, Amt für Stadtplanung und Umwelt
21.04.2022 09:00;668;377;291;Leicht bewoelkt;9;8;0;Stadt Konstanz, Amt für Stadtplanung und Umwelt
21.04.2022 10:00;493;281;212;Leicht bewoelkt;10;10;0;Stadt Konstanz, Amt für Stadtplanung und Umwelt
21.04.2022 11:00;651;333;318;Sonnig;12;12;0;Stadt Konstanz, Amt für Stadtplanung und Umwelt
21.04.2022 12:00;694;329;365;Sonnig;14;14;0;Stadt Konstanz, Amt für Stadtplanung und Umwelt
21.04.2022 13:00;751;395;356;Sonnig;15;15;0;Stadt Konstanz, Amt für Stadtplanung und Umwelt
21.04.2022 14:00;654;348;306;Sonnig;16;16;0;Stadt Konstanz, Amt für Stadtplanung und Umwelt
21.04.2022 15:00;798;394;404;Sonnig;17;17;0;Stadt Konstanz, Amt für Stadtplanung und Umwelt
21.04.2022 16:00;909;434;475;Sonnig;17;17;0;Stadt Konstanz, Amt für Stadtplanung und Umwelt
21.04.2022 17:00;1043;474;569;Sonnig;16;16;0;Stadt Konstanz, Amt für Stadtplanung und Umwelt
21.04.2022 18:00;875;393;482;Sonnig;16;16;0;Stadt Konstanz, Amt für Stadtplanung und Umwelt
21.04.2022 19:00;652;298;354;Sonnig;13;13;0;Stadt Konstanz, Amt für Stadtplanung und Umwelt
21.04.2022 20:00;550;241;309;Leicht bewoelkt;11;10;0;Stadt Konstanz, Amt für Stadtplanung und Umwelt
21.04.2022 21:00;316;129;187;Leicht bewoelkt;9;7;0;Stadt Konstanz, Amt für Stadtplanung und Umwelt
21.04.2022 22:00;258;110;148;Leicht bewoelkt;7;5;0;Stadt Konstanz, Amt für Stadtplanung und Umwelt
21.04.2022 23:00;163;71;92;Sonnig;6;4;0;Stadt Konstanz, Amt für Stadtplanung und Umwelt
22.04.2022 00:00;80;34;46;Sonnig;5;2;0;Stadt Konstanz, Amt für Stadtplanung und Umwelt
22.04.2022 01:00;49;20;29;Sonnig;4;2;0;Stadt Konstanz, Amt für Stadtplanung und Umwelt
22.04.2022 02:00;44;24;20;Leichter Nebel;4;1;0;Stadt Konstanz, Amt für Stadtplanung und Umwelt
22.04.2022 03:00;13;11;2;Leichter Nebel;3;0;0;Stadt Konstanz, Amt für Stadtplanung und Umwelt
22.04.2022 04:00;16;16;0;Leichter Nebel;3;1;0;Stadt Konstanz, Amt für Stadtplanung und Umwelt
22.04.2022 05:00;38;24;14;Bedeckt;4;2;0;Stadt Konstanz, Amt für Stadtplanung und Umwelt
22.04.2022 06:00;156;92;64;Bedeckt;4;3;0;Stadt Konstanz, Amt für Stadtplanung und Umwelt
22.04.2022 07:00;443;268;175;Bedeckt;5;4;0;Stadt Konstanz, Amt für Stadtplanung und Umwelt
22.04.2022 08:00;529;299;230;Bewoelkt;6;5;0;Stadt Konstanz, Amt für Stadtplanung und Umwelt
22.04.2022 09:00;603;364;239;Bewoelkt;7;7;0;Stadt Konstanz, Amt für Stadtplanung und Umwelt
22.04.2022 10:00;547;307;240;Bewoelkt;8;8;0;Stadt Konstanz, Amt für Stadtplanung und Umwelt
22.04.2022 11:00;710;386;324;Leicht bewoelkt;10;9;0;Stadt Konstanz, Amt für Stadtplanung und Umwelt
22.04.2022 12:00;730;344;386;Leicht bewoelkt;11;10;0;Stadt Konstanz, Amt für Stadtplanung und Umwelt
22.04.2022 13:00;740;334;406;Leicht bewoelkt;12;11;0;Stadt Konstanz, Amt für Stadtplanung und Umwelt
22.04.2022 14:00;797;386;411;Sonnig;13;13;0;Stadt Konstanz, Amt für Stadtplanung und Umwelt
22.04.2022 15:00;712;343;369;Sonnig;14;14;0;Stadt Konstanz, Amt für Stadtplanung und Umwelt
22.04.2022 16:00;776;386;390;Sonnig;14;14;0;Stadt Konstanz, Amt für Stadtplanung und Umwelt
22.04.2022 17:00;820;382;438;Leicht bewoelkt;14;14;0;Stadt Konstanz, Amt für Stadtplanung und Umwelt
22.04.2022 18:00;749;362;387;Leicht bewoelkt;14;15;0;Stadt Konstanz, Amt für Stadtplanung und Umwelt
22.04.2022 19:00;590;317;273;Leicht bewoelkt;12;13;0;Stadt Konstanz, Amt für Stadtplanung und Umwelt
22.04.2022 20:00;426;203;223;Leicht bewoelkt;11;11;0;Stadt Konstanz, Amt für Stadtplanung und Umwelt
22.04.2022 21:00;317;157;160;Leicht bewoelkt;9;9;0;Stadt Konstanz, Amt für Stadtplanung und Umwelt
22.04.2022 22:00;251;107;144;Leicht bewoelkt;8;7;0;Stadt Konstanz, Amt für Stadtplanung und Umwelt
22.04.2022 23:00;184;62;122;Leicht bewoelkt;6;5;0;Stadt Konstanz, Amt für Stadtplanung und Umwelt
23.04.2022 00:00;141;62;79;Leicht bewoelkt;5;4;0;Stadt Konstanz, Amt für Stadtplanung und Umwelt
23.04.2022 01:00;108;36;72;Leicht bewoelkt;5;4;0;Stadt Konstanz, Amt für Stadtplanung und Umwelt
23.04.2022 02:00;59;21;38;Leichter Nebel;5;4;0;Stadt Konstanz, Amt für Stadtplanung und Umwelt
23.04.2022 03:00;62;12;50;Leichter Nebel;5;4;0;Stadt Konstanz, Amt für Stadtplanung und Umwelt
23.04.2022 04:00;22;12;10;Leichter Nebel;5;3;0;Stadt Konstanz, Amt für Stadtplanung und Umwelt
23.04.2022 05:00;25;9;16;Leichter Nebel;5;3;0;Stadt Konstanz, Amt für Stadtplanung und Umwelt
23.04.2022 06:00;44;26;18;Leichter Nebel;5;3;0;Stadt Konstanz, Amt für Stadtplanung und Umwelt
23.04.2022 07:00;71;40;31;Leichter Nebel;7;5;0;Stadt Konstanz, Amt für Stadtplanung und Umwelt
23.04.2022 08:00;225;123;102;Bewoelkt;9;7;0;Stadt Konstanz, Amt für Stadtplanung und Umwelt
23.04.2022 09:00;378;227;151;Bewoelkt;10;9;0;Stadt Konstanz, Amt für Stadtplanung und Umwelt
23.04.2022 10:00;431;258;173;Bewoelkt;11;10;0;Stadt Konstanz, Amt für Stadtplanung und Umwelt
23.04.2022 11:00;505;267;238;Bedeckt;12;11;0;Stadt Konstanz, Amt für Stadtplanung und Umwelt
23.04.2022 12:00;519;275;244;Bedeckt;13;11;0;Stadt Konstanz, Amt für Stadtplanung und Umwelt
23.04.2022 13:00;565;298;267;Bedeckt;13;12;0;Stadt Konstanz, Amt für Stadtplanung und Umwelt
23.04.2022 14:00;617;296;321;Bewoelkt;13;12;0;Stadt Konstanz, Amt für Stadtplanung und Umwelt
23.04.2022 15:00;591;262;329;Bewoelkt;13;12;0;Stadt Konstanz, Amt für Stadtplanung und Umwelt
23.04.2022 16:00;638;288;350;Bewoelkt;13;12;0;Stadt Konstanz, Amt für Stadtplanung und Umwelt
23.04.2022 17:00;567;253;314;Bedeckt;13;11;0;Stadt Konstanz, Amt für Stadtplanung und Umwelt
23.04.2022 18:00;568;263;305;Bedeckt;13;11;0;Stadt Konstanz, Amt für Stadtplanung und Umwelt
23.04.2022 19:00;391;186;205;Bedeckt;12;10;0;Stadt Konstanz, Amt für Stadtplanung und Umwelt
23.04.2022 20:00;345;151;194;Bedeckt;11;9;0;Stadt Konstanz, Amt für Stadtplanung und Umwelt
23.04.2022 21:00;270;153;117;Bedeckt;10;8;0;Stadt Konstanz, Amt für Stadtplanung und Umwelt
23.04.2022 22:00;219;108;111;Bedeckt;9;7;0;Stadt Konstanz, Amt für Stadtplanung und Umwelt
23.04.2022 23:00;176;71;105;Leicht bewoelkt;8;7;0;Stadt Konstanz, Amt für Stadtplanung und Umwelt
24.04.2022 00:00;145;48;97;Leicht bewoelkt;7;6;0;Stadt Konstanz, Amt für Stadtplanung und Umwelt
24.04.2022 01:00;125;68;57;Leicht bewoelkt;7;6;0;Stadt Konstanz, Amt für Stadtplanung und Umwelt
24.04.2022 02:00;82;27;55;Leichter Nebel;6;5;0;Stadt Konstanz, Amt für Stadtplanung und Umwelt
24.04.2022 03:00;90;18;72;Leichter Nebel;6;4;0;Stadt Konstanz, Amt für Stadtplanung und Umwelt
24.04.2022 04:00;40;26;14;Leichter Nebel;6;4;0;Stadt Konstanz, Amt für Stadtplanung und Umwelt
24.04.2022 05:00;35;19;16;Nieselregen;6;3;0.2;Stadt Konstanz, Amt für Stadtplanung und Umwelt
24.04.2022 06:00;36;20;16;Nieselregen;6;3;0.3;Stadt Konstanz, Amt für Stadtplanung und Umwelt
24.04.2022 07:00;35;15;20;Nieselregen;7;5;0.1;Stadt Konstanz, Amt für Stadtplanung und Umwelt
24.04.2022 08:00;89;43;46;Leicht bewoelkt;7;6;0;Stadt Konstanz, Amt für Stadtplanung und Umwelt
24.04.2022 09:00;185;105;80;Leicht bewoelkt;8;8;0;Stadt Konstanz, Amt für Stadtplanung und Umwelt
24.04.2022 10:00;179;103;76;Leicht bewoelkt;10;10;0;Stadt Konstanz, Amt für Stadtplanung und Umwelt
24.04.2022 11:00;261;111;150;Sonnig;12;12;0;Stadt Konstanz, Amt für Stadtplanung und Umwelt
24.04.2022 12:00;282;121;161;Sonnig;14;14;0;Stadt Konstanz, Amt für Stadtplanung und Umwelt
24.04.2022 13:00;308;145;163;Sonnig;14;14;0;Stadt Konstanz, Amt für Stadtplanung und Umwelt
24.04.2022 14:00;312;167;145;Stellenweiser Regenfall;14;13;0;Stadt Konstanz, Amt für Stadtplanung und Umwelt
24.04.2022 15:00;252;130;122;Stellenweiser Regenfall;13;13;0;Stadt Konstanz, Amt für Stadtplanung und Umwelt
24.04.2022 16:00;206;98;108;Stellenweiser Regenfall;13;12;0;Stadt Konstanz, Amt für Stadtplanung und Umwelt
24.04.2022 17:00;251;120;131;Leichter Regenschauer;12;12;0.1;Stadt Konstanz, Amt für Stadtplanung und Umwelt
24.04.2022 18:00;181;106;75;Leichter Regenschauer;11;11;0.1;Stadt Konstanz, Amt für Stadtplanung und Umwelt
24.04.2022 19:00;175;90;85;Leichter Regenschauer;10;10;0;Stadt Konstanz, Amt für Stadtplanung und Umwelt
24.04.2022 20:00;116;58;58;Leichter Regenfall;10;9;0.3;Stadt Konstanz, Amt für Stadtplanung und Umwelt
24.04.2022 21:00;82;38;44;Leichter Regenfall;9;8;0.4;Stadt Konstanz, Amt für Stadtplanung und Umwelt
24.04.2022 22:00;51;26;25;Leichter Regenfall;9;8;0.2;Stadt Konstanz, Amt für Stadtplanung und Umwelt
24.04.2022 23:00;49;19;30;Nieselregen;8;7;0.2;Stadt Konstanz, Amt für Stadtplanung und Umwelt
25.04.2022 00:00;17;12;5;Nieselregen;8;7;0.4;Stadt Konstanz, Amt für Stadtplanung und Umwelt
25.04.2022 01:00;10;6;4;Nieselregen;8;7;0.2;Stadt Konstanz, Amt für Stadtplanung und Umwelt
25.04.2022 02:00;9;4;5;Stellenweiser Regenfall;8;6;0;Stadt Konstanz, Amt für Stadtplanung und Umwelt
25.04.2022 03:00;3;2;1;Stellenweiser Regenfall;9;6;0;Stadt Konstanz, Amt für Stadtplanung und Umwelt
25.04.2022 04:00;7;5;2;Stellenweiser Regenfall;8;6;0;Stadt Konstanz, Amt für Stadtplanung und Umwelt
25.04.2022 05:00;40;28;12;Nieselregen;8;7;0.2;Stadt Konstanz, Amt für Stadtplanung und Umwelt
25.04.2022 06:00;138;75;63;Nieselregen;8;7;0.3;Stadt Konstanz, Amt für Stadtplanung und Umwelt
25.04.2022 07:00;924;548;376;Nieselregen;8;7;0.2;Stadt Konstanz, Amt für Stadtplanung und Umwelt
25.04.2022 08:00;630;340;290;Leichter Regenschauer;9;7;0.1;Stadt Konstanz, Amt für Stadtplanung und Umwelt
25.04.2022 09:00;577;324;253;Leichter Regenschauer;9;8;0.2;Stadt Konstanz, Amt für Stadtplanung und Umwelt
25.04.2022 10:00;348;190;158;Leichter Regenschauer;10;9;0.1;Stadt Konstanz, Amt für Stadtplanung und Umwelt
25.04.2022 11:00;510;221;289;Leichter Regenschauer;11;10;0.1;Stadt Konstanz, Amt für Stadtplanung und Umwelt
25.04.2022 12:00;523;243;280;Leichter Regenschauer;12;11;0.1;Stadt Konstanz, Amt für Stadtplanung und Umwelt
25.04.2022 13:00;826;353;473;Leichter Regenschauer;12;12;0.1;Stadt Konstanz, Amt für Stadtplanung und Umwelt
25.04.2022 14:00;539;271;268;Stellenweiser Regenfall;13;12;0;Stadt Konstanz, Amt für Stadtplanung und Umwelt
25.04.2022 15:00;831;398;433;Stellenweiser Regenfall;14;13;0;Stadt Konstanz, Amt für Stadtplanung und Umwelt
25.04.2022 16:00;741;364;377;Stellenweiser Regenfall;13;13;0;Stadt Konstanz, Amt für Stadtplanung und Umwelt
25.04.2022 17:00;900;430;470;Leichter Regenschauer;13;13;0.1;Stadt Konstanz, Amt für Stadtplanung und Umwelt
25.04.2022 18:00;778;394;384;Leichter Regenschauer;13;13;0.1;Stadt Konstanz, Amt für Stadtplanung und Umwelt
25.04.2022 19:00;657;299;358;Leichter Regenschauer;11;11;0;Stadt Konstanz, Amt für Stadtplanung und Umwelt
25.04.2022 20:00;403;178;225;Leichter Regenfall;9;9;0.4;Stadt Konstanz, Amt für Stadtplanung und Umwelt
25.04.2022 21:00;226;95;131;Leichter Regenfall;8;6;0.5;Stadt Konstanz, Amt für Stadtplanung und Umwelt
25.04.2022 22:00;163;70;93;Leichter Regenfall;7;6;0.3;Stadt Konstanz, Amt für Stadtplanung und Umwelt
25.04.2022 23:00;73;35;38;Leichter Regenschauer;7;5;0.2;Stadt Konstanz, Amt für Stadtplanung und Umwelt
26.04.2022 00:00;62;28;34;Leichter Regenschauer;6;5;0.3;Stadt Konstanz, Amt für Stadtplanung und Umwelt
26.04.2022 01:00;21;9;12;Leichter Regenschauer;6;5;0.2;Stadt Konstanz, Amt für Stadtplanung und Umwelt
26.04.2022 02:00;5;4;1;Nieselregen;6;5;0.1;Stadt Konstanz, Amt für Stadtplanung und Umwelt
26.04.2022 03:00;4;3;1;Nieselregen;6;4;0.2;Stadt Konstanz, Amt für Stadtplanung und Umwelt
26.04.2022 04:00;9;6;3;Nieselregen;6;5;0.1;Stadt Konstanz, Amt für Stadtplanung und Umwelt
26.04.2022 05:00;29;22;7;Leichter Regenfall;6;6;0.3;Stadt Konstanz, Amt für Stadtplanung und Umwelt
26.04.2022 06:00;152;88;64;Leichter Regenfall;7;7;0.4;Stadt Konstanz, Amt für Stadtplanung und Umwelt
26.04.2022 07:00;920;559;361;Leichter Regenfall;7;7;0.2;Stadt Konstanz, Amt für Stadtplanung und Umwelt
26.04.2022 08:00;707;394;313;Leichter Regenfall;7;7;0.5;Stadt Konstanz, Amt für Stadtplanung und Umwelt
26.04.2022 09:00;419;250;169;Leichter Regenfall;7;7;0.7;Stadt Konstanz, Amt für Stadtplanung und Umwelt
26.04.2022 10:00;235;119;116;Leichter Regenfall;7;7;0.3;Stadt Konstanz, Amt für Stadtplanung und Umwelt
26.04.2022 11:00;396;190;206;Leichter Regenfall;7;6;0.5;Stadt Konstanz, Amt für Stadtplanung und Umwelt
26.04.2022 12:00;474;228;246;Leichter Regenfall;7;6;0.7;Stadt Konstanz, Amt für Stadtplanung und Umwelt
26.04.2022 13:00;707;315;392;Leichter Regenfall;7;6;0.3;Stadt Konstanz, Amt für Stadtplanung und Umwelt
26.04.2022 14:00;539;247;292;Nieselregen;7;6;0.1;Stadt Konstanz, Amt für Stadtplanung und Umwelt
26.04.2022 15:00;848;418;430;Nieselregen;7;6;0.1;Stadt Konstanz, Amt für Stadtplanung und Umwelt
26.04.2022 16:00;669;294;375;Nieselregen;7;7;0;Stadt Konstanz, Amt für Stadtplanung und Umwelt
26.04.2022 17:00;842;411;431;Leichter Regenschauer;7;7;0.1;Stadt Konstanz, Amt für Stadtplanung und Umwelt
26.04.2022 18:00;719;346;373;Leichter Regenschauer;7;7;0.1;Stadt Konstanz, Amt für Stadtplanung und Umwelt
26.04.2022 19:00;526;237;289;Leichter Regenschauer;7;7;0.1;Stadt Konstanz, Amt für Stadtplanung und Umwelt
26.04.2022 20:00;389;165;224;Nieselregen;6;6;0.1;Stadt Konstanz, Amt für Stadtplanung und Umwelt
26.04.2022 21:00;273;125;148;Nieselregen;6;6;0.1;Stadt Konstanz, Amt für Stadtplanung und Umwelt
26.04.2022 22:00;180;73;107;Nieselregen;5;5;0.1;Stadt Konstanz, Amt für Stadtplanung und Umwelt
26.04.2022 23:00;123;59;64;Leichter Nebel;5;4;0;Stadt Konstanz, Amt für Stadtplanung und Umwelt
27.04.2022 00:00;54;26;28;Leichter Nebel;4;4;0.1;Stadt Konstanz, Amt für Stadtplanung und Umwelt
27.04.2022 01:00;27;19;8;Leichter Nebel;4;4;0;Stadt Konstanz, Amt für Stadtplanung und Umwelt
27.04.2022 02:00;4;1;3;Leichter Nebel;4;4;0;Stadt Konstanz, Amt für Stadtplanung und Umwelt
27.04.2022 03:00;8;7;1;Leichter Nebel;3;3;0;Stadt Konstanz, Amt für Stadtplanung und Umwelt
27.04.2022 04:00;8;2;6;Leichter Nebel;4;3;0;Stadt Konstanz, Amt für Stadtplanung und Umwelt
27.04.2022 05:00;64;37;27;Leichter Nebel;4;3;0;Stadt Konstanz, Amt für Stadtplanung und Umwelt
27.04.2022 06:00;202;114;88;Leichter Nebel;4;4;0;Stadt Konstanz, Amt für Stadtplanung und Umwelt
27.04.2022 07:00;1050;616;434;Leichter Nebel;6;5;0;Stadt Konstanz, Amt für Stadtplanung und Umwelt
27.04.2022 08:00;799;459;340;Leicht bewoelkt;8;7;0;Stadt Konstanz, Amt für Stadtplanung und Umwelt
27.04.2022 09:00;751;448;303;Leicht bewoelkt;10;9;0;Stadt Konstanz, Amt für Stadtplanung und Umwelt
27.04.2022 10:00;449;250;199;Leicht bewoelkt;12;11;0;Stadt Konstanz, Amt für Stadtplanung und Umwelt
27.04.2022 11:00;622;277;345;Sonnig;13;13;0;Stadt Konstanz, Amt für Stadtplanung und Umwelt
27.04.2022 12:00;734;340;394;Sonnig;15;15;0;Stadt Konstanz, Amt für Stadtplanung und Umwelt
27.04.2022 13:00;1005;480;525;Sonnig;16;16;0;Stadt Konstanz, Amt für Stadtplanung und Umwelt
27.04.2022 14:00;773;386;387;Sonnig;16;16;0;Stadt Konstanz, Amt für Stadtplanung und Umwelt
27.04.2022 15:00;1035;459;576;Sonnig;16;16;0;Stadt Konstanz, Amt für Stadtplanung und Umwelt
27.04.2022 16:00;961;447;514;Sonnig;16;15;0;Stadt Konstanz, Amt für Stadtplanung und Umwelt
27.04.2022 17:00;1159;512;647;Sonnig;15;14;0;Stadt Konstanz, Amt für Stadtplanung und Umwelt
27.04.2022 18:00;975;466;509;Sonnig;14;13;0;Stadt Konstanz, Amt für Stadtplanung und Umwelt
27.04.2022 19:00;719;335;384;Sonnig;12;10;0;Stadt Konstanz, Amt für Stadtplanung und Umwelt
27.04.2022 20:00;553;259;294;Sonnig;9;7;0;Stadt Konstanz, Amt für Stadtplanung und Umwelt
27.04.2022 21:00;365;176;189;Sonnig;7;4;0;Stadt Konstanz, Amt für Stadtplanung und Umwelt
27.04.2022 22:00;282;135;147;Sonnig;6;4;0;Stadt Konstanz, Amt für Stadtplanung und Umwelt
27.04.2022 23:00;173;69;104;Sonnig;5;3;0;Stadt Konstanz, Amt für Stadtplanung und Umwelt
28.04.2022 00:00;72;27;45;Sonnig;4;2;0;Stadt Konstanz, Amt für Stadtplanung und Umwelt
28.04.2022 01:00;49;9;40;Sonnig;3;1;0;Stadt Konstanz, Amt für Stadtplanung und Umwelt
28.04.2022 02:00;25;9;16;Sonnig;2;0;0;Stadt Konstanz, Amt für Stadtplanung und Umwelt
28.04.2022 03:00;18;10;8;Sonnig;1;0;0;Stadt Konstanz, Amt für Stadtplanung und Umwelt
28.04.2022 04:00;11;5;6;Sonnig;1;0;0;Stadt Konstanz, Amt für Stadtplanung und Umwelt
28.04.2022 05:00;53;37;16;Sonnig;1;0;0;Stadt Konstanz, Amt für Stadtplanung und Umwelt
28.04.2022 06:00;208;115;93;Sonnig;1;0;0;Stadt Konstanz, Amt für Stadtplanung und Umwelt
28.04.2022 07:00;1006;624;382;Sonnig;4;3;0;Stadt Konstanz, Amt für Stadtplanung und Umwelt
28.04.2022 08:00;857;476;381;Sonnig;7;6;0;Stadt Konstanz, Amt für Stadtplanung und Umwelt
28.04.2022 09:00;753;410;343;Sonnig;10;9;0;Stadt Konstanz, Amt für Stadtplanung und Umwelt
28.04.2022 10:00;535;291;244;Sonnig;13;12;0;Stadt Konstanz, Amt für Stadtplanung und Umwelt
28.04.2022 11:00;693;353;340;Sonnig;15;15;0;Stadt Konstanz, Amt für Stadtplanung und Umwelt
28.04.2022 12:00;774;343;431;Sonnig;18;18;0;Stadt Konstanz, Amt für Stadtplanung und Umwelt
28.04.2022 13:00;1033;464;569;Sonnig;18;18;0;Stadt Konstanz, Amt für Stadtplanung und Umwelt
28.04.2022 14:00;783;393;390;Sonnig;19;19;0;Stadt Konstanz, Amt für Stadtplanung und Umwelt
28.04.2022 15:00;1153;563;590;Sonnig;19;19;0;Stadt Konstanz, Amt für Stadtplanung und Umwelt
28.04.2022 16:00;1099;521;578;Sonnig;18;18;0;Stadt Konstanz, Amt für Stadtplanung und Umwelt
28.04.2022 17:00;1274;603;671;Sonnig;18;18;0;Stadt Konstanz, Amt für Stadtplanung und Umwelt
28.04.2022 18:00;1094;514;580;Sonnig;17;17;0;Stadt Konstanz, Amt für Stadtplanung und Umwelt
28.04.2022 19:00;766;371;395;Sonnig;14;13;0;Stadt Konstanz, Amt für Stadtplanung und Umwelt
28.04.2022 20:00;514;228;286;Sonnig;11;10;0;Stadt Konstanz, Amt für Stadtplanung und Umwelt
28.04.2022 21:00;403;168;235;Sonnig;8;6;0;Stadt Konstanz, Amt für Stadtplanung und Umwelt
28.04.2022 22:00;274;112;162;Sonnig;7;5;0;Stadt Konstanz, Amt für Stadtplanung und Umwelt
28.04.2022 23:00;200;86;114;Sonnig;6;4;0;Stadt Konstanz, Amt für Stadtplanung und Umwelt
29.04.2022 00:00;97;31;66;Sonnig;4;4;0;Stadt Konstanz, Amt für Stadtplanung und Umwelt
29.04.2022 01:00;65;16;49;Sonnig;4;3;0;Stadt Konstanz, Amt für Stadtplanung und Umwelt
29.04.2022 02:00;27;13;14;Sonnig;3;3;0;Stadt Konstanz, Amt für Stadtplanung und Umwelt
29.04.2022 03:00;9;7;2;Sonnig;3;2;0;Stadt Konstanz, Amt für Stadtplanung und Umwelt
29.04.2022 04:00;6;6;0;Sonnig;3;2;0;Stadt Konstanz, Amt für Stadtplanung und Umwelt
29.04.2022 05:00;46;33;13;Sonnig;3;2;0;Stadt Konstanz, Amt für Stadtplanung und Umwelt
29.04.2022 06:00;193;108;85;Sonnig;3;2;0;Stadt Konstanz, Amt für Stadtplanung und Umwelt
29.04.2022 07:00;1017;646;371;Sonnig;6;5;0;Stadt Konstanz, Amt für Stadtplanung und Umwelt
29.04.2022 08:00;842;478;364;Sonnig;8;8;0;Stadt Konstanz, Amt für Stadtplanung und Umwelt
29.04.2022 09:00;804;472;332;Sonnig;11;12;0;Stadt Konstanz, Amt für Stadtplanung und Umwelt
29.04.2022 10:00;624;315;309;Sonnig;13;13;0;Stadt Konstanz, Amt für Stadtplanung und Umwelt
29.04.2022 11:00;745;369;376;Bewoelkt;14;14;0;Stadt Konstanz, Amt für Stadtplanung und Umwelt
29.04.2022 12:00;918;405;513;Bewoelkt;16;16;0;Stadt Konstanz, Amt für Stadtplanung und Umwelt
29.04.2022 13:00;1098;465;633;Bewoelkt;16;16;0;Stadt Konstanz, Amt für Stadtplanung und Umwelt
29.04.2022 14:00;897;455;442;Sonnig;16;16;0;Stadt Konstanz, Amt für Stadtplanung und Umwelt
29.04.2022 15:00;894;449;445;Sonnig;17;17;0;Stadt Konstanz, Amt für Stadtplanung und Umwelt
29.04.2022 16:00;870;431;439;Sonnig;16;16;0;Stadt Konstanz, Amt für Stadtplanung und Umwelt
29.04.2022 17:00;924;422;502;Sonnig;15;15;0;Stadt Konstanz, Amt für Stadtplanung und Umwelt
29.04.2022 18:00;906;462;444;Sonnig;14;14;0;Stadt Konstanz, Amt für Stadtplanung und Umwelt
29.04.2022 19:00;608;301;307;Sonnig;12;12;0;Stadt Konstanz, Amt für Stadtplanung und Umwelt
29.04.2022 20:00;471;225;246;Sonnig;11;10;0;Stadt Konstanz, Amt für Stadtplanung und Umwelt
29.04.2022 21:00;355;154;201;Sonnig;9;9;0;Stadt Konstanz, Amt für Stadtplanung und Umwelt
29.04.2022 22:00;308;113;195;Sonnig;8;8;0;Stadt Konstanz, Amt für Stadtplanung und Umwelt
29.04.2022 23:00;246;75;171;Sonnig;7;7;0;Stadt Konstanz, Amt für Stadtplanung und Umwelt
30.04.2022 00:00;162;60;102;Sonnig;6;6;0;Stadt Konstanz, Amt für Stadtplanung und Umwelt
30.04.2022 01:00;109;44;65;Sonnig;6;5;0;Stadt Konstanz, Amt für Stadtplanung und Umwelt
30.04.2022 02:00;90;50;40;Sonnig;5;5;0;Stadt Konstanz, Amt für Stadtplanung und Umwelt
30.04.2022 03:00;77;29;48;Sonnig;5;4;0;Stadt Konstanz, Amt für Stadtplanung und Umwelt
30.04.2022 04:00;50;42;8;Sonnig;5;5;0;Stadt Konstanz, Amt für Stadtplanung und Umwelt
30.04.2022 05:00;51;37;14;Leicht bewoelkt;6;5;0;Stadt Konstanz, Amt für Stadtplanung und Umwelt
30.04.2022 06:00;49;30;19;Leicht bewoelkt;6;6;0;Stadt Konstanz, Amt für Stadtplanung und Umwelt
30.04.2022 07:00;63;33;30;Leicht bewoelkt;8;8;0;Stadt Konstanz, Amt für Stadtplanung und Umwelt
30.04.2022 08:00;138;85;53;Leicht bewoelkt;10;10;0;Stadt Konstanz, Amt für Stadtplanung und Umwelt
30.04.2022 09:00;270;158;112;Leicht bewoelkt;12;12;0;Stadt Konstanz, Amt für Stadtplanung und Umwelt
30.04.2022 10:00;329;161;168;Leicht bewoelkt;13;13;0;Stadt Konstanz, Amt für Stadtplanung und Umwelt
30.04.2022 11:00;420;223;197;Bedeckt;14;14;0;Stadt Konstanz, Amt für Stadtplanung und Umwelt
30.04.2022 12:00;461;251;210;Bedeckt;14;15;0;Stadt Konstanz, Amt für Stadtplanung und Umwelt
30.04.2022 13:00;478;253;225;Bedeckt;15;15;0;Stadt Konstanz, Amt für Stadtplanung und Umwelt
30.04.2022 14:00;549;252;297;Stellenweiser Regenfall;15;15;0.1;Stadt Konstanz, Amt für Stadtplanung und Umwelt
30.04.2022 15:00;438;215;223;Stellenweiser Regenfall;15;15;0.1;Stadt Konstanz, Amt für Stadtplanung und Umwelt
30.04.2022 16:00;488;256;232;Stellenweiser Regenfall;14;14;0;Stadt Konstanz, Amt für Stadtplanung und Umwelt
30.04.2022 17:00;514;248;266;Leichter Regenschauer;13;13;0.1;Stadt Konstanz, Amt für Stadtplanung und Umwelt
30.04.2022 18:00;542;226;316;Leichter Regenschauer;12;12;0.1;Stadt Konstanz, Amt für Stadtplanung und Umwelt
30.04.2022 19:00;430;193;237;Leichter Regenschauer;11;11;0;Stadt Konstanz, Amt für Stadtplanung und Umwelt
30.04.2022 20:00;250;119;131;Leicht bewoelkt;9;9;0;Stadt Konstanz, Amt für Stadtplanung und Umwelt
30.04.2022 21:00;221;107;114;Leicht bewoelkt;8;8;0;Stadt Konstanz, Amt für Stadtplanung und Umwelt
30.04.2022 22:00;180;82;98;Leicht bewoelkt;7;7;0;Stadt Konstanz, Amt für Stadtplanung und Umwelt
30.04.2022 23:00;146;61;85;Leicht bewoelkt;6;6;0;Stadt Konstanz, Amt für Stadtplanung und Umwelt
01.05.2022 00:00;123;51;72;Leicht bewoelkt;5;5;0;Stadt Konstanz, Amt für Stadtplanung und Umwelt
01.05.2022 01:00;75;25;50;Leicht bewoelkt;5;5;0;Stadt Konstanz, Amt für Stadtplanung und Umwelt
01.05.2022 02:00;67;19;48;Leicht bewoelkt;6;6;0;Stadt Konstanz, Amt für Stadtplanung und Umwelt
01.05.2022 03:00;53;18;35;Leicht bewoelkt;6;6;0;Stadt Konstanz, Amt für Stadtplanung und Umwelt
01.05.2022 04:00;31;14;17;Leicht bewoelkt;6;6;0;Stadt Konstanz, Amt für Stadtplanung und Umwelt
01.05.2022 05:00;32;17;15;Bewoelkt;6;6;0;Stadt Konstanz, Amt für Stadtplanung und Umwelt
01.05.2022 06:00;33;28;5;Bewoelkt;6;6;0;Stadt Konstanz, Amt für Stadtplanung und Umwelt
01.05.2022 07:00;40;15;25;Bewoelkt;8;8;0;Stadt Konstanz, Amt für Stadtplanung und Umwelt
01.05.2022 08:00;87;34;53;Leicht bewoelkt;10;10;0;Stadt Konstanz, Amt für Stadtplanung und Umwelt
01.05.2022 09:00;231;130;101;Leicht bewoelkt;12;12;0;Stadt Konstanz, Amt für Stadtplanung und Umwelt
01.05.2022 10:00;345;172;173;Leicht bewoelkt;12;12;0;Stadt Konstanz, Amt für Stadtplanung und Umwelt
01.05.2022 11:00;476;216;260;Stellenweiser Regenfall;13;13;0;Stadt Konstanz, Amt für Stadtplanung und Umwelt
01.05.2022 12:00;462;209;253;Stellenweiser Regenfall;14;13;0;Stadt Konstanz, Amt für Stadtplanung und Umwelt
01.05.2022 13:00;569;288;281;Stellenweiser Regenfall;14;14;0;Stadt Konstanz, Amt für Stadtplanung und Umwelt
01.05.2022 14:00;599;330;269;Leicht bewoelkt;15;15;0;Stadt Konstanz, Amt für Stadtplanung und Umwelt
01.05.2022 15:00;606;322;284;Leicht bewoelkt;16;16;0;Stadt Konstanz, Amt für Stadtplanung und Umwelt
01.05.2022 16:00;566;252;314;Leicht bewoelkt;16;15;0;Stadt Konstanz, Amt für Stadtplanung und Umwelt
01.05.2022 17:00;627;305;322;Stellenweiser Regenfall;15;15;0;Stadt Konstanz, Amt für Stadtplanung und Umwelt
01.05.2022 18:00;514;255;259;Stellenweiser Regenfall;14;14;0;Stadt Konstanz, Amt für Stadtplanung und Umwelt
01.05.2022 19:00;408;235;173;Stellenweiser Regenfall;12;11;0;Stadt Konstanz, Amt für Stadtplanung und Umwelt
01.05.2022 20:00;346;140;206;Sonnig;10;9;0;Stadt Konstanz, Amt für Stadtplanung und Umwelt
01.05.2022 21:00;241;101;140;Sonnig;7;6;0;Stadt Konstanz, Amt für Stadtplanung und Umwelt
01.05.2022 22:00;126;50;76;Sonnig;7;6;0;Stadt Konstanz, Amt für Stadtplanung und Umwelt
01.05.2022 23:00;89;40;49;Leichter Nebel;6;6;0;Stadt Konstanz, Amt für Stadtplanung und Umwelt
02.05.2022 00:00;44;16;28;Leichter Nebel;6;6;0.1;Stadt Konstanz, Amt für Stadtplanung und Umwelt
02.05.2022 01:00;22;14;8;Leichter Nebel;6;6;0;Stadt Konstanz, Amt für Stadtplanung und Umwelt
02.05.2022 02:00;3;3;0;Leichter Nebel;5;5;0;Stadt Konstanz, Amt für Stadtplanung und Umwelt
02.05.2022 03:00;5;1;4;Leichter Nebel;5;5;0;Stadt Konstanz, Amt für Stadtplanung und Umwelt
02.05.2022 04:00;5;3;2;Leichter Nebel;5;5;0;Stadt Konstanz, Amt für Stadtplanung und Umwelt
02.05.2022 05:00;54;31;23;Leichter Nebel;6;6;0;Stadt Konstanz, Amt für Stadtplanung und Umwelt
02.05.2022 06:00;198;116;82;Leichter Nebel;6;6;0;Stadt Konstanz, Amt für Stadtplanung und Umwelt
02.05.2022 07:00;1017;631;386;Leichter Nebel;7;7;0;Stadt Konstanz, Amt für Stadtplanung und Umwelt
02.05.2022 08:00;820;448;372;Leicht bewoelkt;8;8;0;Stadt Konstanz, Amt für Stadtplanung und Umwelt
02.05.2022 09:00;772;449;323;Leicht bewoelkt;10;10;0;Stadt Konstanz, Amt für Stadtplanung und Umwelt
02.05.2022 10:00;518;265;253;Leicht bewoelkt;11;11;0;Stadt Konstanz, Amt für Stadtplanung und Umwelt
02.05.2022 11:00;735;331;404;Leicht bewoelkt;12;12;0;Stadt Konstanz, Amt für Stadtplanung und Umwelt
02.05.2022 12:00;693;301;392;Leicht bewoelkt;13;13;0;Stadt Konstanz, Amt für Stadtplanung und Umwelt
02.05.2022 13:00;1039;454;585;Leicht bewoelkt;14;14;0;Stadt Konstanz, Amt für Stadtplanung und Umwelt
02.05.2022 14:00;797;424;373;Leicht bewoelkt;15;15;0;Stadt Konstanz, Amt für Stadtplanung und Umwelt
02.05.2022 15:00;1141;564;577;Leicht bewoelkt;16;16;0;Stadt Konstanz, Amt für Stadtplanung und Umwelt
02.05.2022 16:00;1028;490;538;Leicht bewoelkt;15;15;0;Stadt Konstanz, Amt für Stadtplanung und Umwelt
02.05.2022 17:00;1229;566;663;Stellenweiser Regenfall;14;14;0.1;Stadt Konstanz, Amt für Stadtplanung und Umwelt
02.05.2022 18:00;967;443;524;Stellenweiser Regenfall;13;13;0.1;Stadt Konstanz, Amt für Stadtplanung und Umwelt
02.05.2022 19:00;717;354;363;Stellenweiser Regenfall;11;11;0.1;Stadt Konstanz, Amt für Stadtplanung und Umwelt
02.05.2022 20:00;521;215;306;Leicht bewoelkt;9;9;0;Stadt Konstanz, Amt für Stadtplanung und Umwelt
02.05.2022 21:00;359;158;201;Leicht bewoelkt;7;7;0;Stadt Konstanz, Amt für Stadtplanung und Umwelt
02.05.2022 22:00;249;88;161;Leicht bewoelkt;7;6;0;Stadt Konstanz, Amt für Stadtplanung und Umwelt
02.05.2022 23:00;106;46;60;Leicht bewoelkt;6;6;0;Stadt Konstanz, Amt für Stadtplanung und Umwelt
03.05.2022 00:00;48;20;28;Leicht bewoelkt;6;6;0;Stadt Konstanz, Amt für Stadtplanung und Umwelt
03.05.2022 01:00;32;15;17;Leicht bewoelkt;6;6;0;Stadt Konstanz, Amt für Stadtplanung und Umwelt
03.05.2022 02:00;14;8;6;Sonnig;5;5;0;Stadt Konstanz, Amt für Stadtplanung und Umwelt
03.05.2022 03:00;11;10;1;Sonnig;5;5;0;Stadt Konstanz, Amt für Stadtplanung und Umwelt
03.05.2022 04:00;10;4;6;Sonnig;5;5;0;Stadt Konstanz, Amt für Stadtplanung und Umwelt
03.05.2022 05:00;45;29;16;Sonnig;5;5;0;Stadt Konstanz, Amt für Stadtplanung und Umwelt
03.05.2022 06:00;226;133;93;Sonnig;6;6;0;Stadt Konstanz, Amt für Stadtplanung und Umwelt
03.05.2022 07:00;1108;698;410;Sonnig;8;8;0;Stadt Konstanz, Amt für Stadtplanung und Umwelt
03.05.2022 08:00;992;557;435;Sonnig;11;11;0;Stadt Konstanz, Amt für Stadtplanung und Umwelt
03.05.2022 09:00;875;521;354;Sonnig;14;14;0;Stadt Konstanz, Amt für Stadtplanung und Umwelt
03.05.2022 10:00;590;308;282;Sonnig;15;15;0;Stadt Konstanz, Amt für Stadtplanung und Umwelt
03.05.2022 11:00;806;382;424;Sonnig;16;16;0;Stadt Konstanz, Amt für Stadtplanung und Umwelt
03.05.2022 12:00;763;324;439;Sonnig;18;18;0;Stadt Konstanz, Amt für Stadtplanung und Umwelt
03.05.2022 13:00;956;437;519;Sonnig;18;18;0;Stadt Konstanz, Amt für Stadtplanung und Umwelt
03.05.2022 14:00;773;381;392;Sonnig;19;19;0;Stadt Konstanz, Amt für Stadtplanung und Umwelt
03.05.2022 15:00;1149;556;593;Sonnig;19;19;0;Stadt Konstanz, Amt für Stadtplanung und Umwelt
03.05.2022 16:00;1053;499;554;Sonnig;18;18;0;Stadt Konstanz, Amt für Stadtplanung und Umwelt
03.05.2022 17:00;1150;541;609;Stellenweiser Regenfall;16;16;0;Stadt Konstanz, Amt für Stadtplanung und Umwelt
03.05.2022 18:00;920;430;490;Stellenweiser Regenfall;15;15;0;Stadt Konstanz, Amt für Stadtplanung und Umwelt
03.05.2022 19:00;675;308;367;Stellenweiser Regenfall;13;13;0;Stadt Konstanz, Amt für Stadtplanung und Umwelt
03.05.2022 20:00;518;206;312;Leichter Regenschauer;12;12;0.1;Stadt Konstanz, Amt für Stadtplanung und Umwelt
03.05.2022 21:00;366;167;199;Leichter Regenschauer;10;10;0.1;Stadt Konstanz, Amt für Stadtplanung und Umwelt
03.05.2022 22:00;261;99;162;Leichter Regenschauer;9;10;0.1;Stadt Konstanz, Amt für Stadtplanung und Umwelt
03.05.2022 23:00;143;73;70;Leichter Regenschauer;9;9;0.1;Stadt Konstanz, Amt für Stadtplanung und Umwelt
04.05.2022 00:00;77;30;47;Leichter Regenschauer;9;9;0.2;Stadt Konstanz, Amt für Stadtplanung und Umwelt
04.05.2022 01:00;59;19;40;Leichter Regenschauer;8;8;0.1;Stadt Konstanz, Amt für Stadtplanung und Umwelt
04.05.2022 02:00;15;7;8;Stellenweise Gewitter und Niederschlaege;8;8;0;Stadt Konstanz, Amt für Stadtplanung und Umwelt
04.05.2022 03:00;7;3;4;Stellenweise Gewitter und Niederschlaege;8;8;0;Stadt Konstanz, Amt für Stadtplanung und Umwelt
04.05.2022 04:00;5;4;1;Stellenweise Gewitter und Niederschlaege;8;8;0;Stadt Konstanz, Amt für Stadtplanung und Umwelt
04.05.2022 05:00;66;39;27;Bewoelkt;9;9;0;Stadt Konstanz, Amt für Stadtplanung und Umwelt
04.05.2022 06:00;206;117;89;Bewoelkt;9;9;0;Stadt Konstanz, Amt für Stadtplanung und Umwelt
04.05.2022 07:00;1131;712;419;Bewoelkt;10;10;0;Stadt Konstanz, Amt für Stadtplanung und Umwelt
04.05.2022 08:00;868;519;349;Leichter Regenschauer;11;11;0.1;Stadt Konstanz, Amt für Stadtplanung und Umwelt
04.05.2022 09:00;845;489;356;Leichter Regenschauer;12;12;0.1;Stadt Konstanz, Amt für Stadtplanung und Umwelt
04.05.2022 10:00;490;278;212;Leichter Regenschauer;12;12;0.1;Stadt Konstanz, Amt für Stadtplanung und Umwelt
04.05.2022 11:00;727;341;386;Leichter Regenschauer;12;12;0.2;Stadt Konstanz, Amt für Stadtplanung und Umwelt
04.05.2022 12:00;799;340;459;Leichter Regenschauer;12;12;0.2;Stadt Konstanz, Amt für Stadtplanung und Umwelt
04.05.2022 13:00;1059;516;543;Leichter Regenschauer;14;14;0.1;Stadt Konstanz, Amt für Stadtplanung und Umwelt
04.05.2022 14:00;807;391;416;Leicht bewoelkt;15;15;0;Stadt Konstanz, Amt für Stadtplanung und Umwelt
04.05.2022 15:00;1126;486;640;Leicht bewoelkt;17;17;0;Stadt Konstanz, Amt für Stadtplanung und Umwelt
04.05.2022 16:00;962;443;519;Leicht bewoelkt;16;16;0;Stadt Konstanz, Amt für Stadtplanung und Umwelt
04.05.2022 17:00;1169;486;683;Leichter Regenschauer;15;16;0.1;Stadt Konstanz, Amt für Stadtplanung und Umwelt
04.05.2022 18:00;971;449;522;Leichter Regenschauer;15;15;0.1;Stadt Konstanz, Amt für Stadtplanung und Umwelt
04.05.2022 19:00;657;293;364;Leichter Regenschauer;13;13;0;Stadt Konstanz, Amt für Stadtplanung und Umwelt
04.05.2022 20:00;511;235;276;Leichter Regenschauer;11;11;0.2;Stadt Konstanz, Amt für Stadtplanung und Umwelt
04.05.2022 21:00;478;225;253;Leichter Regenschauer;10;9;0.3;Stadt Konstanz, Amt für Stadtplanung und Umwelt
04.05.2022 22:00;264;117;147;Leichter Regenschauer;9;9;0.1;Stadt Konstanz, Amt für Stadtplanung und Umwelt
04.05.2022 23:00;189;61;128;Leichter Regenschauer;9;9;0.2;Stadt Konstanz, Amt für Stadtplanung und Umwelt
05.05.2022 00:00;120;31;89;Leichter Regenschauer;9;9;0.3;Stadt Konstanz, Amt für Stadtplanung und Umwelt
05.05.2022 01:00;47;16;31;Leichter Regenschauer;9;10;0.2;Stadt Konstanz, Amt für Stadtplanung und Umwelt
05.05.2022 02:00;24;15;9;Leichter Regenschauer;10;10;0.1;Stadt Konstanz, Amt für Stadtplanung und Umwelt
05.05.2022 03:00;21;15;6;Leichter Regenschauer;10;10;0.1;Stadt Konstanz, Amt für Stadtplanung und Umwelt
05.05.2022 04:00;23;18;5;Leichter Regenschauer;10;10;0;Stadt Konstanz, Amt für Stadtplanung und Umwelt
05.05.2022 05:00;52;39;13;Leichter Regenschauer;10;10;0.3;Stadt Konstanz, Amt für Stadtplanung und Umwelt
05.05.2022 06:00;183;102;81;Leichter Regenschauer;10;10;0.4;Stadt Konstanz, Amt für Stadtplanung und Umwelt
05.05.2022 07:00;990;609;381;Leichter Regenschauer;10;10;0.2;Stadt Konstanz, Amt für Stadtplanung und Umwelt
05.05.2022 08:00;801;424;377;Leicht bewoelkt;11;10;0;Stadt Konstanz, Amt für Stadtplanung und Umwelt
05.05.2022 09:00;796;462;334;Leicht bewoelkt;11;10;0;Stadt Konstanz, Amt für Stadtplanung und Umwelt
05.05.2022 10:00;452;268;184;Leicht bewoelkt;12;12;0;Stadt Konstanz, Amt für Stadtplanung und Umwelt
05.05.2022 11:00;618;332;286;Stellenweiser Regenfall;13;13;0.2;Stadt Konstanz, Amt für Stadtplanung und Umwelt
05.05.2022 12:00;725;316;409;Stellenweiser Regenfall;15;15;0.3;Stadt Konstanz, Amt für Stadtplanung und Umwelt
05.05.2022 13:00;937;435;502;Stellenweiser Regenfall;15;15;0.2;Stadt Konstanz, Amt für Stadtplanung und Umwelt
05.05.2022 14:00;657;325;332;Nieselregen mit Gewitter;15;15;0.1;Stadt Konstanz, Amt für Stadtplanung und Umwelt
05.05.2022 15:00;955;469;486;Nieselregen mit Gewitter;15;15;0.2;Stadt Konstanz, Amt für Stadtplanung und Umwelt
05.05.2022 16:00;881;416;465;Nieselregen mit Gewitter;15;15;0.1;Stadt Konstanz, Amt für Stadtplanung und Umwelt
05.05.2022 17:00;1108;495;613;Stellenweiser Regenfall;14;15;0.2;Stadt Konstanz, Amt für Stadtplanung und Umwelt
05.05.2022 18:00;815;357;458;Stellenweiser Regenfall;14;15;0.3;Stadt Konstanz, Amt für Stadtplanung und Umwelt
05.05.2022 19:00;410;153;257;Stellenweiser Regenfall;12;13;0.2;Stadt Konstanz, Amt für Stadtplanung und Umwelt
05.05.2022 20:00;253;102;151;Stellenweiser Regenfall;10;10;0;Stadt Konstanz, Amt für Stadtplanung und Umwelt
05.05.2022 21:00;186;91;95;Stellenweiser Regenfall;7;7;0;Stadt Konstanz, Amt für Stadtplanung und Umwelt
05.05.2022 22:00;139;50;89;Stellenweiser Regenfall;8;8;0;Stadt Konstanz, Amt für Stadtplanung und Umwelt
05.05.2022 23:00;90;33;57;Nieselregen;8;8;0.2;Stadt Konstanz, Amt für Stadtplanung und Umwelt
06.05.2022 00:00;31;11;20;Nieselregen;8;8;0.4;Stadt Konstanz, Amt für Stadtplanung und Umwelt
06.05.2022 01:00;22;4;18;Nieselregen;8;8;0.2;Stadt Konstanz, Amt für Stadtplanung und Umwelt
06.05.2022 02:00;17;10;7;Nieselregen;8;8;0.1;Stadt Konstanz, Amt für Stadtplanung und Umwelt
06.05.2022 03:00;5;3;2;Nieselregen;8;9;0.2;Stadt Konstanz, Amt für Stadtplanung und Umwelt
06.05.2022 04:00;4;4;0;Nieselregen;8;8;0.1;Stadt Konstanz, Amt für Stadtplanung und Umwelt
06.05.2022 05:00;40;27;13;Nieselregen;8;8;0.2;Stadt Konstanz, Amt für Stadtplanung und Umwelt
06.05.2022 06:00;146;92;54;Nieselregen;8;8;0.3;Stadt Konstanz, Amt für Stadtplanung und Umwelt
06.05.2022 07:00;708;406;302;Nieselregen;9;9;0.2;Stadt Konstanz, Amt für Stadtplanung und Umwelt
06.05.2022 08:00;633;362;271;Leichter Regenfall;9;9;0.3;Stadt Konstanz, Amt für Stadtplanung und Umwelt
06.05.2022 09:00;444;263;181;Leichter Regenfall;9;9;0.4;Stadt Konstanz, Amt für Stadtplanung und Umwelt
06.05.2022 10:00;312;166;146;Leichter Regenfall;10;10;0.2;Stadt Konstanz, Amt für Stadtplanung und Umwelt
06.05.2022 11:00;421;227;194;Nieselregen;10;10;0.2;Stadt Konstanz, Amt für Stadtplanung und Umwelt
06.05.2022 12:00;553;277;276;Nieselregen;10;10;0.3;Stadt Konstanz, Amt für Stadtplanung und Umwelt
06.05.2022 13:00;774;317;457;Nieselregen;10;10;0.1;Stadt Konstanz, Amt für Stadtplanung und Umwelt
06.05.2022 14:00;576;321;255;Nieselregen;10;10;0.1;Stadt Konstanz, Amt für Stadtplanung und Umwelt
06.05.2022 15:00;682;310;372;Nieselregen;10;10;0.1;Stadt Konstanz, Amt für Stadtplanung und Umwelt
06.05.2022 16:00;594;296;298;Nieselregen;10;10;0.1;Stadt Konstanz, Amt für Stadtplanung und Umwelt
06.05.2022 17:00;675;309;366;Leichter Regenschauer;10;10;0.1;Stadt Konstanz, Amt für Stadtplanung und Umwelt
06.05.2022 18:00;605;275;330;Leichter Regenschauer;11;11;0.1;Stadt Konstanz, Amt für Stadtplanung und Umwelt
06.05.2022 19:00;530;235;295;Leichter Regenschauer;10;10;0;Stadt Konstanz, Amt für Stadtplanung und Umwelt
06.05.2022 20:00;355;164;191;Leichter Nebel;9;9;0;Stadt Konstanz, Amt für Stadtplanung und Umwelt
06.05.2022 21:00;288;142;146;Leichter Nebel;8;8;0;Stadt Konstanz, Amt für Stadtplanung und Umwelt
06.05.2022 22:00;196;64;132;Leichter Nebel;8;8;0;Stadt Konstanz, Amt für Stadtplanung und Umwelt
06.05.2022 23:00;178;76;102;Bedeckt;9;9;0;Stadt Konstanz, Amt für Stadtplanung und Umwelt
07.05.2022 00:00;161;53;108;Bedeckt;9;9;0;Stadt Konstanz, Amt für Stadtplanung und Umwelt
07.05.2022 01:00;109;45;64;Bedeckt;9;9;0;Stadt Konstanz, Amt für Stadtplanung und Umwelt
07.05.2022 02:00;86;34;52;Leicht bewoelkt;8;8;0;Stadt Konstanz, Amt für Stadtplanung und Umwelt
07.05.2022 03:00;50;25;25;Leicht bewoelkt;8;8;0;Stadt Konstanz, Amt für Stadtplanung und Umwelt
07.05.2022 04:00;46;36;10;Leicht bewoelkt;9;9;0;Stadt Konstanz, Amt für Stadtplanung und Umwelt
07.05.2022 05:00;41;27;14;Leicht bewoelkt;9;9;0;Stadt Konstanz, Amt für Stadtplanung und Umwelt
07.05.2022 06:00;59;34;25;Leicht bewoelkt;9;9;0;Stadt Konstanz, Amt für Stadtplanung und Umwelt
07.05.2022 07:00;67;25;42;Leicht bewoelkt;11;11;0;Stadt Konstanz, Amt für Stadtplanung und Umwelt
07.05.2022 08:00;212;116;96;Leicht bewoelkt;12;12;0;Stadt Konstanz, Amt für Stadtplanung und Umwelt
07.05.2022 09:00;404;246;158;Leicht bewoelkt;14;14;0;Stadt Konstanz, Amt für Stadtplanung und Umwelt
07.05.2022 10:00;475;270;205;Leicht bewoelkt;15;15;0;Stadt Konstanz, Amt für Stadtplanung und Umwelt
07.05.2022 11:00;560;294;266;Leicht bewoelkt;16;16;0;Stadt Konstanz, Amt für Stadtplanung und Umwelt
07.05.2022 12:00;662;357;305;Leicht bewoelkt;18;18;0;Stadt Konstanz, Amt für Stadtplanung und Umwelt
07.05.2022 13:00;678;348;330;Leicht bewoelkt;18;18;0;Stadt Konstanz, Amt für Stadtplanung und Umwelt
07.05.2022 14:00;644;282;362;Stellenweiser Regenfall;18;18;0;Stadt Konstanz, Amt für Stadtplanung und Umwelt
07.05.2022 15:00;610;273;337;Stellenweiser Regenfall;18;18;0;Stadt Konstanz, Amt für Stadtplanung und Umwelt
07.05.2022 16:00;384;187;197;Stellenweiser Regenfall;17;17;0;Stadt Konstanz, Amt für Stadtplanung und Umwelt
07.05.2022 17:00;467;198;269;Stellenweiser Regenfall;17;17;0;Stadt Konstanz, Amt für Stadtplanung und Umwelt
07.05.2022 18:00;454;205;249;Stellenweiser Regenfall;16;16;0;Stadt Konstanz, Amt für Stadtplanung und Umwelt
07.05.2022 19:00;375;189;186;Stellenweiser Regenfall;14;13;0;Stadt Konstanz, Amt für Stadtplanung und Umwelt
07.05.2022 20:00;275;142;133;Sonnig;12;11;0;Stadt Konstanz, Amt für Stadtplanung und Umwelt
07.05.2022 21:00;242;112;130;Sonnig;10;8;0;Stadt Konstanz, Amt für Stadtplanung und Umwelt
07.05.2022 22:00;188;72;116;Sonnig;9;8;0;Stadt Konstanz, Amt für Stadtplanung und Umwelt
07.05.2022 23:00;190;89;101;Bewoelkt;9;9;0;Stadt Konstanz, Amt für Stadtplanung und Umwelt
08.05.2022 00:00;150;53;97;Bewoelkt;9;9;0;Stadt Konstanz, Amt für Stadtplanung und Umwelt
08.05.2022 01:00;119;32;87;Bewoelkt;8;8;0;Stadt Konstanz, Amt für Stadtplanung und Umwelt
08.05.2022 02:00;66;17;49;Leichter Nebel;8;8;0;Stadt Konstanz, Amt für Stadtplanung und Umwelt
08.05.2022 03:00;66;29;37;Leichter Nebel;8;8;0;Stadt Konstanz, Amt für Stadtplanung und Umwelt
08.05.2022 04:00;41;17;24;Leichter Nebel;8;8;0;Stadt Konstanz, Amt für Stadtplanung und Umwelt
08.05.2022 05:00;34;18;16;Leichter Nebel;9;9;0;Stadt Konstanz, Amt für Stadtplanung und Umwelt
08.05.2022 06:00;26;16;10;Leichter Nebel;9;9;0;Stadt Konstanz, Amt für Stadtplanung und Umwelt
08.05.2022 07:00;40;16;24;Leichter Nebel;11;10;0;Stadt Konstanz, Amt für Stadtplanung und Umwelt
08.05.2022 08:00;85;47;38;Bedeckt;12;12;0;Stadt Konstanz, Amt für Stadtplanung und Umwelt
08.05.2022 09:00;210;102;108;Bedeckt;14;13;0;Stadt Konstanz, Amt für Stadtplanung und Umwelt
08.05.2022 10:00;243;129;114;Bedeckt;15;15;0;Stadt Konstanz, Amt für Stadtplanung und Umwelt
08.05.2022 11:00;414;222;192;Leicht bewoelkt;17;17;0;Stadt Konstanz, Amt für Stadtplanung und Umwelt
08.05.2022 12:00;391;184;207;Leicht bewoelkt;19;19;0;Stadt Konstanz, Amt für Stadtplanung und Umwelt
08.05.2022 13:00;412;192;220;Leicht bewoelkt;19;19;0;Stadt Konstanz, Amt für Stadtplanung und Umwelt
08.05.2022 14:00;506;278;228;Stellenweiser Regenfall;19;19;0;Stadt Konstanz, Amt für Stadtplanung und Umwelt
08.05.2022 15:00;579;288;291;Stellenweiser Regenfall;19;19;0;Stadt Konstanz, Amt für Stadtplanung und Umwelt
08.05.2022 16:00;510;257;253;Stellenweiser Regenfall;19;19;0;Stadt Konstanz, Amt für Stadtplanung und Umwelt
08.05.2022 17:00;493;236;257;Stellenweiser Regenfall;18;18;0;Stadt Konstanz, Amt für Stadtplanung und Umwelt
08.05.2022 18:00;414;176;238;Stellenweiser Regenfall;18;18;0;Stadt Konstanz, Amt für Stadtplanung und Umwelt
08.05.2022 19:00;348;172;176;Stellenweiser Regenfall;16;15;0;Stadt Konstanz, Amt für Stadtplanung und Umwelt
08.05.2022 20:00;261;109;152;Leicht bewoelkt;13;13;0;Stadt Konstanz, Amt für Stadtplanung und Umwelt
08.05.2022 21:00;202;90;112;Leicht bewoelkt;11;10;0;Stadt Konstanz, Amt für Stadtplanung und Umwelt
08.05.2022 22:00;127;54;73;Leicht bewoelkt;10;9;0;Stadt Konstanz, Amt für Stadtplanung und Umwelt
08.05.2022 23:00;80;30;50;Leichter Nebel;9;8;0;Stadt Konstanz, Amt für Stadtplanung und Umwelt
09.05.2022 00:00;29;13;16;Leichter Nebel;8;7;0;Stadt Konstanz, Amt für Stadtplanung und Umwelt
09.05.2022 01:00;15;10;5;Leichter Nebel;8;7;0;Stadt Konstanz, Amt für Stadtplanung und Umwelt
09.05.2022 02:00;5;3;2;Leichter Nebel;7;7;0;Stadt Konstanz, Amt für Stadtplanung und Umwelt
09.05.2022 03:00;3;0;3;Leichter Nebel;7;7;0;Stadt Konstanz, Amt für Stadtplanung und Umwelt
09.05.2022 04:00;14;8;6;Leichter Nebel;7;7;0;Stadt Konstanz, Amt für Stadtplanung und Umwelt
09.05.2022 05:00;65;45;20;Leichter Nebel;8;7;0;Stadt Konstanz, Amt für Stadtplanung und Umwelt
09.05.2022 06:00;185;100;85;Leichter Nebel;8;7;0;Stadt Konstanz, Amt für Stadtplanung und Umwelt
09.05.2022 07:00;1078;664;414;Leichter Nebel;10;10;0;Stadt Konstanz, Amt für Stadtplanung und Umwelt
09.05.2022 08:00;837;478;359;Leicht bewoelkt;12;12;0;Stadt Konstanz, Amt für Stadtplanung und Umwelt
09.05.2022 09:00;815;483;332;Leicht bewoelkt;15;15;0;Stadt Konstanz, Amt für Stadtplanung und Umwelt
09.05.2022 10:00;481;255;226;Leicht bewoelkt;16;15;0;Stadt Konstanz, Amt für Stadtplanung und Umwelt
09.05.2022 11:00;661;319;342;Leicht bewoelkt;17;16;0;Stadt Konstanz, Amt für Stadtplanung und Umwelt
09.05.2022 12:00;708;327;381;Leicht bewoelkt;17;17;0;Stadt Konstanz, Amt für Stadtplanung und Umwelt
09.05.2022 13:00;1150;488;662;Leicht bewoelkt;18;18;0;Stadt Konstanz, Amt für Stadtplanung und Umwelt
09.05.2022 14:00;759;388;371;Leicht bewoelkt;19;19;0;Stadt Konstanz, Amt für Stadtplanung und Umwelt
09.05.2022 15:00;1098;500;598;Leicht bewoelkt;19;19;0;Stadt Konstanz, Amt für Stadtplanung und Umwelt
09.05.2022 16:00;1053;500;553;Leicht bewoelkt;18;18;0;Stadt Konstanz, Amt für Stadtplanung und Umwelt
09.05.2022 17:00;1178;594;584;Stellenweiser Regenfall;18;18;0;Stadt Konstanz, Amt für Stadtplanung und Umwelt
09.05.2022 18:00;1051;526;525;Stellenweiser Regenfall;17;17;0;Stadt Konstanz, Amt für Stadtplanung und Umwelt
09.05.2022 19:00;774;362;412;Stellenweiser Regenfall;15;15;0;Stadt Konstanz, Amt für Stadtplanung und Umwelt
09.05.2022 20:00;587;244;343;Sonnig;13;13;0;Stadt Konstanz, Amt für Stadtplanung und Umwelt
09.05.2022 21:00;391;159;232;Sonnig;11;11;0;Stadt Konstanz, Amt für Stadtplanung und Umwelt
09.05.2022 22:00;256;105;151;Sonnig;10;10;0;Stadt Konstanz, Amt für Stadtplanung und Umwelt
09.05.2022 23:00;119;43;76;Leicht bewoelkt;10;10;0;Stadt Konstanz, Amt für Stadtplanung und Umwelt
10.05.2022 00:00;87;32;55;Leicht bewoelkt;9;9;0;Stadt Konstanz, Amt für Stadtplanung und Umwelt
10.05.2022 01:00;37;18;19;Leicht bewoelkt;9;9;0;Stadt Konstanz, Amt für Stadtplanung und Umwelt
10.05.2022 02:00;20;12;8;Leicht bewoelkt;8;8;0;Stadt Konstanz, Amt für Stadtplanung und Umwelt
10.05.2022 03:00;11;5;6;Leicht bewoelkt;8;8;0;Stadt Konstanz, Amt für Stadtplanung und Umwelt
10.05.2022 04:00;8;7;1;Leicht bewoelkt;8;8;0;Stadt Konstanz, Amt für Stadtplanung und Umwelt
10.05.2022 05:00;53;39;14;Sonnig;9;9;0;Stadt Konstanz, Amt für Stadtplanung und Umwelt
10.05.2022 06:00;241;125;116;Sonnig;9;9;0;Stadt Konstanz, Amt für Stadtplanung und Umwelt
10.05.2022 07:00;1107;667;440;Sonnig;12;12;0;Stadt Konstanz, Amt für Stadtplanung und Umwelt
10.05.2022 08:00;972;549;423;Sonnig;14;14;0;Stadt Konstanz, Amt für Stadtplanung und Umwelt
10.05.2022 09:00;889;521;368;Sonnig;16;16;0;Stadt Konstanz, Amt für Stadtplanung und Umwelt
10.05.2022 10:00;645;344;301;Sonnig;18;18;0;Stadt Konstanz, Amt für Stadtplanung und Umwelt
10.05.2022 11:00;848;410;438;Sonnig;19;19;0;Stadt Konstanz, Amt für Stadtplanung und Umwelt
10.05.2022 12:00;843;353;490;Sonnig;21;21;0;Stadt Konstanz, Amt für Stadtplanung und Umwelt
10.05.2022 13:00;1081;536;545;Sonnig;21;21;0;Stadt Konstanz, Amt für Stadtplanung und Umwelt
10.05.2022 14:00;907;503;404;Sonnig;22;22;0;Stadt Konstanz, Amt für Stadtplanung und Umwelt
10.05.2022 15:00;1258;597;661;Sonnig;22;25;0;Stadt Konstanz, Amt für Stadtplanung und Umwelt
10.05.2022 16:00;1127;531;596;Sonnig;22;22;0;Stadt Konstanz, Amt für Stadtplanung und Umwelt
10.05.2022 17:00;1388;663;725;Sonnig;21;21;0;Stadt Konstanz, Amt für Stadtplanung und Umwelt
10.05.2022 18:00;1204;559;645;Sonnig;20;20;0;Stadt Konstanz, Amt für Stadtplanung und Umwelt
10.05.2022 19:00;897;419;478;Sonnig;18;18;0;Stadt Konstanz, Amt für Stadtplanung und Umwelt
10.05.2022 20:00;610;242;368;Leicht bewoelkt;16;16;0;Stadt Konstanz, Amt für Stadtplanung und Umwelt
10.05.2022 21:00;458;182;276;Leicht bewoelkt;13;13;0;Stadt Konstanz, Amt für Stadtplanung und Umwelt
10.05.2022 22:00;326;144;182;Leicht bewoelkt;12;12;0;Stadt Konstanz, Amt für Stadtplanung und Umwelt
10.05.2022 23:00;157;54;103;Leicht bewoelkt;12;12;0;Stadt Konstanz, Amt für Stadtplanung und Umwelt
11.05.2022 00:00;90;29;61;Leicht bewoelkt;11;11;0;Stadt Konstanz, Amt für Stadtplanung und Umwelt
11.05.2022 01:00;37;19;18;Leicht bewoelkt;11;11;0;Stadt Konstanz, Amt für Stadtplanung und Umwelt
11.05.2022 02:00;28;8;20;Sonnig;10;11;0;Stadt Konstanz, Amt für Stadtplanung und Umwelt
11.05.2022 03:00;9;5;4;Sonnig;10;11;0;Stadt Konstanz, Amt für Stadtplanung und Umwelt
11.05.2022 04:00;6;5;1;Sonnig;11;11;0;Stadt Konstanz, Amt für Stadtplanung und Umwelt
11.05.2022 05:00;71;51;20;Sonnig;11;11;0;Stadt Konstanz, Amt für Stadtplanung und Umwelt
11.05.2022 06:00;223;119;104;Sonnig;11;11;0;Stadt Konstanz, Amt für Stadtplanung und Umwelt
11.05.2022 07:00;1234;774;460;Sonnig;14;14;0;Stadt Konstanz, Amt für Stadtplanung und Umwelt
11.05.2022 08:00;959;528;431;Sonnig;17;17;0;Stadt Konstanz, Amt für Stadtplanung und Umwelt
11.05.2022 09:00;919;529;390;Sonnig;20;20;0;Stadt Konstanz, Amt für Stadtplanung und Umwelt
11.05.2022 10:00;606;325;281;Sonnig;21;21;0;Stadt Konstanz, Amt für Stadtplanung und Umwelt
11.05.2022 11:00;848;376;472;Sonnig;22;23;0;Stadt Konstanz, Amt für Stadtplanung und Umwelt
11.05.2022 12:00;908;430;478;Sonnig;23;25;0;Stadt Konstanz, Amt für Stadtplanung und Umwelt
11.05.2022 13:00;1147;539;608;Sonnig;24;25;0;Stadt Konstanz, Amt für Stadtplanung und Umwelt
11.05.2022 14:00;932;494;438;Sonnig;24;25;0;Stadt Konstanz, Amt für Stadtplanung und Umwelt
11.05.2022 15:00;1284;572;712;Sonnig;25;25;0;Stadt Konstanz, Amt für Stadtplanung und Umwelt
11.05.2022 16:00;1143;557;586;Sonnig;24;25;0;Stadt Konstanz, Amt für Stadtplanung und Umwelt
11.05.2022 17:00;1409;664;745;Leicht bewoelkt;23;25;0;Stadt Konstanz, Amt für Stadtplanung und Umwelt
11.05.2022 18:00;1197;560;637;Leicht bewoelkt;23;25;0;Stadt Konstanz, Amt für Stadtplanung und Umwelt
11.05.2022 19:00;920;459;461;Leicht bewoelkt;20;20;0;Stadt Konstanz, Amt für Stadtplanung und Umwelt
11.05.2022 20:00;742;378;364;Stellenweiser Regenfall;17;17;0;Stadt Konstanz, Amt für Stadtplanung und Umwelt
11.05.2022 21:00;649;306;343;Stellenweiser Regenfall;14;15;0;Stadt Konstanz, Amt für Stadtplanung und Umwelt
11.05.2022 22:00;443;165;278;Stellenweiser Regenfall;14;14;0;Stadt Konstanz, Amt für Stadtplanung und Umwelt
11.05.2022 23:00;220;62;158;Sonnig;13;13;0;Stadt Konstanz, Amt für Stadtplanung und Umwelt
12.05.2022 00:00;153;41;112;Sonnig;12;12;0;Stadt Konstanz, Amt für Stadtplanung und Umwelt
12.05.2022 01:00;48;10;38;Sonnig;12;12;0;Stadt Konstanz, Amt für Stadtplanung und Umwelt
12.05.2022 02:00;15;8;7;Sonnig;12;11;0;Stadt Konstanz, Amt für Stadtplanung und Umwelt
12.05.2022 03:00;12;9;3;Sonnig;11;11;0;Stadt Konstanz, Amt für Stadtplanung und Umwelt
12.05.2022 04:00;11;6;5;Sonnig;12;12;0;Stadt Konstanz, Amt für Stadtplanung und Umwelt
12.05.2022 05:00;62;40;22;Sonnig;12;12;0;Stadt Konstanz, Amt für Stadtplanung und Umwelt
12.05.2022 06:00;216;118;98;Sonnig;13;13;0;Stadt Konstanz, Amt für Stadtplanung und Umwelt
12.05.2022 07:00;1087;676;411;Sonnig;15;15;0;Stadt Konstanz, Amt für Stadtplanung und Umwelt
12.05.2022 08:00;936;502;434;Sonnig;17;17;0;Stadt Konstanz, Amt für Stadtplanung und Umwelt
12.05.2022 09:00;931;530;401;Sonnig;19;19;0;Stadt Konstanz, Amt für Stadtplanung und Umwelt
12.05.2022 10:00;648;380;268;Sonnig;20;20;0;Stadt Konstanz, Amt für Stadtplanung und Umwelt
12.05.2022 11:00;777;354;423;Sonnig;21;21;0;Stadt Konstanz, Amt für Stadtplanung und Umwelt
12.05.2022 12:00;738;354;384;Sonnig;22;25;0;Stadt Konstanz, Amt für Stadtplanung und Umwelt
12.05.2022 13:00;1111;509;602;Sonnig;23;25;0;Stadt Konstanz, Amt für Stadtplanung und Umwelt
12.05.2022 14:00;885;452;433;Sonnig;23;25;0;Stadt Konstanz, Amt für Stadtplanung und Umwelt
12.05.2022 15:00;1215;586;629;Sonnig;24;25;0;Stadt Konstanz, Amt für Stadtplanung und Umwelt
12.05.2022 16:00;1103;528;575;Sonnig;24;25;0;Stadt Konstanz, Amt für Stadtplanung und Umwelt
12.05.2022 17:00;1365;631;734;Sonnig;23;25;0;Stadt Konstanz, Amt für Stadtplanung und Umwelt
12.05.2022 18:00;1157;539;618;Sonnig;23;25;0;Stadt Konstanz, Amt für Stadtplanung und Umwelt
12.05.2022 19:00;846;369;477;Sonnig;20;20;0;Stadt Konstanz, Amt für Stadtplanung und Umwelt
12.05.2022 20:00;592;254;338;Stellenweiser Regenfall;17;18;0.1;Stadt Konstanz, Amt für Stadtplanung und Umwelt
12.05.2022 21:00;457;207;250;Stellenweiser Regenfall;14;15;0.1;Stadt Konstanz, Amt für Stadtplanung und Umwelt
12.05.2022 22:00;280;109;171;Stellenweiser Regenfall;14;14;0;Stadt Konstanz, Amt für Stadtplanung und Umwelt
12.05.2022 23:00;184;82;102;Leichter Regenschauer;13;14;0.3;Stadt Konstanz, Amt für Stadtplanung und Umwelt
13.05.2022 00:00;99;43;56;Leichter Regenschauer;13;13;0.5;Stadt Konstanz, Amt für Stadtplanung und Umwelt
13.05.2022 01:00;63;24;39;Leichter Regenschauer;13;13;0.3;Stadt Konstanz, Amt für Stadtplanung und Umwelt
13.05.2022 02:00;22;12;10;Leichter Regenschauer;13;13;0.1;Stadt Konstanz, Amt für Stadtplanung und Umwelt
13.05.2022 03:00;8;0;8;Leichter Regenschauer;13;13;0.2;Stadt Konstanz, Amt für Stadtplanung und Umwelt
13.05.2022 04:00;9;8;1;Leichter Regenschauer;14;14;0.1;Stadt Konstanz, Amt für Stadtplanung und Umwelt
13.05.2022 05:00;42;27;15;Stellenweiser Regenfall;14;14;0.1;Stadt Konstanz, Amt für Stadtplanung und Umwelt
13.05.2022 06:00;178;114;64;Stellenweiser Regenfall;14;14;0.1;Stadt Konstanz, Amt für Stadtplanung und Umwelt
13.05.2022 07:00;978;568;410;Stellenweiser Regenfall;15;15;0;Stadt Konstanz, Amt für Stadtplanung und Umwelt
13.05.2022 08:00;719;392;327;Leichter Regenschauer;16;16;0.1;Stadt Konstanz, Amt für Stadtplanung und Umwelt
13.05.2022 09:00;640;386;254;Leichter Regenschauer;18;18;0.2;Stadt Konstanz, Amt für Stadtplanung und Umwelt
13.05.2022 10:00;531;281;250;Leichter Regenschauer;19;19;0.1;Stadt Konstanz, Amt für Stadtplanung und Umwelt
13.05.2022 11:00;664;306;358;Stellenweiser Regenfall;20;20;0.1;Stadt Konstanz, Amt für Stadtplanung und Umwelt
13.05.2022 12:00;841;420;421;Stellenweiser Regenfall;21;21;0.2;Stadt Konstanz, Amt für Stadtplanung und Umwelt
13.05.2022 13:00;1080;418;662;Stellenweiser Regenfall;21;21;0.1;Stadt Konstanz, Amt für Stadtplanung und Umwelt
13.05.2022 14:00;790;370;420;Leichter Regenschauer;21;21;0.3;Stadt Konstanz, Amt für Stadtplanung und Umwelt
13.05.2022 15:00;922;408;514;Leichter Regenschauer;21;21;0.4;Stadt Konstanz, Amt für Stadtplanung und Umwelt
13.05.2022 16:00;961;429;532;Leichter Regenschauer;20;20;0.2;Stadt Konstanz, Amt für Stadtplanung und Umwelt
13.05.2022 17:00;975;367;608;Leichter Regenschauer;20;20;0.3;Stadt Konstanz, Amt für Stadtplanung und Umwelt
13.05.2022 18:00;799;324;475;Leichter Regenschauer;19;19;0.4;Stadt Konstanz, Amt für Stadtplanung und Umwelt
13.05.2022 19:00;482;198;284;Leichter Regenschauer;17;17;0.2;Stadt Konstanz, Amt für Stadtplanung und Umwelt
13.05.2022 20:00;392;176;216;Leichter Regenschauer;15;15;0.1;Stadt Konstanz, Amt für Stadtplanung und Umwelt
13.05.2022 21:00;274;112;162;Leichter Regenschauer;13;13;0.1;Stadt Konstanz, Amt für Stadtplanung und Umwelt
13.05.2022 22:00;200;97;103;Leichter Regenschauer;13;13;0.1;Stadt Konstanz, Amt für Stadtplanung und Umwelt
13.05.2022 23:00;275;163;112;Stellenweiser Regenfall;12;13;0.1;Stadt Konstanz, Amt für Stadtplanung und Umwelt
14.05.2022 00:00;285;202;83;Stellenweiser Regenfall;12;13;0.1;Stadt Konstanz, Amt für Stadtplanung und Umwelt
14.05.2022 01:00;155;110;45;Stellenweiser Regenfall;11;12;0.1;Stadt Konstanz, Amt für Stadtplanung und Umwelt
14.05.2022 02:00;88;38;50;Sonnig;11;11;0;Stadt Konstanz, Amt für Stadtplanung und Umwelt
14.05.2022 03:00;51;17;34;Sonnig;10;10;0;Stadt Konstanz, Amt für Stadtplanung und Umwelt
14.05.2022 04:00;32;16;16;Sonnig;10;11;0;Stadt Konstanz, Amt für Stadtplanung und Umwelt
14.05.2022 05:00;34;25;9;Sonnig;11;11;0;Stadt Konstanz, Amt für Stadtplanung und Umwelt
14.05.2022 06:00;51;29;22;Sonnig;11;11;0;Stadt Konstanz, Amt für Stadtplanung und Umwelt
14.05.2022 07:00;79;41;38;Sonnig;13;13;0;Stadt Konstanz, Amt für Stadtplanung und Umwelt
14.05.2022 08:00;280;169;111;Sonnig;15;15;0;Stadt Konstanz, Amt für Stadtplanung und Umwelt
14.05.2022 09:00;496;324;172;Sonnig;18;18;0;Stadt Konstanz, Amt für Stadtplanung und Umwelt
14.05.2022 10:00;706;379;327;Sonnig;19;19;0;Stadt Konstanz, Amt für Stadtplanung und Umwelt
14.05.2022 11:00;816;468;348;Sonnig;20;20;0;Stadt Konstanz, Amt für Stadtplanung und Umwelt
14.05.2022 12:00;867;439;428;Sonnig;22;22;0;Stadt Konstanz, Amt für Stadtplanung und Umwelt
14.05.2022 13:00;948;457;491;Sonnig;22;22;0;Stadt Konstanz, Amt für Stadtplanung und Umwelt
14.05.2022 14:00;1136;491;645;Sonnig;22;25;0;Stadt Konstanz, Amt für Stadtplanung und Umwelt
14.05.2022 15:00;1095;474;621;Sonnig;23;25;0;Stadt Konstanz, Amt für Stadtplanung und Umwelt
14.05.2022 16:00;1080;488;592;Sonnig;22;23;0;Stadt Konstanz, Amt für Stadtplanung und Umwelt
14.05.2022 17:00;1015;441;574;Sonnig;22;22;0;Stadt Konstanz, Amt für Stadtplanung und Umwelt
14.05.2022 18:00;715;321;394;Sonnig;21;21;0;Stadt Konstanz, Amt für Stadtplanung und Umwelt
14.05.2022 19:00;608;312;296;Sonnig;18;18;0;Stadt Konstanz, Amt für Stadtplanung und Umwelt
14.05.2022 20:00;500;213;287;Sonnig;16;16;0;Stadt Konstanz, Amt für Stadtplanung und Umwelt
14.05.2022 21:00;402;137;265;Sonnig;13;13;0;Stadt Konstanz, Amt für Stadtplanung und Umwelt
14.05.2022 22:00;347;113;234;Sonnig;13;12;0;Stadt Konstanz, Amt für Stadtplanung und Umwelt
14.05.2022 23:00;375;203;172;Sonnig;12;12;0;Stadt Konstanz, Amt für Stadtplanung und Umwelt
15.05.2022 00:00;396;249;147;Sonnig;11;11;0;Stadt Konstanz, Amt für Stadtplanung und Umwelt
15.05.2022 01:00;247;153;94;Sonnig;10;11;0;Stadt Konstanz, Amt für Stadtplanung und Umwelt
15.05.2022 02:00;136;73;63;Sonnig;10;10;0;Stadt Konstanz, Amt für Stadtplanung und Umwelt
15.05.2022 03:00;87;58;29;Sonnig;10;10;0;Stadt Konstanz, Amt für Stadtplanung und Umwelt
15.05.2022 04:00;64;38;26;Sonnig;10;10;0;Stadt Konstanz, Amt für Stadtplanung und Umwelt
15.05.2022 05:00;35;22;13;Sonnig;10;10;0;Stadt Konstanz, Amt für Stadtplanung und Umwelt
15.05.2022 06:00;45;26;19;Sonnig;11;11;0;Stadt Konstanz, Amt für Stadtplanung und Umwelt
15.05.2022 07:00;72;36;36;Sonnig;13;13;0;Stadt Konstanz, Amt für Stadtplanung und Umwelt
15.05.2022 08:00;115;41;74;Sonnig;16;16;0;Stadt Konstanz, Amt für Stadtplanung und Umwelt
15.05.2022 09:00;312;162;150;Sonnig;19;19;0;Stadt Konstanz, Amt für Stadtplanung und Umwelt
15.05.2022 10:00;464;208;256;Sonnig;20;20;0;Stadt Konstanz, Amt für Stadtplanung und Umwelt
15.05.2022 11:00;500;235;265;Sonnig;21;21;0;Stadt Konstanz, Amt für Stadtplanung und Umwelt
15.05.2022 12:00;616;309;307;Sonnig;23;25;0;Stadt Konstanz, Amt für Stadtplanung und Umwelt
15.05.2022 13:00;734;362;372;Sonnig;23;25;0;Stadt Konstanz, Amt für Stadtplanung und Umwelt
15.05.2022 14:00;780;407;373;Sonnig;23;25;0;Stadt Konstanz, Amt für Stadtplanung und Umwelt
15.05.2022 15:00;713;383;330;Sonnig;24;25;0;Stadt Konstanz, Amt für Stadtplanung und Umwelt
15.05.2022 16:00;733;369;364;Sonnig;23;25;0;Stadt Konstanz, Amt für Stadtplanung und Umwelt
15.05.2022 17:00;661;350;311;Sonnig;22;25;0;Stadt Konstanz, Amt für Stadtplanung und Umwelt
15.05.2022 18:00;726;360;366;Sonnig;21;21;0;Stadt Konstanz, Amt für Stadtplanung und Umwelt
15.05.2022 19:00;599;288;311;Sonnig;19;19;0;Stadt Konstanz, Amt für Stadtplanung und Umwelt
15.05.2022 20:00;423;168;255;Stellenweiser Regenfall;17;18;0;Stadt Konstanz, Amt für Stadtplanung und Umwelt
15.05.2022 21:00;314;133;181;Stellenweiser Regenfall;15;16;0;Stadt Konstanz, Amt für Stadtplanung und Umwelt
15.05.2022 22:00;178;77;101;Stellenweiser Regenfall;14;15;0;Stadt Konstanz, Amt für Stadtplanung und Umwelt
15.05.2022 23:00;63;22;41;Sonnig;13;14;0;Stadt Konstanz, Amt für Stadtplanung und Umwelt
16.05.2022 00:00;32;20;12;Sonnig;13;13;0;Stadt Konstanz, Amt für Stadtplanung und Umwelt
16.05.2022 01:00;10;8;2;Sonnig;12;12;0;Stadt Konstanz, Amt für Stadtplanung und Umwelt
16.05.2022 02:00;14;8;6;Stellenweiser Regenfall;12;12;0;Stadt Konstanz, Amt für Stadtplanung und Umwelt
16.05.2022 03:00;3;1;2;Stellenweiser Regenfall;12;12;0;Stadt Konstanz, Amt für Stadtplanung und Umwelt
16.05.2022 04:00;11;9;2;Stellenweiser Regenfall;13;13;0;Stadt Konstanz, Amt für Stadtplanung und Umwelt
16.05.2022 05:00;52;34;18;Stellenweiser Regenfall;13;13;0.1;Stadt Konstanz, Amt für Stadtplanung und Umwelt
16.05.2022 06:00;145;81;64;Stellenweiser Regenfall;13;13;0.1;Stadt Konstanz, Amt für Stadtplanung und Umwelt
16.05.2022 07:00;766;431;335;Stellenweiser Regenfall;16;16;0.1;Stadt Konstanz, Amt für Stadtplanung und Umwelt
16.05.2022 08:00;726;372;354;Leicht bewoelkt;18;18;0;Stadt Konstanz, Amt für Stadtplanung und Umwelt
16.05.2022 09:00;738;412;326;Leicht bewoelkt;20;20;0;Stadt Konstanz, Amt für Stadtplanung und Umwelt
16.05.2022 10:00;514;314;200;Leicht bewoelkt;21;21;0;Stadt Konstanz, Amt für Stadtplanung und Umwelt
16.05.2022 11:00;707;349;358;Nieselregen mit Gewitter;22;23;0.1;Stadt Konstanz, Amt für Stadtplanung und Umwelt
16.05.2022 12:00;649;324;325;Nieselregen mit Gewitter;24;25;0.1;Stadt Konstanz, Amt für Stadtplanung und Umwelt
16.05.2022 13:00;929;458;471;Nieselregen mit Gewitter;24;26;0.1;Stadt Konstanz, Amt für Stadtplanung und Umwelt
16.05.2022 14:00;716;368;348;Sonnig;25;26;0;Stadt Konstanz, Amt für Stadtplanung und Umwelt
16.05.2022 15:00;942;468;474;Sonnig;26;26;0;Stadt Konstanz, Amt für Stadtplanung und Umwelt
16.05.2022 16:00;938;444;494;Sonnig;25;26;0;Stadt Konstanz, Amt für Stadtplanung und Umwelt
16.05.2022 17:00;1090;490;600;Stellenweiser Regenfall;23;25;0;Stadt Konstanz, Amt für Stadtplanung und Umwelt
16.05.2022 18:00;936;443;493;Stellenweiser Regenfall;22;25;0;Stadt Konstanz, Amt für Stadtplanung und Umwelt
16.05.2022 19:00;665;300;365;Stellenweiser Regenfall;19;19;0;Stadt Konstanz, Amt für Stadtplanung und Umwelt
16.05.2022 20:00;442;195;247;Stellenweiser Regenfall;17;17;0.1;Stadt Konstanz, Amt für Stadtplanung und Umwelt
16.05.2022 21:00;337;139;198;Stellenweiser Regenfall;14;14;0.2;Stadt Konstanz, Amt für Stadtplanung und Umwelt
16.05.2022 22:00;174;81;93;Stellenweiser Regenfall;13;13;0.1;Stadt Konstanz, Amt für Stadtplanung und Umwelt
16.05.2022 23:00;91;42;49;Stellenweiser Regenfall;12;12;0.3;Stadt Konstanz, Amt für Stadtplanung und Umwelt
17.05.2022 00:00;45;24;21;Stellenweiser Regenfall;12;12;0.7;Stadt Konstanz, Amt für Stadtplanung und Umwelt
17.05.2022 01:00;20;10;10;Stellenweiser Regenfall;11;11;0.3;Stadt Konstanz, Amt für Stadtplanung und Umwelt
17.05.2022 02:00;9;6;3;Stellenweiser Regenfall;11;11;0.1;Stadt Konstanz, Amt für Stadtplanung und Umwelt
17.05.2022 03:00;6;4;2;Stellenweiser Regenfall;11;11;0.1;Stadt Konstanz, Amt für Stadtplanung und Umwelt
17.05.2022 04:00;12;9;3;Stellenweiser Regenfall;11;11;0;Stadt Konstanz, Amt für Stadtplanung und Umwelt
17.05.2022 05:00;52;35;17;Leichter Nebel;12;12;0;Stadt Konstanz, Amt für Stadtplanung und Umwelt
17.05.2022 06:00;262;145;117;Leichter Nebel;13;13;0;Stadt Konstanz, Amt für Stadtplanung und Umwelt
17.05.2022 07:00;1175;716;459;Leichter Nebel;14;14;0;Stadt Konstanz, Amt für Stadtplanung und Umwelt
17.05.2022 08:00;993;551;442;Leicht bewoelkt;16;16;0;Stadt Konstanz, Amt für Stadtplanung und Umwelt
17.05.2022 09:00;961;552;409;Leicht bewoelkt;18;18;0;Stadt Konstanz, Amt für Stadtplanung und Umwelt
17.05.2022 10:00;653;358;295;Leicht bewoelkt;19;19;0;Stadt Konstanz, Amt für Stadtplanung und Umwelt
17.05.2022 11:00;851;407;444;Bewoelkt;20;20;0;Stadt Konstanz, Amt für Stadtplanung und Umwelt
17.05.2022 12:00;881;359;522;Bewoelkt;21;21;0;Stadt Konstanz, Amt für Stadtplanung und Umwelt
17.05.2022 13:00;1101;508;593;Bewoelkt;21;21;0;Stadt Konstanz, Amt für Stadtplanung und Umwelt
17.05.2022 14:00;850;411;439;Stellenweiser Regenfall;22;22;0;Stadt Konstanz, Amt für Stadtplanung und Umwelt
17.05.2022 15:00;1268;594;674;Stellenweiser Regenfall;22;25;0;Stadt Konstanz, Amt für Stadtplanung und Umwelt
17.05.2022 16:00;1225;603;622;Stellenweiser Regenfall;21;21;0;Stadt Konstanz, Amt für Stadtplanung und Umwelt
17.05.2022 17:00;1351;639;712;Stellenweiser Regenfall;20;20;0.1;Stadt Konstanz, Amt für Stadtplanung und Umwelt
17.05.2022 18:00;1224;527;697;Stellenweiser Regenfall;19;19;0.1;Stadt Konstanz, Amt für Stadtplanung und Umwelt
17.05.2022 19:00;943;474;469;Stellenweiser Regenfall;17;17;0;Stadt Konstanz, Amt für Stadtplanung und Umwelt
17.05.2022 20:00;682;298;384;Bedeckt;16;16;0;Stadt Konstanz, Amt für Stadtplanung und Umwelt
17.05.2022 21:00;455;172;283;Bedeckt;14;14;0;Stadt Konstanz, Amt für Stadtplanung und Umwelt
17.05.2022 22:00;342;133;209;Bedeckt;13;13;0;Stadt Konstanz, Amt für Stadtplanung und Umwelt
17.05.2022 23:00;187;84;103;Sonnig;12;13;0;Stadt Konstanz, Amt für Stadtplanung und Umwelt
18.05.2022 00:00;80;29;51;Sonnig;11;12;0;Stadt Konstanz, Amt für Stadtplanung und Umwelt
18.05.2022 01:00;60;12;48;Sonnig;11;11;0;Stadt Konstanz, Amt für Stadtplanung und Umwelt
18.05.2022 02:00;31;5;26;Sonnig;11;11;0;Stadt Konstanz, Amt für Stadtplanung und Umwelt
18.05.2022 03:00;22;8;14;Sonnig;10;10;0;Stadt Konstanz, Amt für Stadtplanung und Umwelt
18.05.2022 04:00;18;11;7;Sonnig;11;11;0;Stadt Konstanz, Amt für Stadtplanung und Umwelt
18.05.2022 05:00;70;43;27;Sonnig;12;12;0;Stadt Konstanz, Amt für Stadtplanung und Umwelt
18.05.2022 06:00;252;149;103;Sonnig;12;13;0;Stadt Konstanz, Amt für Stadtplanung und Umwelt
18.05.2022 07:00;1217;758;459;Sonnig;15;15;0;Stadt Konstanz, Amt für Stadtplanung und Umwelt
18.05.2022 08:00;1049;601;448;Sonnig;17;17;0;Stadt Konstanz, Amt für Stadtplanung und Umwelt
18.05.2022 09:00;997;583;414;Sonnig;19;19;0;Stadt Konstanz, Amt für Stadtplanung und Umwelt
18.05.2022 10:00;639;310;329;Sonnig;21;21;0;Stadt Konstanz, Amt für Stadtplanung und Umwelt
18.05.2022 11:00;880;405;475;Sonnig;22;22;0;Stadt Konstanz, Amt für Stadtplanung und Umwelt
18.05.2022 12:00;934;413;521;Sonnig;23;25;0;Stadt Konstanz, Amt für Stadtplanung und Umwelt
18.05.2022 13:00;1190;584;606;Sonnig;24;25;0;Stadt Konstanz, Amt für Stadtplanung und Umwelt
18.05.2022 14:00;863;407;456;Sonnig;25;26;0;Stadt Konstanz, Amt für Stadtplanung und Umwelt
18.05.2022 15:00;1245;577;668;Sonnig;26;27;0;Stadt Konstanz, Amt für Stadtplanung und Umwelt
18.05.2022 16:00;1149;552;597;Sonnig;25;26;0;Stadt Konstanz, Amt für Stadtplanung und Umwelt
18.05.2022 17:00;1341;607;734;Sonnig;25;26;0;Stadt Konstanz, Amt für Stadtplanung und Umwelt
18.05.2022 18:00;1178;577;601;Sonnig;24;26;0;Stadt Konstanz, Amt für Stadtplanung und Umwelt
18.05.2022 19:00;907;455;452;Sonnig;21;21;0;Stadt Konstanz, Amt für Stadtplanung und Umwelt
18.05.2022 20:00;786;408;378;Sonnig;18;18;0;Stadt Konstanz, Amt für Stadtplanung und Umwelt
18.05.2022 21:00;582;252;330;Sonnig;15;15;0;Stadt Konstanz, Amt für Stadtplanung und Umwelt
18.05.2022 22:00;370;141;229;Sonnig;14;14;0;Stadt Konstanz, Amt für Stadtplanung und Umwelt
18.05.2022 23:00;185;62;123;Sonnig;13;13;0;Stadt Konstanz, Amt für Stadtplanung und Umwelt
19.05.2022 00:00;225;91;134;Sonnig;13;13;0;Stadt Konstanz, Amt für Stadtplanung und Umwelt
19.05.2022 01:00;60;25;35;Sonnig;12;12;0;Stadt Konstanz, Amt für Stadtplanung und Umwelt
19.05.2022 02:00;35;14;21;Sonnig;12;12;0;Stadt Konstanz, Amt für Stadtplanung und Umwelt
19.05.2022 03:00;17;6;11;Sonnig;12;12;0;Stadt Konstanz, Amt für Stadtplanung und Umwelt
19.05.2022 04:00;13;12;1;Sonnig;13;13;0;Stadt Konstanz, Amt für Stadtplanung und Umwelt
19.05.2022 05:00;61;37;24;Sonnig;13;13;0;Stadt Konstanz, Amt für Stadtplanung und Umwelt
19.05.2022 06:00;238;131;107;Sonnig;14;14;0;Stadt Konstanz, Amt für Stadtplanung und Umwelt
19.05.2022 07:00;1214;746;468;Sonnig;17;17;0;Stadt Konstanz, Amt für Stadtplanung und Umwelt
19.05.2022 08:00;942;506;436;Sonnig;19;19;0;Stadt Konstanz, Amt für Stadtplanung und Umwelt
19.05.2022 09:00;946;522;424;Sonnig;21;21;0;Stadt Konstanz, Amt für Stadtplanung und Umwelt
19.05.2022 10:00;616;329;287;Sonnig;23;26;0;Stadt Konstanz, Amt für Stadtplanung und Umwelt
19.05.2022 11:00;870;434;436;Sonnig;25;27;0;Stadt Konstanz, Amt für Stadtplanung und Umwelt
19.05.2022 12:00;843;384;459;Sonnig;27;28;0;Stadt Konstanz, Amt für Stadtplanung und Umwelt
19.05.2022 13:00;1146;507;639;Sonnig;27;27;0;Stadt Konstanz, Amt für Stadtplanung und Umwelt
19.05.2022 14:00;844;419;425;Stellenweise Gewitter und Niederschlaege;27;27;0;Stadt Konstanz, Amt für Stadtplanung und Umwelt
19.05.2022 15:00;1220;591;629;Stellenweise Gewitter und Niederschlaege;27;27;0;Stadt Konstanz, Amt für Stadtplanung und Umwelt
19.05.2022 16:00;1167;568;599;Stellenweise Gewitter und Niederschlaege;23;24;0;Stadt Konstanz, Amt für Stadtplanung und Umwelt
19.05.2022 17:00;1245;584;661;Stellenweiser Regenfall;20;20;0.1;Stadt Konstanz, Amt für Stadtplanung und Umwelt
19.05.2022 18:00;907;462;445;Stellenweiser Regenfall;17;17;0.1;Stadt Konstanz, Amt für Stadtplanung und Umwelt
19.05.2022 19:00;721;327;394;Stellenweiser Regenfall;16;16;0.1;Stadt Konstanz, Amt für Stadtplanung und Umwelt
19.05.2022 20:00;521;237;284;Leicht bewoelkt;15;15;0;Stadt Konstanz, Amt für Stadtplanung und Umwelt
19.05.2022 21:00;394;185;209;Leicht bewoelkt;14;14;0;Stadt Konstanz, Amt für Stadtplanung und Umwelt
19.05.2022 22:00;309;118;191;Leicht bewoelkt;14;14;0;Stadt Konstanz, Amt für Stadtplanung und Umwelt
19.05.2022 23:00;193;87;106;Stellenweiser Regenfall;14;14;0;Stadt Konstanz, Amt für Stadtplanung und Umwelt
20.05.2022 00:00;95;40;55;Stellenweiser Regenfall;14;14;0.1;Stadt Konstanz, Amt für Stadtplanung und Umwelt
20.05.2022 01:00;52;21;31;Stellenweiser Regenfall;14;14;0;Stadt Konstanz, Amt für Stadtplanung und Umwelt
20.05.2022 02:00;23;9;14;Stellenweiser Regenfall;14;14;0.2;Stadt Konstanz, Amt für Stadtplanung und Umwelt
20.05.2022 03:00;14;6;8;Stellenweiser Regenfall;14;14;0.3;Stadt Konstanz, Amt für Stadtplanung und Umwelt
20.05.2022 04:00;22;15;7;Stellenweiser Regenfall;14;14;0.1;Stadt Konstanz, Amt für Stadtplanung und Umwelt
20.05.2022 05:00;50;38;12;Stellenweiser Regenfall;14;14;0.1;Stadt Konstanz, Amt für Stadtplanung und Umwelt
20.05.2022 06:00;237;134;103;Stellenweiser Regenfall;14;15;0.1;Stadt Konstanz, Amt für Stadtplanung und Umwelt
20.05.2022 07:00;1019;639;380;Stellenweiser Regenfall;17;17;0.1;Stadt Konstanz, Amt für Stadtplanung und Umwelt
20.05.2022 08:00;867;486;381;Sonnig;20;20;0;Stadt Konstanz, Amt für Stadtplanung und Umwelt
20.05.2022 09:00;833;497;336;Sonnig;22;25;0;Stadt Konstanz, Amt für Stadtplanung und Umwelt
20.05.2022 10:00;686;375;311;Sonnig;25;27;0;Stadt Konstanz, Amt für Stadtplanung und Umwelt
20.05.2022 11:00;862;407;455;Sonnig;27;29;0;Stadt Konstanz, Amt für Stadtplanung und Umwelt
20.05.2022 12:00;964;427;537;Sonnig;30;31;0;Stadt Konstanz, Amt für Stadtplanung und Umwelt
20.05.2022 13:00;1148;485;663;Sonnig;30;31;0;Stadt Konstanz, Amt für Stadtplanung und Umwelt
20.05.2022 14:00;877;422;455;Sonnig;31;32;0;Stadt Konstanz, Amt für Stadtplanung und Umwelt
20.05.2022 15:00;907;408;499;Sonnig;32;32;0;Stadt Konstanz, Amt für Stadtplanung und Umwelt
20.05.2022 16:00;889;453;436;Sonnig;30;31;0;Stadt Konstanz, Amt für Stadtplanung und Umwelt
20.05.2022 17:00;977;486;491;Stellenweise Gewitter und Niederschlaege;28;29;0;Stadt Konstanz, Amt für Stadtplanung und Umwelt
20.05.2022 18:00;854;427;427;Stellenweise Gewitter und Niederschlaege;26;27;0;Stadt Konstanz, Amt für Stadtplanung und Umwelt
20.05.2022 19:00;832;439;393;Stellenweise Gewitter und Niederschlaege;23;24;0;Stadt Konstanz, Amt für Stadtplanung und Umwelt
20.05.2022 20:00;582;273;309;Sonnig;21;21;0;Stadt Konstanz, Amt für Stadtplanung und Umwelt
20.05.2022 21:00;442;209;233;Sonnig;19;19;0;Stadt Konstanz, Amt für Stadtplanung und Umwelt
20.05.2022 22:00;403;159;244;Sonnig;18;18;0;Stadt Konstanz, Amt für Stadtplanung und Umwelt
20.05.2022 23:00;275;78;197;Stellenweiser Regenfall;18;18;0.1;Stadt Konstanz, Amt für Stadtplanung und Umwelt
21.05.2022 00:00;220;81;139;Stellenweiser Regenfall;17;17;0.1;Stadt Konstanz, Amt für Stadtplanung und Umwelt
21.05.2022 01:00;128;37;91;Stellenweiser Regenfall;17;17;0.1;Stadt Konstanz, Amt für Stadtplanung und Umwelt
21.05.2022 02:00;62;18;44;Stellenweise Gewitter und Niederschlaege;16;16;0;Stadt Konstanz, Amt für Stadtplanung und Umwelt
21.05.2022 03:00;38;28;10;Stellenweise Gewitter und Niederschlaege;16;16;0;Stadt Konstanz, Amt für Stadtplanung und Umwelt
21.05.2022 04:00;34;21;13;Stellenweise Gewitter und Niederschlaege;16;16;0;Stadt Konstanz, Amt für Stadtplanung und Umwelt
21.05.2022 05:00;41;26;15;Leichter Regenschauer;16;16;0.3;Stadt Konstanz, Amt für Stadtplanung und Umwelt
21.05.2022 06:00;73;44;29;Leichter Regenschauer;16;16;0.4;Stadt Konstanz, Amt für Stadtplanung und Umwelt
21.05.2022 07:00;83;39;44;Leichter Regenschauer;16;16;0.2;Stadt Konstanz, Amt für Stadtplanung und Umwelt
21.05.2022 08:00;273;151;122;Stellenweiser Regenfall;16;16;0;Stadt Konstanz, Amt für Stadtplanung und Umwelt
21.05.2022 09:00;463;273;190;Stellenweiser Regenfall;17;17;0;Stadt Konstanz, Amt für Stadtplanung und Umwelt
21.05.2022 10:00;581;299;282;Stellenweiser Regenfall;18;18;0;Stadt Konstanz, Amt für Stadtplanung und Umwelt
21.05.2022 11:00;635;375;260;Stellenweiser Regenfall;18;18;0;Stadt Konstanz, Amt für Stadtplanung und Umwelt
21.05.2022 12:00;705;341;364;Stellenweiser Regenfall;19;19;0;Stadt Konstanz, Amt für Stadtplanung und Umwelt
21.05.2022 13:00;711;351;360;Stellenweiser Regenfall;21;21;0;Stadt Konstanz, Amt für Stadtplanung und Umwelt
21.05.2022 14:00;848;369;479;Sonnig;22;23;0;Stadt Konstanz, Amt für Stadtplanung und Umwelt
21.05.2022 15:00;781;376;405;Sonnig;24;25;0;Stadt Konstanz, Amt für Stadtplanung und Umwelt
21.05.2022 16:00;783;414;369;Sonnig;23;25;0;Stadt Konstanz, Amt für Stadtplanung und Umwelt
21.05.2022 17:00;797;392;405;Sonnig;23;25;0;Stadt Konstanz, Amt für Stadtplanung und Umwelt
21.05.2022 18:00;711;326;385;Sonnig;22;25;0;Stadt Konstanz, Amt für Stadtplanung und Umwelt
21.05.2022 19:00;658;326;332;Sonnig;19;20;0;Stadt Konstanz, Amt für Stadtplanung und Umwelt
21.05.2022 20:00;443;224;219;Sonnig;17;17;0;Stadt Konstanz, Amt für Stadtplanung und Umwelt
21.05.2022 21:00;469;257;212;Sonnig;14;14;0;Stadt Konstanz, Amt für Stadtplanung und Umwelt
21.05.2022 22:00;376;173;203;Sonnig;13;13;0;Stadt Konstanz, Amt für Stadtplanung und Umwelt
21.05.2022 23:00;323;155;168;Sonnig;12;12;0;Stadt Konstanz, Amt für Stadtplanung und Umwelt
22.05.2022 00:00;250;69;181;Sonnig;11;11;0;Stadt Konstanz, Amt für Stadtplanung und Umwelt
22.05.2022 01:00;166;51;115;Sonnig;11;11;0;Stadt Konstanz, Amt für Stadtplanung und Umwelt
22.05.2022 02:00;145;49;96;Sonnig;10;10;0;Stadt Konstanz, Amt für Stadtplanung und Umwelt
22.05.2022 03:00;68;26;42;Sonnig;10;9;0;Stadt Konstanz, Amt für Stadtplanung und Umwelt
22.05.2022 04:00;40;13;27;Sonnig;10;10;0;Stadt Konstanz, Amt für Stadtplanung und Umwelt
22.05.2022 05:00;35;22;13;Sonnig;11;11;0;Stadt Konstanz, Amt für Stadtplanung und Umwelt
22.05.2022 06:00;40;22;18;Sonnig;12;12;0;Stadt Konstanz, Amt für Stadtplanung und Umwelt
22.05.2022 07:00;49;29;20;Sonnig;14;14;0;Stadt Konstanz, Amt für Stadtplanung und Umwelt
22.05.2022 08:00;121;56;65;Sonnig;16;16;0;Stadt Konstanz, Amt für Stadtplanung und Umwelt
22.05.2022 09:00;302;148;154;Sonnig;18;18;0;Stadt Konstanz, Amt für Stadtplanung und Umwelt
22.05.2022 10:00;358;178;180;Sonnig;20;20;0;Stadt Konstanz, Amt für Stadtplanung und Umwelt
22.05.2022 11:00;452;209;243;Sonnig;22;22;0;Stadt Konstanz, Amt für Stadtplanung und Umwelt
22.05.2022 12:00;457;227;230;Sonnig;23;25;0;Stadt Konstanz, Amt für Stadtplanung und Umwelt
22.05.2022 13:00;512;268;244;Sonnig;23;25;0;Stadt Konstanz, Amt für Stadtplanung und Umwelt
22.05.2022 14:00;611;294;317;Leicht bewoelkt;23;25;0;Stadt Konstanz, Amt für Stadtplanung und Umwelt
22.05.2022 15:00;557;279;278;Leicht bewoelkt;23;25;0;Stadt Konstanz, Amt für Stadtplanung und Umwelt
22.05.2022 16:00;626;337;289;Leicht bewoelkt;22;24;0;Stadt Konstanz, Amt für Stadtplanung und Umwelt
22.05.2022 17:00;580;291;289;Leicht bewoelkt;22;22;0;Stadt Konstanz, Amt für Stadtplanung und Umwelt
22.05.2022 18:00;590;271;319;Leicht bewoelkt;21;21;0;Stadt Konstanz, Amt für Stadtplanung und Umwelt
22.05.2022 19:00;458;225;233;Leicht bewoelkt;19;19;0;Stadt Konstanz, Amt für Stadtplanung und Umwelt
22.05.2022 20:00;301;136;165;Stellenweiser Regenfall;17;17;0.1;Stadt Konstanz, Amt für Stadtplanung und Umwelt
22.05.2022 21:00;205;87;118;Stellenweiser Regenfall;15;15;0.1;Stadt Konstanz, Amt für Stadtplanung und Umwelt
22.05.2022 22:00;176;76;100;Stellenweiser Regenfall;15;15;0;Stadt Konstanz, Amt für Stadtplanung und Umwelt
22.05.2022 23:00;74;34;40;Leicht bewoelkt;14;14;0;Stadt Konstanz, Amt für Stadtplanung und Umwelt
23.05.2022 00:00;42;18;24;Leicht bewoelkt;13;13;0;Stadt Konstanz, Amt für Stadtplanung und Umwelt
23.05.2022 01:00;13;5;8;Leicht bewoelkt;13;13;0;Stadt Konstanz, Amt für Stadtplanung und Umwelt
23.05.2022 02:00;11;8;3;Leicht bewoelkt;13;13;0;Stadt Konstanz, Amt für Stadtplanung und Umwelt
23.05.2022 03:00;5;4;1;Leicht bewoelkt;13;13;0;Stadt Konstanz, Amt für Stadtplanung und Umwelt
23.05.2022 04:00;10;7;3;Leicht bewoelkt;13;13;0;Stadt Konstanz, Amt für Stadtplanung und Umwelt
23.05.2022 05:00;44;30;14;Bewoelkt;14;14;0;Stadt Konstanz, Amt für Stadtplanung und Umwelt
23.05.2022 06:00;170;94;76;Bewoelkt;14;15;0;Stadt Konstanz, Amt für Stadtplanung und Umwelt
23.05.2022 07:00;970;592;378;Bewoelkt;17;17;0;Stadt Konstanz, Amt für Stadtplanung und Umwelt
23.05.2022 08:00;736;379;357;Leicht bewoelkt;19;19;0;Stadt Konstanz, Amt für Stadtplanung und Umwelt
23.05.2022 09:00;820;488;332;Leicht bewoelkt;21;21;0;Stadt Konstanz, Amt für Stadtplanung und Umwelt
23.05.2022 10:00;549;283;266;Leicht bewoelkt;22;23;0;Stadt Konstanz, Amt für Stadtplanung und Umwelt
23.05.2022 11:00;751;353;398;Stellenweise Gewitter und Niederschlaege;23;24;0;Stadt Konstanz, Amt für Stadtplanung und Umwelt
23.05.2022 12:00;759;378;381;Stellenweise Gewitter und Niederschlaege;24;26;0;Stadt Konstanz, Amt für Stadtplanung und Umwelt
23.05.2022 13:00;1068;466;602;Stellenweise Gewitter und Niederschlaege;24;26;0;Stadt Konstanz, Amt für Stadtplanung und Umwelt
23.05.2022 14:00;724;342;382;Stellenweise Gewitter und Niederschlaege;25;26;0;Stadt Konstanz, Amt für Stadtplanung und Umwelt
23.05.2022 15:00;965;461;504;Stellenweise Gewitter und Niederschlaege;25;26;0;Stadt Konstanz, Amt für Stadtplanung und Umwelt
23.05.2022 16:00;963;451;512;Stellenweise Gewitter und Niederschlaege;23;24;0;Stadt Konstanz, Amt für Stadtplanung und Umwelt
23.05.2022 17:00;446;186;260;Leichter Regenschauer;21;21;0.2;Stadt Konstanz, Amt für Stadtplanung und Umwelt
23.05.2022 18:00;513;237;276;Leichter Regenschauer;20;20;0.3;Stadt Konstanz, Amt für Stadtplanung und Umwelt
23.05.2022 19:00;427;179;248;Leichter Regenschauer;18;18;0.1;Stadt Konstanz, Amt für Stadtplanung und Umwelt
23.05.2022 20:00;342;128;214;Leichter Regenschauer;16;16;0.3;Stadt Konstanz, Amt für Stadtplanung und Umwelt
23.05.2022 21:00;196;83;113;Leichter Regenschauer;15;15;0.4;Stadt Konstanz, Amt für Stadtplanung und Umwelt
23.05.2022 22:00;141;52;89;Leichter Regenschauer;15;14;0.2;Stadt Konstanz, Amt für Stadtplanung und Umwelt
23.05.2022 23:00;59;29;30;Leichter Regenschauer;14;14;0.7;Stadt Konstanz, Amt für Stadtplanung und Umwelt
24.05.2022 00:00;33;19;14;Leichter Regenschauer;14;14;01. Mrz;Stadt Konstanz, Amt für Stadtplanung und Umwelt
24.05.2022 01:00;22;14;8;Leichter Regenschauer;14;13;0.7;Stadt Konstanz, Amt für Stadtplanung und Umwelt
24.05.2022 02:00;5;4;1;Leichter Regenfall;13;13;0.5;Stadt Konstanz, Amt für Stadtplanung und Umwelt
24.05.2022 03:00;5;1;4;Leichter Regenfall;13;12;0.6;Stadt Konstanz, Amt für Stadtplanung und Umwelt
24.05.2022 04:00;9;7;2;Leichter Regenfall;13;12;0.3;Stadt Konstanz, Amt für Stadtplanung und Umwelt
24.05.2022 05:00;39;30;9;Leichter Regenfall;12;11;0.4;Stadt Konstanz, Amt für Stadtplanung und Umwelt
24.05.2022 06:00;135;78;57;Leichter Regenfall;12;11;0.5;Stadt Konstanz, Amt für Stadtplanung und Umwelt
24.05.2022 07:00;760;479;281;Leichter Regenfall;12;12;0.3;Stadt Konstanz, Amt für Stadtplanung und Umwelt
24.05.2022 08:00;662;344;318;Leichter Nebel;13;12;0;Stadt Konstanz, Amt für Stadtplanung und Umwelt
24.05.2022 09:00;613;367;246;Leichter Nebel;13;13;0;Stadt Konstanz, Amt für Stadtplanung und Umwelt
24.05.2022 10:00;421;212;209;Leichter Nebel;13;13;0;Stadt Konstanz, Amt für Stadtplanung und Umwelt
24.05.2022 11:00;502;261;241;Nieselregen;13;13;0.1;Stadt Konstanz, Amt für Stadtplanung und Umwelt
24.05.2022 12:00;593;246;347;Nieselregen;13;13;0.1;Stadt Konstanz, Amt für Stadtplanung und Umwelt
24.05.2022 13:00;783;353;430;Nieselregen;13;14;0.1;Stadt Konstanz, Amt für Stadtplanung und Umwelt
24.05.2022 14:00;527;258;269;Leichter Nebel;13;14;0;Stadt Konstanz, Amt für Stadtplanung und Umwelt
24.05.2022 15:00;843;396;447;Leichter Nebel;13;14;0;Stadt Konstanz, Amt für Stadtplanung und Umwelt
24.05.2022 16:00;911;413;498;Leichter Nebel;13;14;0;Stadt Konstanz, Amt für Stadtplanung und Umwelt
24.05.2022 17:00;1022;460;562;Leichter Regenschauer;13;13;0.1;Stadt Konstanz, Amt für Stadtplanung und Umwelt
24.05.2022 18:00;856;365;491;Leichter Regenschauer;13;13;0.2;Stadt Konstanz, Amt für Stadtplanung und Umwelt
24.05.2022 19:00;673;319;354;Leichter Regenschauer;12;12;0.1;Stadt Konstanz, Amt für Stadtplanung und Umwelt
24.05.2022 20:00;403;160;243;Maessiger Regenfall;12;12;0.9;Stadt Konstanz, Amt für Stadtplanung und Umwelt
24.05.2022 21:00;296;120;176;Maessiger Regenfall;11;11;01. Feb;Stadt Konstanz, Amt für Stadtplanung und Umwelt
24.05.2022 22:00;233;76;157;Maessiger Regenfall;11;11;0.6;Stadt Konstanz, Amt für Stadtplanung und Umwelt
24.05.2022 23:00;104;54;50;Stellenweiser Nieselregen;11;11;0.1;Stadt Konstanz, Amt für Stadtplanung und Umwelt
25.05.2022 00:00;73;32;41;Stellenweiser Nieselregen;11;11;0.3;Stadt Konstanz, Amt für Stadtplanung und Umwelt
25.05.2022 01:00;27;13;14;Stellenweiser Nieselregen;11;11;0.1;Stadt Konstanz, Amt für Stadtplanung und Umwelt
25.05.2022 02:00;23;12;11;Bewoelkt;11;11;0;Stadt Konstanz, Amt für Stadtplanung und Umwelt
25.05.2022 03:00;6;4;2;Bewoelkt;11;11;0;Stadt Konstanz, Amt für Stadtplanung und Umwelt
25.05.2022 04:00;6;2;4;Bewoelkt;11;11;0;Stadt Konstanz, Amt für Stadtplanung und Umwelt
25.05.2022 05:00;32;22;10;Leichter Nebel;11;11;0;Stadt Konstanz, Amt für Stadtplanung und Umwelt
25.05.2022 06:00;147;88;59;Leichter Nebel;12;12;0;Stadt Konstanz, Amt für Stadtplanung und Umwelt
25.05.2022 07:00;978;590;388;Leichter Nebel;12;12;0;Stadt Konstanz, Amt für Stadtplanung und Umwelt
25.05.2022 08:00;776;456;320;Stellenweiser Regenfall;12;12;0;Stadt Konstanz, Amt für Stadtplanung und Umwelt
25.05.2022 09:00;766;421;345;Stellenweiser Regenfall;13;13;0;Stadt Konstanz, Amt für Stadtplanung und Umwelt
25.05.2022 10:00;550;301;249;Stellenweiser Regenfall;13;13;0;Stadt Konstanz, Amt für Stadtplanung und Umwelt
25.05.2022 11:00;720;323;397;Stellenweiser Regenfall;14;14;0;Stadt Konstanz, Amt für Stadtplanung und Umwelt
25.05.2022 12:00;787;367;420;Stellenweiser Regenfall;15;15;0;Stadt Konstanz, Amt für Stadtplanung und Umwelt
25.05.2022 13:00;1029;472;557;Stellenweiser Regenfall;16;16;0;Stadt Konstanz, Amt für Stadtplanung und Umwelt
25.05.2022 14:00;853;422;431;Sonnig;17;18;0;Stadt Konstanz, Amt für Stadtplanung und Umwelt
25.05.2022 15:00;1043;501;542;Sonnig;19;19;0;Stadt Konstanz, Amt für Stadtplanung und Umwelt
25.05.2022 16:00;999;455;544;Sonnig;19;19;0;Stadt Konstanz, Amt für Stadtplanung und Umwelt
25.05.2022 17:00;1236;523;713;Sonnig;19;19;0;Stadt Konstanz, Amt für Stadtplanung und Umwelt
25.05.2022 18:00;1000;510;490;Sonnig;19;19;0;Stadt Konstanz, Amt für Stadtplanung und Umwelt
25.05.2022 19:00;775;410;365;Sonnig;16;16;0;Stadt Konstanz, Amt für Stadtplanung und Umwelt
25.05.2022 20:00;677;371;306;Leicht bewoelkt;14;14;0;Stadt Konstanz, Amt für Stadtplanung und Umwelt
25.05.2022 21:00;558;281;277;Leicht bewoelkt;12;12;0;Stadt Konstanz, Amt für Stadtplanung und Umwelt
25.05.2022 22:00;447;193;254;Leicht bewoelkt;11;11;0;Stadt Konstanz, Amt für Stadtplanung und Umwelt
25.05.2022 23:00;295;85;210;Sonnig;10;10;0;Stadt Konstanz, Amt für Stadtplanung und Umwelt
26.05.2022 00:00;223;61;162;Sonnig;10;10;0;Stadt Konstanz, Amt für Stadtplanung und Umwelt
26.05.2022 01:00;125;44;81;Sonnig;9;9;0;Stadt Konstanz, Amt für Stadtplanung und Umwelt
26.05.2022 02:00;94;42;52;Leicht bewoelkt;9;9;0;Stadt Konstanz, Amt für Stadtplanung und Umwelt
26.05.2022 03:00;81;51;30;Leicht bewoelkt;8;8;0;Stadt Konstanz, Amt für Stadtplanung und Umwelt
26.05.2022 04:00;48;22;26;Leicht bewoelkt;9;9;0;Stadt Konstanz, Amt für Stadtplanung und Umwelt
26.05.2022 05:00;28;13;15;Leicht bewoelkt;10;10;0;Stadt Konstanz, Amt für Stadtplanung und Umwelt
26.05.2022 06:00;42;22;20;Leicht bewoelkt;10;10;0;Stadt Konstanz, Amt für Stadtplanung und Umwelt
26.05.2022 07:00;74;50;24;Leicht bewoelkt;13;13;0;Stadt Konstanz, Amt für Stadtplanung und Umwelt
26.05.2022 08:00;120;67;53;Leicht bewoelkt;15;15;0;Stadt Konstanz, Amt für Stadtplanung und Umwelt
26.05.2022 09:00;393;201;192;Leicht bewoelkt;17;17;0;Stadt Konstanz, Amt für Stadtplanung und Umwelt
26.05.2022 10:00;484;264;220;Leicht bewoelkt;18;18;0;Stadt Konstanz, Amt für Stadtplanung und Umwelt
26.05.2022 11:00;622;295;327;Leicht bewoelkt;19;19;0;Stadt Konstanz, Amt für Stadtplanung und Umwelt
26.05.2022 12:00;568;245;323;Leicht bewoelkt;20;20;0;Stadt Konstanz, Amt für Stadtplanung und Umwelt
26.05.2022 13:00;691;370;321;Leicht bewoelkt;21;21;0;Stadt Konstanz, Amt für Stadtplanung und Umwelt
26.05.2022 14:00;723;352;371;Sonnig;22;22;0;Stadt Konstanz, Amt für Stadtplanung und Umwelt
26.05.2022 15:00;774;398;376;Sonnig;22;24;0;Stadt Konstanz, Amt für Stadtplanung und Umwelt
26.05.2022 16:00;685;344;341;Sonnig;22;22;0;Stadt Konstanz, Amt für Stadtplanung und Umwelt
26.05.2022 17:00;693;352;341;Leicht bewoelkt;22;22;0;Stadt Konstanz, Amt für Stadtplanung und Umwelt
26.05.2022 18:00;638;339;299;Leicht bewoelkt;21;21;0;Stadt Konstanz, Amt für Stadtplanung und Umwelt
26.05.2022 19:00;565;291;274;Leicht bewoelkt;18;18;0;Stadt Konstanz, Amt für Stadtplanung und Umwelt
26.05.2022 20:00;494;222;272;Sonnig;16;16;0;Stadt Konstanz, Amt für Stadtplanung und Umwelt
26.05.2022 21:00;334;140;194;Sonnig;13;13;0;Stadt Konstanz, Amt für Stadtplanung und Umwelt
26.05.2022 22:00;246;94;152;Sonnig;12;12;0;Stadt Konstanz, Amt für Stadtplanung und Umwelt
26.05.2022 23:00;161;70;91;Sonnig;11;11;0;Stadt Konstanz, Amt für Stadtplanung und Umwelt
27.05.2022 00:00;115;36;79;Sonnig;11;11;0;Stadt Konstanz, Amt für Stadtplanung und Umwelt
27.05.2022 01:00;53;21;32;Sonnig;10;10;0;Stadt Konstanz, Amt für Stadtplanung und Umwelt
27.05.2022 02:00;19;10;9;Sonnig;10;10;0;Stadt Konstanz, Amt für Stadtplanung und Umwelt
27.05.2022 03:00;8;3;5;Sonnig;9;9;0;Stadt Konstanz, Amt für Stadtplanung und Umwelt
27.05.2022 04:00;7;3;4;Sonnig;10;10;0;Stadt Konstanz, Amt für Stadtplanung und Umwelt
27.05.2022 05:00;38;26;12;Sonnig;11;12;0;Stadt Konstanz, Amt für Stadtplanung und Umwelt
27.05.2022 06:00;98;47;51;Sonnig;12;13;0;Stadt Konstanz, Amt für Stadtplanung und Umwelt
27.05.2022 07:00;304;175;129;Sonnig;14;14;0;Stadt Konstanz, Amt für Stadtplanung und Umwelt
27.05.2022 08:00;506;288;218;Leicht bewoelkt;16;16;0;Stadt Konstanz, Amt für Stadtplanung und Umwelt
27.05.2022 09:00;661;384;277;Leicht bewoelkt;17;17;0;Stadt Konstanz, Amt für Stadtplanung und Umwelt
27.05.2022 10:00;728;420;308;Leicht bewoelkt;19;19;0;Stadt Konstanz, Amt für Stadtplanung und Umwelt
27.05.2022 11:00;792;440;352;Sonnig;20;20;0;Stadt Konstanz, Amt für Stadtplanung und Umwelt
27.05.2022 12:00;941;479;462;Sonnig;21;21;0;Stadt Konstanz, Amt für Stadtplanung und Umwelt
27.05.2022 13:00;889;396;493;Sonnig;22;22;0;Stadt Konstanz, Amt für Stadtplanung und Umwelt
27.05.2022 14:00;1038;491;547;Leicht bewoelkt;22;25;0;Stadt Konstanz, Amt für Stadtplanung und Umwelt
27.05.2022 15:00;919;460;459;Leicht bewoelkt;23;25;0;Stadt Konstanz, Amt für Stadtplanung und Umwelt
27.05.2022 16:00;961;491;470;Leicht bewoelkt;22;22;0;Stadt Konstanz, Amt für Stadtplanung und Umwelt
27.05.2022 17:00;989;453;536;Sonnig;21;21;0;Stadt Konstanz, Amt für Stadtplanung und Umwelt
27.05.2022 18:00;849;432;417;Sonnig;20;20;0;Stadt Konstanz, Amt für Stadtplanung und Umwelt
27.05.2022 19:00;715;338;377;Sonnig;18;17;0;Stadt Konstanz, Amt für Stadtplanung und Umwelt
27.05.2022 20:00;555;262;293;Leicht bewoelkt;15;15;0;Stadt Konstanz, Amt für Stadtplanung und Umwelt
27.05.2022 21:00;412;181;231;Leicht bewoelkt;13;12;0;Stadt Konstanz, Amt für Stadtplanung und Umwelt
27.05.2022 22:00;270;115;155;Leicht bewoelkt;12;12;0;Stadt Konstanz, Amt für Stadtplanung und Umwelt
27.05.2022 23:00;235;89;146;Stellenweiser Regenfall;12;12;0;Stadt Konstanz, Amt für Stadtplanung und Umwelt
28.05.2022 00:00;198;74;124;Stellenweiser Regenfall;11;12;0.1;Stadt Konstanz, Amt für Stadtplanung und Umwelt
28.05.2022 01:00;132;49;83;Stellenweiser Regenfall;11;11;0;Stadt Konstanz, Amt für Stadtplanung und Umwelt
28.05.2022 02:00;79;27;52;Stellenweiser Regenfall;10;10;0;Stadt Konstanz, Amt für Stadtplanung und Umwelt
28.05.2022 03:00;47;20;27;Stellenweiser Regenfall;10;9;0;Stadt Konstanz, Amt für Stadtplanung und Umwelt
28.05.2022 04:00;30;13;17;Stellenweiser Regenfall;10;9;0;Stadt Konstanz, Amt für Stadtplanung und Umwelt
28.05.2022 05:00;48;25;23;Stellenweiser Regenfall;9;8;0;Stadt Konstanz, Amt für Stadtplanung und Umwelt
28.05.2022 06:00;53;38;15;Stellenweiser Regenfall;9;8;0;Stadt Konstanz, Amt für Stadtplanung und Umwelt
28.05.2022 07:00;80;44;36;Stellenweiser Regenfall;10;9;0;Stadt Konstanz, Amt für Stadtplanung und Umwelt
28.05.2022 08:00;215;122;93;Sonnig;12;11;0;Stadt Konstanz, Amt für Stadtplanung und Umwelt
28.05.2022 09:00;496;273;223;Sonnig;13;12;0;Stadt Konstanz, Amt für Stadtplanung und Umwelt
28.05.2022 10:00;648;343;305;Sonnig;14;14;0;Stadt Konstanz, Amt für Stadtplanung und Umwelt
28.05.2022 11:00;679;349;330;Sonnig;15;15;0;Stadt Konstanz, Amt für Stadtplanung und Umwelt
28.05.2022 12:00;755;390;365;Sonnig;16;16;0;Stadt Konstanz, Amt für Stadtplanung und Umwelt
28.05.2022 13:00;699;325;374;Sonnig;17;17;0;Stadt Konstanz, Amt für Stadtplanung und Umwelt
28.05.2022 14:00;709;331;378;Sonnig;17;17;0;Stadt Konstanz, Amt für Stadtplanung und Umwelt
28.05.2022 15:00;712;356;356;Sonnig;18;18;0;Stadt Konstanz, Amt für Stadtplanung und Umwelt
28.05.2022 16:00;749;373;376;Sonnig;17;17;0;Stadt Konstanz, Amt für Stadtplanung und Umwelt
28.05.2022 17:00;765;376;389;Sonnig;17;17;0;Stadt Konstanz, Amt für Stadtplanung und Umwelt
28.05.2022 18:00;768;385;383;Sonnig;16;16;0;Stadt Konstanz, Amt für Stadtplanung und Umwelt
28.05.2022 19:00;554;307;247;Sonnig;14;13;0;Stadt Konstanz, Amt für Stadtplanung und Umwelt
28.05.2022 20:00;414;205;209;Leicht bewoelkt;12;11;0;Stadt Konstanz, Amt für Stadtplanung und Umwelt
28.05.2022 21:00;287;120;167;Leicht bewoelkt;10;8;0;Stadt Konstanz, Amt für Stadtplanung und Umwelt
28.05.2022 22:00;305;81;224;Leicht bewoelkt;9;8;0;Stadt Konstanz, Amt für Stadtplanung und Umwelt
28.05.2022 23:00;251;77;174;Leicht bewoelkt;9;8;0;Stadt Konstanz, Amt für Stadtplanung und Umwelt
29.05.2022 00:00;193;67;126;Leicht bewoelkt;9;8;0;Stadt Konstanz, Amt für Stadtplanung und Umwelt
29.05.2022 01:00;125;31;94;Leicht bewoelkt;8;8;0;Stadt Konstanz, Amt für Stadtplanung und Umwelt
29.05.2022 02:00;86;28;58;Leicht bewoelkt;7;7;0;Stadt Konstanz, Amt für Stadtplanung und Umwelt
29.05.2022 03:00;40;13;27;Leicht bewoelkt;7;6;0;Stadt Konstanz, Amt für Stadtplanung und Umwelt
29.05.2022 04:00;37;19;18;Leicht bewoelkt;7;7;0;Stadt Konstanz, Amt für Stadtplanung und Umwelt
29.05.2022 05:00;38;20;18;Leicht bewoelkt;7;7;0;Stadt Konstanz, Amt für Stadtplanung und Umwelt
29.05.2022 06:00;47;32;15;Leicht bewoelkt;8;7;0;Stadt Konstanz, Amt für Stadtplanung und Umwelt
29.05.2022 07:00;44;25;19;Leicht bewoelkt;9;8;0;Stadt Konstanz, Amt für Stadtplanung und Umwelt
29.05.2022 08:00;100;51;49;Leicht bewoelkt;10;9;0;Stadt Konstanz, Amt für Stadtplanung und Umwelt
29.05.2022 09:00;207;114;93;Leicht bewoelkt;12;11;0;Stadt Konstanz, Amt für Stadtplanung und Umwelt
29.05.2022 10:00;367;195;172;Leicht bewoelkt;13;12;0;Stadt Konstanz, Amt für Stadtplanung und Umwelt
29.05.2022 11:00;387;196;191;Leicht bewoelkt;14;13;0;Stadt Konstanz, Amt für Stadtplanung und Umwelt
29.05.2022 12:00;478;212;266;Leicht bewoelkt;15;15;0;Stadt Konstanz, Amt für Stadtplanung und Umwelt
29.05.2022 13:00;331;154;177;Leicht bewoelkt;15;15;0;Stadt Konstanz, Amt für Stadtplanung und Umwelt
29.05.2022 14:00;416;187;229;Sonnig;15;15;0;Stadt Konstanz, Amt für Stadtplanung und Umwelt
29.05.2022 15:00;355;160;195;Sonnig;15;15;0;Stadt Konstanz, Amt für Stadtplanung und Umwelt
29.05.2022 16:00;414;199;215;Sonnig;15;15;0;Stadt Konstanz, Amt für Stadtplanung und Umwelt
29.05.2022 17:00;432;218;214;Sonnig;15;15;0;Stadt Konstanz, Amt für Stadtplanung und Umwelt
29.05.2022 18:00;426;204;222;Sonnig;15;15;0;Stadt Konstanz, Amt für Stadtplanung und Umwelt
29.05.2022 19:00;344;163;181;Sonnig;12;12;0;Stadt Konstanz, Amt für Stadtplanung und Umwelt
29.05.2022 20:00;281;124;157;Leicht bewoelkt;10;9;0;Stadt Konstanz, Amt für Stadtplanung und Umwelt
29.05.2022 21:00;222;109;113;Leicht bewoelkt;7;6;0;Stadt Konstanz, Amt für Stadtplanung und Umwelt
29.05.2022 22:00;138;71;67;Leicht bewoelkt;6;5;0;Stadt Konstanz, Amt für Stadtplanung und Umwelt
29.05.2022 23:00;81;36;45;Leicht bewoelkt;6;5;0;Stadt Konstanz, Amt für Stadtplanung und Umwelt
30.05.2022 00:00;38;21;17;Leicht bewoelkt;5;4;0;Stadt Konstanz, Amt für Stadtplanung und Umwelt
30.05.2022 01:00;18;9;9;Leicht bewoelkt;4;4;0;Stadt Konstanz, Amt für Stadtplanung und Umwelt
30.05.2022 02:00;6;4;2;Leicht bewoelkt;4;3;0;Stadt Konstanz, Amt für Stadtplanung und Umwelt
30.05.2022 03:00;3;2;1;Leicht bewoelkt;4;2;0;Stadt Konstanz, Amt für Stadtplanung und Umwelt
30.05.2022 04:00;12;7;5;Leicht bewoelkt;5;3;0;Stadt Konstanz, Amt für Stadtplanung und Umwelt
30.05.2022 05:00;56;39;17;Leicht bewoelkt;6;5;0;Stadt Konstanz, Amt für Stadtplanung und Umwelt
30.05.2022 06:00;191;105;86;Leicht bewoelkt;7;6;0;Stadt Konstanz, Amt für Stadtplanung und Umwelt
30.05.2022 07:00;971;638;333;Leicht bewoelkt;9;8;0;Stadt Konstanz, Amt für Stadtplanung und Umwelt
30.05.2022 08:00;910;514;396;Sonnig;11;10;0;Stadt Konstanz, Amt für Stadtplanung und Umwelt
30.05.2022 09:00;842;492;350;Sonnig;13;12;0;Stadt Konstanz, Amt für Stadtplanung und Umwelt
30.05.2022 10:00;611;320;291;Sonnig;14;14;0;Stadt Konstanz, Amt für Stadtplanung und Umwelt
30.05.2022 11:00;796;387;409;Bedeckt;15;15;0;Stadt Konstanz, Amt für Stadtplanung und Umwelt
30.05.2022 12:00;782;364;418;Bedeckt;16;16;0;Stadt Konstanz, Amt für Stadtplanung und Umwelt
30.05.2022 13:00;1045;434;611;Bedeckt;15;15;0;Stadt Konstanz, Amt für Stadtplanung und Umwelt
30.05.2022 14:00;792;349;443;Leichter Regenschauer;14;13;0.3;Stadt Konstanz, Amt für Stadtplanung und Umwelt
30.05.2022 15:00;1060;534;526;Leichter Regenschauer;13;12;0.4;Stadt Konstanz, Amt für Stadtplanung und Umwelt
30.05.2022 16:00;1138;517;621;Leichter Regenschauer;13;12;0.2;Stadt Konstanz, Amt für Stadtplanung und Umwelt
30.05.2022 17:00;1208;556;652;Stellenweiser Regenfall;13;13;0.2;Stadt Konstanz, Amt für Stadtplanung und Umwelt
30.05.2022 18:00;1093;497;596;Stellenweiser Regenfall;14;14;0.3;Stadt Konstanz, Amt für Stadtplanung und Umwelt
30.05.2022 19:00;778;373;405;Stellenweiser Regenfall;12;11;0.2;Stadt Konstanz, Amt für Stadtplanung und Umwelt
30.05.2022 20:00;584;239;345;Sonnig;10;9;0;Stadt Konstanz, Amt für Stadtplanung und Umwelt
30.05.2022 21:00;439;199;240;Sonnig;8;7;0;Stadt Konstanz, Amt für Stadtplanung und Umwelt
30.05.2022 22:00;251;107;144;Sonnig;8;7;0;Stadt Konstanz, Amt für Stadtplanung und Umwelt
30.05.2022 23:00;127;50;77;Leicht bewoelkt;8;7;0;Stadt Konstanz, Amt für Stadtplanung und Umwelt
31.05.2022 00:00;64;31;33;Leicht bewoelkt;8;7;0;Stadt Konstanz, Amt für Stadtplanung und Umwelt
31.05.2022 01:00;50;21;29;Leicht bewoelkt;7;7;0;Stadt Konstanz, Amt für Stadtplanung und Umwelt
31.05.2022 02:00;17;13;4;Leicht bewoelkt;7;7;0;Stadt Konstanz, Amt für Stadtplanung und Umwelt
31.05.2022 03:00;8;6;2;Leicht bewoelkt;7;7;0;Stadt Konstanz, Amt für Stadtplanung und Umwelt
31.05.2022 04:00;15;14;1;Leicht bewoelkt;8;8;0;Stadt Konstanz, Amt für Stadtplanung und Umwelt
31.05.2022 05:00;49;39;10;Leicht bewoelkt;9;9;0;Stadt Konstanz, Amt für Stadtplanung und Umwelt
31.05.2022 06:00;190;120;70;Leicht bewoelkt;10;10;0;Stadt Konstanz, Amt für Stadtplanung und Umwelt
31.05.2022 07:00;1016;645;371;Leicht bewoelkt;11;12;0;Stadt Konstanz, Amt für Stadtplanung und Umwelt
31.05.2022 08:00;958;536;422;Stellenweiser Regenfall;13;14;0;Stadt Konstanz, Amt für Stadtplanung und Umwelt
31.05.2022 09:00;921;574;347;Stellenweiser Regenfall;15;16;0;Stadt Konstanz, Amt für Stadtplanung und Umwelt
31.05.2022 10:00;603;324;279;Stellenweiser Regenfall;16;17;0;Stadt Konstanz, Amt für Stadtplanung und Umwelt
31.05.2022 11:00;803;391;412;Bedeckt;17;18;0;Stadt Konstanz, Amt für Stadtplanung und Umwelt
31.05.2022 12:00;806;305;501;Bedeckt;19;19;0;Stadt Konstanz, Amt für Stadtplanung und Umwelt
31.05.2022 13:00;1093;478;615;Bedeckt;16;16;0;Stadt Konstanz, Amt für Stadtplanung und Umwelt
31.05.2022 14:00;702;315;387;Leichter Nebel;14;14;0;Stadt Konstanz, Amt für Stadtplanung und Umwelt
31.05.2022 15:00;935;423;512;Leichter Nebel;12;12;0;Stadt Konstanz, Amt für Stadtplanung und Umwelt
31.05.2022 16:00;974;428;546;Leichter Nebel;13;12;0;Stadt Konstanz, Amt für Stadtplanung und Umwelt
31.05.2022 17:00;1160;519;641;Stellenweiser Nieselregen;13;13;0.2;Stadt Konstanz, Amt für Stadtplanung und Umwelt
31.05.2022 18:00;982;451;531;Stellenweiser Nieselregen;14;14;0.2;Stadt Konstanz, Amt für Stadtplanung und Umwelt
31.05.2022 19:00;534;258;276;Stellenweiser Nieselregen;13;13;0.1;Stadt Konstanz, Amt für Stadtplanung und Umwelt
31.05.2022 20:00;517;232;285;Leichter Regenschauer;12;11;0.1;Stadt Konstanz, Amt für Stadtplanung und Umwelt
31.05.2022 21:00;320;141;179;Leichter Regenschauer;11;10;0.1;Stadt Konstanz, Amt für Stadtplanung und Umwelt
31.05.2022 22:00;255;105;150;Leichter Regenschauer;10;10;0.1;Stadt Konstanz, Amt für Stadtplanung und Umwelt
31.05.2022 23:00;164;75;89;Stellenweiser Regenfall;10;10;0;Stadt Konstanz, Amt für Stadtplanung und Umwelt
01.06.2022 00:00;81;22;59;Stellenweiser Regenfall;10;10;0.1;Stadt Konstanz, Amt für Stadtplanung und Umwelt
01.06.2022 01:00;62;20;42;Stellenweiser Regenfall;10;9;0;Stadt Konstanz, Amt für Stadtplanung und Umwelt
01.06.2022 02:00;66;16;50;Leicht bewoelkt;9;9;0;Stadt Konstanz, Amt für Stadtplanung und Umwelt
01.06.2022 03:00;21;2;19;Leicht bewoelkt;9;8;0;Stadt Konstanz, Amt für Stadtplanung und Umwelt
01.06.2022 04:00;23;8;15;Leicht bewoelkt;9;9;0;Stadt Konstanz, Amt für Stadtplanung und Umwelt
01.06.2022 05:00;56;38;18;Sonnig;10;10;0;Stadt Konstanz, Amt für Stadtplanung und Umwelt
01.06.2022 06:00;199;116;83;Sonnig;11;11;0;Stadt Konstanz, Amt für Stadtplanung und Umwelt
01.06.2022 07:00;1009;664;345;Sonnig;13;13;0;Stadt Konstanz, Amt für Stadtplanung und Umwelt
01.06.2022 08:00;911;487;424;Sonnig;15;15;0;Stadt Konstanz, Amt für Stadtplanung und Umwelt
01.06.2022 09:00;843;518;325;Sonnig;17;17;0;Stadt Konstanz, Amt für Stadtplanung und Umwelt
01.06.2022 10:00;616;352;264;Sonnig;18;18;0;Stadt Konstanz, Amt für Stadtplanung und Umwelt
01.06.2022 11:00;718;335;383;Leicht bewoelkt;19;19;0;Stadt Konstanz, Amt für Stadtplanung und Umwelt
01.06.2022 12:00;832;365;467;Leicht bewoelkt;20;20;0;Stadt Konstanz, Amt für Stadtplanung und Umwelt
01.06.2022 13:00;1125;559;566;Leicht bewoelkt;20;20;0;Stadt Konstanz, Amt für Stadtplanung und Umwelt
01.06.2022 14:00;740;356;384;Stellenweiser Regenfall;20;20;0;Stadt Konstanz, Amt für Stadtplanung und Umwelt
01.06.2022 15:00;894;354;540;Stellenweiser Regenfall;19;19;0;Stadt Konstanz, Amt für Stadtplanung und Umwelt
01.06.2022 16:00;761;324;437;Stellenweiser Regenfall;18;18;0;Stadt Konstanz, Amt für Stadtplanung und Umwelt
01.06.2022 17:00;935;401;534;Stellenweiser Regenfall;18;18;0.1;Stadt Konstanz, Amt für Stadtplanung und Umwelt
01.06.2022 18:00;713;256;457;Stellenweiser Regenfall;17;17;0.1;Stadt Konstanz, Amt für Stadtplanung und Umwelt
01.06.2022 19:00;447;209;238;Stellenweiser Regenfall;16;16;0.1;Stadt Konstanz, Amt für Stadtplanung und Umwelt
01.06.2022 20:00;370;201;169;Stellenweiser Regenfall;15;15;0;Stadt Konstanz, Amt für Stadtplanung und Umwelt
01.06.2022 21:00;251;125;126;Stellenweiser Regenfall;13;13;0;Stadt Konstanz, Amt für Stadtplanung und Umwelt
01.06.2022 22:00;220;84;136;Stellenweiser Regenfall;13;13;0;Stadt Konstanz, Amt für Stadtplanung und Umwelt
01.06.2022 23:00;101;44;57;Leichter Regenschauer;12;13;0.1;Stadt Konstanz, Amt für Stadtplanung und Umwelt
02.06.2022 00:00;57;23;34;Leichter Regenschauer;12;12;0.2;Stadt Konstanz, Amt für Stadtplanung und Umwelt
02.06.2022 01:00;36;13;23;Leichter Regenschauer;12;12;0.1;Stadt Konstanz, Amt für Stadtplanung und Umwelt
02.06.2022 02:00;12;9;3;Leichter Regenschauer;11;11;0.2;Stadt Konstanz, Amt für Stadtplanung und Umwelt
02.06.2022 03:00;5;4;1;Leichter Regenschauer;11;11;0.3;Stadt Konstanz, Amt für Stadtplanung und Umwelt
02.06.2022 04:00;9;5;4;Leichter Regenschauer;12;12;0.1;Stadt Konstanz, Amt für Stadtplanung und Umwelt
02.06.2022 05:00;45;32;13;Leichter Regenschauer;12;13;0.2;Stadt Konstanz, Amt für Stadtplanung und Umwelt
02.06.2022 06:00;185;110;75;Leichter Regenschauer;13;13;0.2;Stadt Konstanz, Amt für Stadtplanung und Umwelt
02.06.2022 07:00;924;579;345;Leichter Regenschauer;14;14;0.1;Stadt Konstanz, Amt für Stadtplanung und Umwelt
02.06.2022 08:00;883;486;397;Leichter Regenschauer;15;15;0.1;Stadt Konstanz, Amt für Stadtplanung und Umwelt
02.06.2022 09:00;760;420;340;Leichter Regenschauer;16;16;0.2;Stadt Konstanz, Amt für Stadtplanung und Umwelt
02.06.2022 10:00;585;308;277;Leichter Regenschauer;17;17;0.1;Stadt Konstanz, Amt für Stadtplanung und Umwelt
02.06.2022 11:00;693;333;360;Stellenweiser Regenfall;19;19;0.1;Stadt Konstanz, Amt für Stadtplanung und Umwelt
02.06.2022 12:00;735;317;418;Stellenweiser Regenfall;21;21;0.1;Stadt Konstanz, Amt für Stadtplanung und Umwelt
02.06.2022 13:00;1058;445;613;Stellenweiser Regenfall;22;22;0;Stadt Konstanz, Amt für Stadtplanung und Umwelt
02.06.2022 14:00;772;387;385;Sonnig;23;25;0;Stadt Konstanz, Amt für Stadtplanung und Umwelt
02.06.2022 15:00;1024;507;517;Sonnig;24;25;0;Stadt Konstanz, Amt für Stadtplanung und Umwelt
02.06.2022 16:00;1056;499;557;Sonnig;23;25;0;Stadt Konstanz, Amt für Stadtplanung und Umwelt
02.06.2022 17:00;1122;518;604;Sonnig;22;25;0;Stadt Konstanz, Amt für Stadtplanung und Umwelt
02.06.2022 18:00;929;421;508;Sonnig;22;22;0;Stadt Konstanz, Amt für Stadtplanung und Umwelt
02.06.2022 19:00;684;303;381;Sonnig;19;19;0;Stadt Konstanz, Amt für Stadtplanung und Umwelt
02.06.2022 20:00;536;264;272;Sonnig;17;17;0;Stadt Konstanz, Amt für Stadtplanung und Umwelt
02.06.2022 21:00;402;187;215;Sonnig;15;15;0;Stadt Konstanz, Amt für Stadtplanung und Umwelt
02.06.2022 22:00;337;135;202;Sonnig;14;14;0;Stadt Konstanz, Amt für Stadtplanung und Umwelt
02.06.2022 23:00;281;125;156;Leichter Regenschauer;14;14;0.1;Stadt Konstanz, Amt für Stadtplanung und Umwelt
03.06.2022 00:00;116;46;70;Leichter Regenschauer;13;13;0.1;Stadt Konstanz, Amt für Stadtplanung und Umwelt
03.06.2022 01:00;33;13;20;Leichter Regenschauer;13;13;0.1;Stadt Konstanz, Amt für Stadtplanung und Umwelt
03.06.2022 02:00;35;26;9;Leichter Nebel;13;13;0;Stadt Konstanz, Amt für Stadtplanung und Umwelt
03.06.2022 03:00;17;6;11;Leichter Nebel;12;12;0;Stadt Konstanz, Amt für Stadtplanung und Umwelt
03.06.2022 04:00;22;13;9;Leichter Nebel;13;13;0;Stadt Konstanz, Amt für Stadtplanung und Umwelt
03.06.2022 05:00;52;36;16;Sonnig;14;14;0;Stadt Konstanz, Amt für Stadtplanung und Umwelt
03.06.2022 06:00;194;114;80;Sonnig;14;14;0;Stadt Konstanz, Amt für Stadtplanung und Umwelt
03.06.2022 07:00;853;525;328;Sonnig;16;16;0;Stadt Konstanz, Amt für Stadtplanung und Umwelt
03.06.2022 08:00;848;484;364;Sonnig;19;19;0;Stadt Konstanz, Amt für Stadtplanung und Umwelt
03.06.2022 09:00;804;477;327;Sonnig;21;21;0;Stadt Konstanz, Amt für Stadtplanung und Umwelt
03.06.2022 10:00;652;350;302;Sonnig;22;22;0;Stadt Konstanz, Amt für Stadtplanung und Umwelt
03.06.2022 11:00;698;334;364;Leicht bewoelkt;23;24;0;Stadt Konstanz, Amt für Stadtplanung und Umwelt
03.06.2022 12:00;900;437;463;Leicht bewoelkt;24;26;0;Stadt Konstanz, Amt für Stadtplanung und Umwelt
03.06.2022 13:00;1075;430;645;Leicht bewoelkt;24;26;0;Stadt Konstanz, Amt für Stadtplanung und Umwelt
03.06.2022 14:00;834;423;411;Stellenweise Gewitter und Niederschlaege;24;26;0;Stadt Konstanz, Amt für Stadtplanung und Umwelt
03.06.2022 15:00;797;335;462;Stellenweise Gewitter und Niederschlaege;24;26;0;Stadt Konstanz, Amt für Stadtplanung und Umwelt
03.06.2022 16:00;574;281;293;Stellenweise Gewitter und Niederschlaege;22;23;0;Stadt Konstanz, Amt für Stadtplanung und Umwelt
03.06.2022 17:00;452;231;221;Leichter Regenschauer;20;20;0.3;Stadt Konstanz, Amt für Stadtplanung und Umwelt
03.06.2022 18:00;542;252;290;Leichter Regenschauer;18;18;0.4;Stadt Konstanz, Amt für Stadtplanung und Umwelt
03.06.2022 19:00;535;310;225;Leichter Regenschauer;17;17;0.2;Stadt Konstanz, Amt für Stadtplanung und Umwelt
03.06.2022 20:00;400;258;142;Leichter Nebel;16;16;0;Stadt Konstanz, Amt für Stadtplanung und Umwelt
03.06.2022 21:00;319;168;151;Leichter Nebel;15;15;0;Stadt Konstanz, Amt für Stadtplanung und Umwelt
03.06.2022 22:00;275;103;172;Leichter Nebel;15;15;0;Stadt Konstanz, Amt für Stadtplanung und Umwelt
03.06.2022 23:00;289;55;234;Stellenweiser Regenfall;14;15;0.1;Stadt Konstanz, Amt für Stadtplanung und Umwelt
04.06.2022 00:00;193;43;150;Stellenweiser Regenfall;14;14;0.1;Stadt Konstanz, Amt für Stadtplanung und Umwelt
04.06.2022 01:00;127;28;99;Stellenweiser Regenfall;13;14;0.1;Stadt Konstanz, Amt für Stadtplanung und Umwelt
04.06.2022 02:00;52;13;39;Sonnig;13;13;0;Stadt Konstanz, Amt für Stadtplanung und Umwelt
04.06.2022 03:00;47;15;32;Sonnig;12;12;0;Stadt Konstanz, Amt für Stadtplanung und Umwelt
04.06.2022 04:00;34;17;17;Sonnig;13;13;0;Stadt Konstanz, Amt für Stadtplanung und Umwelt
04.06.2022 05:00;36;17;19;Leichter Nebel;14;14;0;Stadt Konstanz, Amt für Stadtplanung und Umwelt
04.06.2022 06:00;50;30;20;Leichter Nebel;15;16;0;Stadt Konstanz, Amt für Stadtplanung und Umwelt
04.06.2022 07:00;58;32;26;Leichter Nebel;17;17;0;Stadt Konstanz, Amt für Stadtplanung und Umwelt
04.06.2022 08:00;139;75;64;Sonnig;18;19;0;Stadt Konstanz, Amt für Stadtplanung und Umwelt
04.06.2022 09:00;397;239;158;Sonnig;20;20;0;Stadt Konstanz, Amt für Stadtplanung und Umwelt
04.06.2022 10:00;539;301;238;Sonnig;22;22;0;Stadt Konstanz, Amt für Stadtplanung und Umwelt
04.06.2022 11:00;623;344;279;Sonnig;23;24;0;Stadt Konstanz, Amt für Stadtplanung und Umwelt
04.06.2022 12:00;677;341;336;Sonnig;25;26;0;Stadt Konstanz, Amt für Stadtplanung und Umwelt
04.06.2022 13:00;681;337;344;Sonnig;25;26;0;Stadt Konstanz, Amt für Stadtplanung und Umwelt
04.06.2022 14:00;677;325;352;Sonnig;26;27;0;Stadt Konstanz, Amt für Stadtplanung und Umwelt
04.06.2022 15:00;756;359;397;Sonnig;27;27;0;Stadt Konstanz, Amt für Stadtplanung und Umwelt
04.06.2022 16:00;676;311;365;Sonnig;26;27;0;Stadt Konstanz, Amt für Stadtplanung und Umwelt
04.06.2022 17:00;751;353;398;Sonnig;25;26;0;Stadt Konstanz, Amt für Stadtplanung und Umwelt
04.06.2022 18:00;682;332;350;Sonnig;24;26;0;Stadt Konstanz, Amt für Stadtplanung und Umwelt
04.06.2022 19:00;587;309;278;Sonnig;22;22;0;Stadt Konstanz, Amt für Stadtplanung und Umwelt
04.06.2022 20:00;460;242;218;Sonnig;19;19;0;Stadt Konstanz, Amt für Stadtplanung und Umwelt
04.06.2022 21:00;383;179;204;Sonnig;17;17;0;Stadt Konstanz, Amt für Stadtplanung und Umwelt
04.06.2022 22:00;275;126;149;Sonnig;16;17;0;Stadt Konstanz, Amt für Stadtplanung und Umwelt
04.06.2022 23:00;277;79;198;Sonnig;16;16;0;Stadt Konstanz, Amt für Stadtplanung und Umwelt
05.06.2022 00:00;191;37;154;Sonnig;15;15;0;Stadt Konstanz, Amt für Stadtplanung und Umwelt
05.06.2022 01:00;151;38;113;Sonnig;15;15;0;Stadt Konstanz, Amt für Stadtplanung und Umwelt
05.06.2022 02:00;105;26;79;Sonnig;14;15;0;Stadt Konstanz, Amt für Stadtplanung und Umwelt
05.06.2022 03:00;96;42;54;Sonnig;14;15;0;Stadt Konstanz, Amt für Stadtplanung und Umwelt
05.06.2022 04:00;35;14;21;Sonnig;15;16;0;Stadt Konstanz, Amt für Stadtplanung und Umwelt
05.06.2022 05:00;41;21;20;Stellenweise Gewitter und Niederschlaege;16;16;0;Stadt Konstanz, Amt für Stadtplanung und Umwelt
05.06.2022 06:00;40;24;16;Stellenweise Gewitter und Niederschlaege;17;17;0;Stadt Konstanz, Amt für Stadtplanung und Umwelt
05.06.2022 07:00;20;11;9;Stellenweise Gewitter und Niederschlaege;18;18;0;Stadt Konstanz, Amt für Stadtplanung und Umwelt
05.06.2022 08:00;79;41;38;Stellenweiser Regenfall;20;20;0;Stadt Konstanz, Amt für Stadtplanung und Umwelt
05.06.2022 09:00;177;88;89;Stellenweiser Regenfall;21;21;0;Stadt Konstanz, Amt für Stadtplanung und Umwelt
05.06.2022 10:00;283;145;138;Stellenweiser Regenfall;23;26;0;Stadt Konstanz, Amt für Stadtplanung und Umwelt
05.06.2022 11:00;377;186;191;Sonnig;25;27;0;Stadt Konstanz, Amt für Stadtplanung und Umwelt
05.06.2022 12:00;323;152;171;Sonnig;27;28;0;Stadt Konstanz, Amt für Stadtplanung und Umwelt
05.06.2022 13:00;284;148;136;Sonnig;25;27;0;Stadt Konstanz, Amt für Stadtplanung und Umwelt
05.06.2022 14:00;167;98;69;Nieselregen mit Gewitter;24;26;0.2;Stadt Konstanz, Amt für Stadtplanung und Umwelt
05.06.2022 15:00;227;105;122;Nieselregen mit Gewitter;22;25;0.3;Stadt Konstanz, Amt für Stadtplanung und Umwelt
05.06.2022 16:00;219;112;107;Nieselregen mit Gewitter;20;20;0.1;Stadt Konstanz, Amt für Stadtplanung und Umwelt
05.06.2022 17:00;288;164;124;Maessiger bis starker Regenschauer;18;18;01. Mai;Stadt Konstanz, Amt für Stadtplanung und Umwelt
05.06.2022 18:00;187;98;89;Maessiger bis starker Regenschauer;16;16;2;Stadt Konstanz, Amt für Stadtplanung und Umwelt
05.06.2022 19:00;178;95;83;Maessiger bis starker Regenschauer;16;16;1;Stadt Konstanz, Amt für Stadtplanung und Umwelt
05.06.2022 20:00;209;94;115;Leichter Regenschauer;15;15;0.5;Stadt Konstanz, Amt für Stadtplanung und Umwelt
05.06.2022 21:00;151;82;69;Leichter Regenschauer;14;14;0.6;Stadt Konstanz, Amt für Stadtplanung und Umwelt
05.06.2022 22:00;117;36;81;Leichter Regenschauer;13;14;0.3;Stadt Konstanz, Amt für Stadtplanung und Umwelt
05.06.2022 23:00;97;30;67;Stellenweiser Regenfall;13;13;0.1;Stadt Konstanz, Amt für Stadtplanung und Umwelt
06.06.2022 00:00;67;25;42;Stellenweiser Regenfall;12;12;0.2;Stadt Konstanz, Amt für Stadtplanung und Umwelt
06.06.2022 01:00;37;21;16;Stellenweiser Regenfall;12;12;0.1;Stadt Konstanz, Amt für Stadtplanung und Umwelt
06.06.2022 02:00;33;16;17;Sonnig;11;11;0;Stadt Konstanz, Amt für Stadtplanung und Umwelt
06.06.2022 03:00;19;9;10;Sonnig;11;11;0;Stadt Konstanz, Amt für Stadtplanung und Umwelt
06.06.2022 04:00;16;8;8;Sonnig;12;12;0;Stadt Konstanz, Amt für Stadtplanung und Umwelt
06.06.2022 05:00;17;9;8;Sonnig;13;13;0;Stadt Konstanz, Amt für Stadtplanung und Umwelt
06.06.2022 06:00;53;35;18;Sonnig;14;14;0;Stadt Konstanz, Amt für Stadtplanung und Umwelt
06.06.2022 07:00;42;24;18;Sonnig;15;15;0;Stadt Konstanz, Amt für Stadtplanung und Umwelt
06.06.2022 08:00;101;43;58;Sonnig;17;17;0;Stadt Konstanz, Amt für Stadtplanung und Umwelt
06.06.2022 09:00;213;113;100;Sonnig;19;19;0;Stadt Konstanz, Amt für Stadtplanung und Umwelt
06.06.2022 10:00;329;166;163;Sonnig;20;20;0;Stadt Konstanz, Amt für Stadtplanung und Umwelt
06.06.2022 11:00;427;219;208;Bewoelkt;22;22;0;Stadt Konstanz, Amt für Stadtplanung und Umwelt
06.06.2022 12:00;467;233;234;Bewoelkt;23;25;0;Stadt Konstanz, Amt für Stadtplanung und Umwelt
06.06.2022 13:00;512;231;281;Bewoelkt;24;25;0;Stadt Konstanz, Amt für Stadtplanung und Umwelt
06.06.2022 14:00;644;350;294;Stellenweiser Regenfall;24;25;0;Stadt Konstanz, Amt für Stadtplanung und Umwelt
06.06.2022 15:00;539;284;255;Stellenweiser Regenfall;24;25;0;Stadt Konstanz, Amt für Stadtplanung und Umwelt
06.06.2022 16:00;520;266;254;Stellenweiser Regenfall;23;24;0;Stadt Konstanz, Amt für Stadtplanung und Umwelt
06.06.2022 17:00;560;259;301;Stellenweiser Regenfall;22;22;0.1;Stadt Konstanz, Amt für Stadtplanung und Umwelt
06.06.2022 18:00;488;257;231;Stellenweiser Regenfall;21;21;0.1;Stadt Konstanz, Amt für Stadtplanung und Umwelt
06.06.2022 19:00;430;220;210;Stellenweiser Regenfall;19;19;0.1;Stadt Konstanz, Amt für Stadtplanung und Umwelt
06.06.2022 20:00;339;154;185;Bewoelkt;17;17;0;Stadt Konstanz, Amt für Stadtplanung und Umwelt
06.06.2022 21:00;255;87;168;Bewoelkt;15;15;0;Stadt Konstanz, Amt für Stadtplanung und Umwelt
06.06.2022 22:00;175;69;106;Bewoelkt;14;14;0;Stadt Konstanz, Amt für Stadtplanung und Umwelt
06.06.2022 23:00;81;46;35;Stellenweiser Regenfall;13;13;0;Stadt Konstanz, Amt für Stadtplanung und Umwelt
07.06.2022 00:00;36;16;20;Stellenweiser Regenfall;12;12;0.1;Stadt Konstanz, Amt für Stadtplanung und Umwelt
07.06.2022 01:00;34;17;17;Stellenweiser Regenfall;12;12;0;Stadt Konstanz, Amt für Stadtplanung und Umwelt
07.06.2022 02:00;11;5;6;Leichter Nebel;12;12;0;Stadt Konstanz, Amt für Stadtplanung und Umwelt
07.06.2022 03:00;13;9;4;Leichter Nebel;12;12;0;Stadt Konstanz, Amt für Stadtplanung und Umwelt
07.06.2022 04:00;8;5;3;Leichter Nebel;12;12;0;Stadt Konstanz, Amt für Stadtplanung und Umwelt
07.06.2022 05:00;39;22;17;Leichter Nebel;12;13;0;Stadt Konstanz, Amt für Stadtplanung und Umwelt
07.06.2022 06:00;102;59;43;Leichter Nebel;13;13;0;Stadt Konstanz, Amt für Stadtplanung und Umwelt
07.06.2022 07:00;247;126;121;Leichter Nebel;14;14;0;Stadt Konstanz, Amt für Stadtplanung und Umwelt
07.06.2022 08:00;420;220;200;Leicht bewoelkt;15;15;0;Stadt Konstanz, Amt für Stadtplanung und Umwelt
07.06.2022 09:00;360;186;174;Leicht bewoelkt;16;16;0;Stadt Konstanz, Amt für Stadtplanung und Umwelt
07.06.2022 10:00;358;208;150;Leicht bewoelkt;17;17;0;Stadt Konstanz, Amt für Stadtplanung und Umwelt
07.06.2022 11:00;401;208;193;Leichter Regenschauer;17;17;0.2;Stadt Konstanz, Amt für Stadtplanung und Umwelt
07.06.2022 12:00;431;211;220;Leichter Regenschauer;18;18;0.2;Stadt Konstanz, Amt für Stadtplanung und Umwelt
07.06.2022 13:00;347;181;166;Leichter Regenschauer;18;18;0.1;Stadt Konstanz, Amt für Stadtplanung und Umwelt
07.06.2022 14:00;399;177;222;Stellenweise Gewitter und Niederschlaege;18;18;0;Stadt Konstanz, Amt für Stadtplanung und Umwelt
07.06.2022 15:00;422;210;212;Stellenweise Gewitter und Niederschlaege;19;19;0;Stadt Konstanz, Amt für Stadtplanung und Umwelt
07.06.2022 16:00;490;241;249;Stellenweise Gewitter und Niederschlaege;18;18;0;Stadt Konstanz, Amt für Stadtplanung und Umwelt
07.06.2022 17:00;536;282;254;Leichter Regenschauer;18;18;0.3;Stadt Konstanz, Amt für Stadtplanung und Umwelt
07.06.2022 18:00;480;213;267;Leichter Regenschauer;18;18;0.4;Stadt Konstanz, Amt für Stadtplanung und Umwelt
07.06.2022 19:00;415;205;210;Leichter Regenschauer;16;15;0.2;Stadt Konstanz, Amt für Stadtplanung und Umwelt
07.06.2022 20:00;347;168;179;Sonnig;14;13;0;Stadt Konstanz, Amt für Stadtplanung und Umwelt
07.06.2022 21:00;273;124;149;Sonnig;12;11;0;Stadt Konstanz, Amt für Stadtplanung und Umwelt
07.06.2022 22:00;168;63;105;Sonnig;11;11;0;Stadt Konstanz, Amt für Stadtplanung und Umwelt
07.06.2022 23:00;94;48;46;Stellenweiser Regenfall;11;11;0;Stadt Konstanz, Amt für Stadtplanung und Umwelt
08.06.2022 00:00;65;31;34;Stellenweiser Regenfall;10;10;0.1;Stadt Konstanz, Amt für Stadtplanung und Umwelt
08.06.2022 01:00;40;21;19;Stellenweiser Regenfall;10;10;0;Stadt Konstanz, Amt für Stadtplanung und Umwelt
08.06.2022 02:00;21;12;9;Sonnig;10;10;0;Stadt Konstanz, Amt für Stadtplanung und Umwelt
08.06.2022 03:00;8;4;4;Sonnig;10;10;0;Stadt Konstanz, Amt für Stadtplanung und Umwelt
08.06.2022 04:00;14;9;5;Sonnig;10;10;0;Stadt Konstanz, Amt für Stadtplanung und Umwelt
08.06.2022 05:00;53;36;17;Leicht bewoelkt;11;11;0;Stadt Konstanz, Amt für Stadtplanung und Umwelt
08.06.2022 06:00;165;102;63;Leicht bewoelkt;12;12;0;Stadt Konstanz, Amt für Stadtplanung und Umwelt
08.06.2022 07:00;354;180;174;Leicht bewoelkt;14;14;0;Stadt Konstanz, Amt für Stadtplanung und Umwelt
08.06.2022 08:00;545;276;269;Sonnig;16;16;0;Stadt Konstanz, Amt für Stadtplanung und Umwelt
08.06.2022 09:00;617;318;299;Sonnig;17;17;0;Stadt Konstanz, Amt für Stadtplanung und Umwelt
08.06.2022 10:00;608;336;272;Sonnig;19;19;0;Stadt Konstanz, Amt für Stadtplanung und Umwelt
08.06.2022 11:00;528;252;276;Leicht bewoelkt;20;20;0;Stadt Konstanz, Amt für Stadtplanung und Umwelt
08.06.2022 12:00;640;323;317;Leicht bewoelkt;21;21;0;Stadt Konstanz, Amt für Stadtplanung und Umwelt
08.06.2022 13:00;556;270;286;Leicht bewoelkt;21;21;0;Stadt Konstanz, Amt für Stadtplanung und Umwelt
08.06.2022 14:00;701;340;361;Leicht bewoelkt;22;22;0;Stadt Konstanz, Amt für Stadtplanung und Umwelt
08.06.2022 15:00;756;340;416;Leicht bewoelkt;22;22;0;Stadt Konstanz, Amt für Stadtplanung und Umwelt
08.06.2022 16:00;793;345;448;Leicht bewoelkt;20;19;0;Stadt Konstanz, Amt für Stadtplanung und Umwelt
08.06.2022 17:00;539;234;305;Stellenweiser Regenfall;17;16;0;Stadt Konstanz, Amt für Stadtplanung und Umwelt
08.06.2022 18:00;521;227;294;Stellenweiser Regenfall;15;14;0;Stadt Konstanz, Amt für Stadtplanung und Umwelt
08.06.2022 19:00;421;219;202;Stellenweiser Regenfall;14;14;0;Stadt Konstanz, Amt für Stadtplanung und Umwelt
08.06.2022 20:00;291;153;138;Leichter Nebel;14;13;0;Stadt Konstanz, Amt für Stadtplanung und Umwelt
08.06.2022 21:00;265;138;127;Leichter Nebel;13;13;0;Stadt Konstanz, Amt für Stadtplanung und Umwelt
08.06.2022 22:00;251;101;150;Leichter Nebel;13;12;0;Stadt Konstanz, Amt für Stadtplanung und Umwelt
08.06.2022 23:00;137;51;86;Leichter Regenschauer;12;11;0.1;Stadt Konstanz, Amt für Stadtplanung und Umwelt
09.06.2022 00:00;60;26;34;Leichter Regenschauer;12;10;0.1;Stadt Konstanz, Amt für Stadtplanung und Umwelt
09.06.2022 01:00;42;10;32;Leichter Regenschauer;12;10;0.1;Stadt Konstanz, Amt für Stadtplanung und Umwelt
09.06.2022 02:00;23;10;13;Leichter Regenschauer;11;11;0.1;Stadt Konstanz, Amt für Stadtplanung und Umwelt
09.06.2022 03:00;14;3;11;Leichter Regenschauer;11;11;0.1;Stadt Konstanz, Amt für Stadtplanung und Umwelt
09.06.2022 04:00;10;5;5;Leichter Regenschauer;12;11;0;Stadt Konstanz, Amt für Stadtplanung und Umwelt
09.06.2022 05:00;36;26;10;Leichter Regenschauer;12;11;0.1;Stadt Konstanz, Amt für Stadtplanung und Umwelt
09.06.2022 06:00;146;75;71;Leichter Regenschauer;12;11;0.2;Stadt Konstanz, Amt für Stadtplanung und Umwelt
09.06.2022 07:00;325;155;170;Leichter Regenschauer;13;12;0.1;Stadt Konstanz, Amt für Stadtplanung und Umwelt
09.06.2022 08:00;459;210;249;Stellenweiser Regenfall;14;13;0.1;Stadt Konstanz, Amt für Stadtplanung und Umwelt
09.06.2022 09:00;330;182;148;Stellenweiser Regenfall;15;14;0.2;Stadt Konstanz, Amt für Stadtplanung und Umwelt
09.06.2022 10:00;185;94;91;Stellenweiser Regenfall;15;14;0.1;Stadt Konstanz, Amt für Stadtplanung und Umwelt
09.06.2022 11:00;228;121;107;Leichter Regenschauer;15;14;0.2;Stadt Konstanz, Amt für Stadtplanung und Umwelt
09.06.2022 12:00;299;135;164;Leichter Regenschauer;15;14;0.3;Stadt Konstanz, Amt für Stadtplanung und Umwelt
09.06.2022 13:00;385;191;194;Leichter Regenschauer;14;13;0.2;Stadt Konstanz, Amt für Stadtplanung und Umwelt
09.06.2022 14:00;404;204;200;Leichter Regenfall;12;11;0.7;Stadt Konstanz, Amt für Stadtplanung und Umwelt
09.06.2022 15:00;484;232;252;Leichter Regenfall;11;10;0.9;Stadt Konstanz, Amt für Stadtplanung und Umwelt
09.06.2022 16:00;576;275;301;Leichter Regenfall;11;10;0.4;Stadt Konstanz, Amt für Stadtplanung und Umwelt
09.06.2022 17:00;657;327;330;Leichter Regenschauer;11;10;0.5;Stadt Konstanz, Amt für Stadtplanung und Umwelt
09.06.2022 18:00;562;265;297;Leichter Regenschauer;11;11;0.7;Stadt Konstanz, Amt für Stadtplanung und Umwelt
09.06.2022 19:00;375;153;222;Leichter Regenschauer;10;9;0.3;Stadt Konstanz, Amt für Stadtplanung und Umwelt
09.06.2022 20:00;267;138;129;Leichter Regenschauer;9;8;0.1;Stadt Konstanz, Amt für Stadtplanung und Umwelt
09.06.2022 21:00;229;108;121;Leichter Regenschauer;8;6;0.1;Stadt Konstanz, Amt für Stadtplanung und Umwelt
09.06.2022 22:00;188;81;107;Leichter Regenschauer;8;7;0.1;Stadt Konstanz, Amt für Stadtplanung und Umwelt
09.06.2022 23:00;121;43;78;Stellenweiser Regenfall;8;7;0;Stadt Konstanz, Amt für Stadtplanung und Umwelt
10.06.2022 00:00;60;32;28;Stellenweiser Regenfall;8;8;0.1;Stadt Konstanz, Amt für Stadtplanung und Umwelt
10.06.2022 01:00;47;30;17;Stellenweiser Regenfall;7;7;0;Stadt Konstanz, Amt für Stadtplanung und Umwelt
10.06.2022 02:00;12;7;5;Bewoelkt;7;7;0;Stadt Konstanz, Amt für Stadtplanung und Umwelt
10.06.2022 03:00;9;2;7;Bewoelkt;6;6;0;Stadt Konstanz, Amt für Stadtplanung und Umwelt
10.06.2022 04:00;9;8;1;Bewoelkt;7;7;0;Stadt Konstanz, Amt für Stadtplanung und Umwelt
10.06.2022 05:00;53;34;19;Leicht bewoelkt;8;8;0;Stadt Konstanz, Amt für Stadtplanung und Umwelt
10.06.2022 06:00;154;89;65;Leicht bewoelkt;9;9;0;Stadt Konstanz, Amt für Stadtplanung und Umwelt
10.06.2022 07:00;377;186;191;Leicht bewoelkt;11;11;0;Stadt Konstanz, Amt für Stadtplanung und Umwelt
10.06.2022 08:00;539;287;252;Sonnig;13;13;0;Stadt Konstanz, Amt für Stadtplanung und Umwelt
10.06.2022 09:00;571;316;255;Sonnig;16;16;0;Stadt Konstanz, Amt für Stadtplanung und Umwelt
10.06.2022 10:00;591;321;270;Sonnig;17;17;0;Stadt Konstanz, Amt für Stadtplanung und Umwelt
10.06.2022 11:00;678;331;347;Sonnig;18;18;0;Stadt Konstanz, Amt für Stadtplanung und Umwelt
10.06.2022 12:00;749;371;378;Sonnig;20;20;0;Stadt Konstanz, Amt für Stadtplanung und Umwelt
10.06.2022 13:00;714;350;364;Sonnig;20;20;0;Stadt Konstanz, Amt für Stadtplanung und Umwelt
10.06.2022 14:00;687;340;347;Sonnig;20;20;0;Stadt Konstanz, Amt für Stadtplanung und Umwelt
10.06.2022 15:00;715;358;357;Sonnig;21;21;0;Stadt Konstanz, Amt für Stadtplanung und Umwelt
10.06.2022 16:00;807;413;394;Sonnig;21;21;0;Stadt Konstanz, Amt für Stadtplanung und Umwelt
10.06.2022 17:00;789;391;398;Sonnig;20;20;0;Stadt Konstanz, Amt für Stadtplanung und Umwelt
10.06.2022 18:00;768;365;403;Sonnig;20;20;0;Stadt Konstanz, Amt für Stadtplanung und Umwelt
10.06.2022 19:00;601;294;307;Sonnig;17;17;0;Stadt Konstanz, Amt für Stadtplanung und Umwelt
10.06.2022 20:00;467;211;256;Sonnig;15;15;0;Stadt Konstanz, Amt für Stadtplanung und Umwelt
10.06.2022 21:00;373;165;208;Sonnig;12;12;0;Stadt Konstanz, Amt für Stadtplanung und Umwelt
10.06.2022 22:00;262;87;175;Sonnig;11;11;0;Stadt Konstanz, Amt für Stadtplanung und Umwelt
10.06.2022 23:00;204;80;124;Sonnig;11;11;0;Stadt Konstanz, Amt für Stadtplanung und Umwelt
11.06.2022 00:00;156;51;105;Sonnig;10;10;0;Stadt Konstanz, Amt für Stadtplanung und Umwelt
11.06.2022 01:00;87;31;56;Sonnig;9;9;0;Stadt Konstanz, Amt für Stadtplanung und Umwelt
11.06.2022 02:00;72;22;50;Sonnig;9;9;0;Stadt Konstanz, Amt für Stadtplanung und Umwelt
11.06.2022 03:00;51;27;24;Sonnig;9;9;0;Stadt Konstanz, Amt für Stadtplanung und Umwelt
11.06.2022 04:00;21;13;8;Sonnig;9;9;0;Stadt Konstanz, Amt für Stadtplanung und Umwelt
11.06.2022 05:00;32;19;13;Sonnig;10;10;0;Stadt Konstanz, Amt für Stadtplanung und Umwelt
11.06.2022 06:00;58;34;24;Sonnig;11;11;0;Stadt Konstanz, Amt für Stadtplanung und Umwelt
11.06.2022 07:00;92;50;42;Sonnig;14;14;0;Stadt Konstanz, Amt für Stadtplanung und Umwelt
11.06.2022 08:00;216;113;103;Sonnig;16;16;0;Stadt Konstanz, Amt für Stadtplanung und Umwelt
11.06.2022 09:00;396;218;178;Sonnig;19;19;0;Stadt Konstanz, Amt für Stadtplanung und Umwelt
11.06.2022 10:00;574;349;225;Sonnig;20;20;0;Stadt Konstanz, Amt für Stadtplanung und Umwelt
11.06.2022 11:00;649;372;277;Sonnig;22;22;0;Stadt Konstanz, Amt für Stadtplanung und Umwelt
11.06.2022 12:00;665;338;327;Sonnig;23;25;0;Stadt Konstanz, Amt für Stadtplanung und Umwelt
11.06.2022 13:00;627;308;319;Sonnig;23;25;0;Stadt Konstanz, Amt für Stadtplanung und Umwelt
11.06.2022 14:00;701;341;360;Sonnig;24;25;0;Stadt Konstanz, Amt für Stadtplanung und Umwelt
11.06.2022 15:00;676;305;371;Sonnig;24;25;0;Stadt Konstanz, Amt für Stadtplanung und Umwelt
11.06.2022 16:00;653;321;332;Sonnig;24;25;0;Stadt Konstanz, Amt für Stadtplanung und Umwelt
11.06.2022 17:00;661;329;332;Sonnig;24;25;0;Stadt Konstanz, Amt für Stadtplanung und Umwelt
11.06.2022 18:00;628;319;309;Sonnig;23;25;0;Stadt Konstanz, Amt für Stadtplanung und Umwelt
11.06.2022 19:00;531;300;231;Sonnig;20;20;0;Stadt Konstanz, Amt für Stadtplanung und Umwelt
11.06.2022 20:00;446;218;228;Sonnig;17;18;0;Stadt Konstanz, Amt für Stadtplanung und Umwelt
11.06.2022 21:00;372;176;196;Sonnig;15;15;0;Stadt Konstanz, Amt für Stadtplanung und Umwelt
11.06.2022 22:00;289;131;158;Sonnig;14;14;0;Stadt Konstanz, Amt für Stadtplanung und Umwelt
11.06.2022 23:00;229;65;164;Sonnig;13;13;0;Stadt Konstanz, Amt für Stadtplanung und Umwelt
12.06.2022 00:00;148;42;106;Sonnig;12;12;0;Stadt Konstanz, Amt für Stadtplanung und Umwelt
12.06.2022 01:00;82;29;53;Sonnig;12;12;0;Stadt Konstanz, Amt für Stadtplanung und Umwelt
12.06.2022 02:00;66;26;40;Sonnig;11;11;0;Stadt Konstanz, Amt für Stadtplanung und Umwelt
12.06.2022 03:00;54;24;30;Sonnig;11;11;0;Stadt Konstanz, Amt für Stadtplanung und Umwelt
12.06.2022 04:00;26;12;14;Sonnig;12;12;0;Stadt Konstanz, Amt für Stadtplanung und Umwelt
12.06.2022 05:00;24;12;12;Sonnig;13;13;0;Stadt Konstanz, Amt für Stadtplanung und Umwelt
12.06.2022 06:00;43;25;18;Sonnig;13;13;0;Stadt Konstanz, Amt für Stadtplanung und Umwelt
12.06.2022 07:00;58;27;31;Sonnig;16;16;0;Stadt Konstanz, Amt für Stadtplanung und Umwelt
12.06.2022 08:00;116;57;59;Sonnig;18;18;0;Stadt Konstanz, Amt für Stadtplanung und Umwelt
12.06.2022 09:00;330;201;129;Sonnig;21;21;0;Stadt Konstanz, Amt für Stadtplanung und Umwelt
12.06.2022 10:00;427;224;203;Sonnig;22;23;0;Stadt Konstanz, Amt für Stadtplanung und Umwelt
12.06.2022 11:00;596;366;230;Sonnig;24;24;0;Stadt Konstanz, Amt für Stadtplanung und Umwelt
12.06.2022 12:00;708;402;306;Sonnig;25;26;0;Stadt Konstanz, Amt für Stadtplanung und Umwelt
12.06.2022 13:00;768;380;388;Sonnig;26;27;0;Stadt Konstanz, Amt für Stadtplanung und Umwelt
12.06.2022 14:00;717;342;375;Sonnig;28;28;0;Stadt Konstanz, Amt für Stadtplanung und Umwelt
12.06.2022 15:00;673;308;365;Sonnig;29;29;0;Stadt Konstanz, Amt für Stadtplanung und Umwelt
12.06.2022 16:00;649;288;361;Sonnig;28;28;0;Stadt Konstanz, Amt für Stadtplanung und Umwelt
12.06.2022 17:00;618;281;337;Sonnig;26;28;0;Stadt Konstanz, Amt für Stadtplanung und Umwelt
12.06.2022 18:00;596;263;333;Sonnig;25;27;0;Stadt Konstanz, Amt für Stadtplanung und Umwelt
12.06.2022 19:00;522;232;290;Sonnig;22;23;0;Stadt Konstanz, Amt für Stadtplanung und Umwelt
12.06.2022 20:00;388;161;227;Sonnig;19;19;0;Stadt Konstanz, Amt für Stadtplanung und Umwelt
12.06.2022 21:00;288;114;174;Sonnig;16;16;0;Stadt Konstanz, Amt für Stadtplanung und Umwelt
12.06.2022 22:00;198;72;126;Sonnig;16;16;0;Stadt Konstanz, Amt für Stadtplanung und Umwelt
12.06.2022 23:00;78;32;46;Leichter Regenschauer;15;15;0.1;Stadt Konstanz, Amt für Stadtplanung und Umwelt
13.06.2022 00:00;29;16;13;Leichter Regenschauer;14;14;0.3;Stadt Konstanz, Amt für Stadtplanung und Umwelt
13.06.2022 01:00;20;9;11;Leichter Regenschauer;14;14;0.1;Stadt Konstanz, Amt für Stadtplanung und Umwelt
13.06.2022 02:00;6;5;1;Leichter Regenschauer;14;14;0.2;Stadt Konstanz, Amt für Stadtplanung und Umwelt
13.06.2022 03:00;6;6;0;Leichter Regenschauer;14;14;0.2;Stadt Konstanz, Amt für Stadtplanung und Umwelt
13.06.2022 04:00;12;7;5;Leichter Regenschauer;14;14;0.1;Stadt Konstanz, Amt für Stadtplanung und Umwelt
13.06.2022 05:00;33;17;16;Leichter Regenschauer;14;14;0.5;Stadt Konstanz, Amt für Stadtplanung und Umwelt
13.06.2022 06:00;129;75;54;Leichter Regenschauer;15;15;0.6;Stadt Konstanz, Amt für Stadtplanung und Umwelt
13.06.2022 07:00;362;196;166;Leichter Regenschauer;15;15;0.3;Stadt Konstanz, Amt für Stadtplanung und Umwelt
13.06.2022 08:00;587;323;264;Leichter Regenschauer;15;16;0.2;Stadt Konstanz, Amt für Stadtplanung und Umwelt
13.06.2022 09:00;503;321;182;Leichter Regenschauer;16;16;0.3;Stadt Konstanz, Amt für Stadtplanung und Umwelt
13.06.2022 10:00;425;245;180;Leichter Regenschauer;17;17;0.1;Stadt Konstanz, Amt für Stadtplanung und Umwelt
13.06.2022 11:00;536;311;225;Stellenweiser Regenfall;19;19;0.1;Stadt Konstanz, Amt für Stadtplanung und Umwelt
13.06.2022 12:00;578;289;289;Stellenweiser Regenfall;21;21;0.2;Stadt Konstanz, Amt für Stadtplanung und Umwelt
13.06.2022 13:00;698;376;322;Stellenweiser Regenfall;22;22;0.1;Stadt Konstanz, Amt für Stadtplanung und Umwelt
13.06.2022 14:00;596;297;299;Sonnig;23;23;0;Stadt Konstanz, Amt für Stadtplanung und Umwelt
13.06.2022 15:00;731;365;366;Sonnig;24;25;0;Stadt Konstanz, Amt für Stadtplanung und Umwelt
13.06.2022 16:00;789;365;424;Sonnig;23;25;0;Stadt Konstanz, Amt für Stadtplanung und Umwelt
13.06.2022 17:00;904;428;476;Sonnig;22;25;0;Stadt Konstanz, Amt für Stadtplanung und Umwelt
13.06.2022 18:00;825;362;463;Sonnig;22;22;0;Stadt Konstanz, Amt für Stadtplanung und Umwelt
13.06.2022 19:00;698;294;404;Sonnig;19;19;0;Stadt Konstanz, Amt für Stadtplanung und Umwelt
13.06.2022 20:00;449;196;253;Sonnig;16;15;0;Stadt Konstanz, Amt für Stadtplanung und Umwelt
13.06.2022 21:00;355;154;201;Sonnig;13;12;0;Stadt Konstanz, Amt für Stadtplanung und Umwelt
13.06.2022 22:00;226;86;140;Sonnig;12;12;0;Stadt Konstanz, Amt für Stadtplanung und Umwelt
13.06.2022 23:00;115;51;64;Sonnig;11;11;0;Stadt Konstanz, Amt für Stadtplanung und Umwelt
14.06.2022 00:00;53;24;29;Sonnig;11;11;0;Stadt Konstanz, Amt für Stadtplanung und Umwelt
14.06.2022 01:00;36;16;20;Sonnig;10;10;0;Stadt Konstanz, Amt für Stadtplanung und Umwelt
14.06.2022 02:00;11;6;5;Sonnig;9;10;0;Stadt Konstanz, Amt für Stadtplanung und Umwelt
14.06.2022 03:00;12;8;4;Sonnig;9;9;0;Stadt Konstanz, Amt für Stadtplanung und Umwelt
14.06.2022 04:00;14;8;6;Sonnig;10;10;0;Stadt Konstanz, Amt für Stadtplanung und Umwelt
14.06.2022 05:00;62;42;20;Sonnig;11;11;0;Stadt Konstanz, Amt für Stadtplanung und Umwelt
14.06.2022 06:00;178;98;80;Sonnig;12;12;0;Stadt Konstanz, Amt für Stadtplanung und Umwelt
14.06.2022 07:00;541;339;202;Sonnig;14;14;0;Stadt Konstanz, Amt für Stadtplanung und Umwelt
14.06.2022 08:00;641;377;264;Sonnig;16;16;0;Stadt Konstanz, Amt für Stadtplanung und Umwelt
14.06.2022 09:00;695;436;259;Sonnig;18;18;0;Stadt Konstanz, Amt für Stadtplanung und Umwelt
14.06.2022 10:00;630;363;267;Sonnig;19;19;0;Stadt Konstanz, Amt für Stadtplanung und Umwelt
14.06.2022 11:00;670;356;314;Sonnig;21;21;0;Stadt Konstanz, Amt für Stadtplanung und Umwelt
14.06.2022 12:00;782;353;429;Sonnig;22;24;0;Stadt Konstanz, Amt für Stadtplanung und Umwelt
14.06.2022 13:00;781;384;397;Sonnig;23;25;0;Stadt Konstanz, Amt für Stadtplanung und Umwelt
14.06.2022 14:00;713;351;362;Leicht bewoelkt;23;25;0;Stadt Konstanz, Amt für Stadtplanung und Umwelt
14.06.2022 15:00;836;415;421;Leicht bewoelkt;24;25;0;Stadt Konstanz, Amt für Stadtplanung und Umwelt
14.06.2022 16:00;879;407;472;Leicht bewoelkt;24;25;0;Stadt Konstanz, Amt für Stadtplanung und Umwelt
14.06.2022 17:00;1039;510;529;Sonnig;24;25;0;Stadt Konstanz, Amt für Stadtplanung und Umwelt
14.06.2022 18:00;966;421;545;Sonnig;24;26;0;Stadt Konstanz, Amt für Stadtplanung und Umwelt
14.06.2022 19:00;791;357;434;Sonnig;21;21;0;Stadt Konstanz, Amt für Stadtplanung und Umwelt
14.06.2022 20:00;586;237;349;Leicht bewoelkt;17;17;0;Stadt Konstanz, Amt für Stadtplanung und Umwelt
14.06.2022 21:00;419;162;257;Leicht bewoelkt;14;14;0;Stadt Konstanz, Amt für Stadtplanung und Umwelt
14.06.2022 22:00;297;126;171;Leicht bewoelkt;13;13;0;Stadt Konstanz, Amt für Stadtplanung und Umwelt
14.06.2022 23:00;175;56;119;Sonnig;12;12;0;Stadt Konstanz, Amt für Stadtplanung und Umwelt
15.06.2022 00:00;77;24;53;Sonnig;11;11;0;Stadt Konstanz, Amt für Stadtplanung und Umwelt
15.06.2022 01:00;50;22;28;Sonnig;11;11;0;Stadt Konstanz, Amt für Stadtplanung und Umwelt
15.06.2022 02:00;18;10;8;Leicht bewoelkt;11;11;0;Stadt Konstanz, Amt für Stadtplanung und Umwelt
15.06.2022 03:00;9;5;4;Leicht bewoelkt;10;10;0;Stadt Konstanz, Amt für Stadtplanung und Umwelt
15.06.2022 04:00;23;16;7;Leicht bewoelkt;11;11;0;Stadt Konstanz, Amt für Stadtplanung und Umwelt
15.06.2022 05:00;60;32;28;Sonnig;12;12;0;Stadt Konstanz, Amt für Stadtplanung und Umwelt
15.06.2022 06:00;168;100;68;Sonnig;13;13;0;Stadt Konstanz, Amt für Stadtplanung und Umwelt
15.06.2022 07:00;545;349;196;Sonnig;16;16;0;Stadt Konstanz, Amt für Stadtplanung und Umwelt
15.06.2022 08:00;671;371;300;Sonnig;18;18;0;Stadt Konstanz, Amt für Stadtplanung und Umwelt
15.06.2022 09:00;674;410;264;Sonnig;21;21;0;Stadt Konstanz, Amt für Stadtplanung und Umwelt
15.06.2022 10:00;561;335;226;Sonnig;23;24;0;Stadt Konstanz, Amt für Stadtplanung und Umwelt
15.06.2022 11:00;682;349;333;Sonnig;26;27;0;Stadt Konstanz, Amt für Stadtplanung und Umwelt
15.06.2022 12:00;733;341;392;Sonnig;28;29;0;Stadt Konstanz, Amt für Stadtplanung und Umwelt
15.06.2022 13:00;754;387;367;Sonnig;29;30;0;Stadt Konstanz, Amt für Stadtplanung und Umwelt
15.06.2022 14:00;708;331;377;Sonnig;30;31;0;Stadt Konstanz, Amt für Stadtplanung und Umwelt
15.06.2022 15:00;851;389;462;Sonnig;30;31;0;Stadt Konstanz, Amt für Stadtplanung und Umwelt
15.06.2022 16:00;896;407;489;Sonnig;29;31;0;Stadt Konstanz, Amt für Stadtplanung und Umwelt
15.06.2022 17:00;978;474;504;Sonnig;28;30;0;Stadt Konstanz, Amt für Stadtplanung und Umwelt
15.06.2022 18:00;916;440;476;Sonnig;27;29;0;Stadt Konstanz, Amt für Stadtplanung und Umwelt
15.06.2022 19:00;708;320;388;Sonnig;24;25;0;Stadt Konstanz, Amt für Stadtplanung und Umwelt
15.06.2022 20:00;579;303;276;Stellenweise Gewitter und Niederschlaege;21;21;0;Stadt Konstanz, Amt für Stadtplanung und Umwelt
15.06.2022 21:00;511;257;254;Stellenweise Gewitter und Niederschlaege;18;18;0;Stadt Konstanz, Amt für Stadtplanung und Umwelt
15.06.2022 22:00;364;145;219;Stellenweise Gewitter und Niederschlaege;17;17;0;Stadt Konstanz, Amt für Stadtplanung und Umwelt
15.06.2022 23:00;249;75;174;Sonnig;16;16;0;Stadt Konstanz, Amt für Stadtplanung und Umwelt
16.06.2022 00:00;161;42;119;Sonnig;16;16;0;Stadt Konstanz, Amt für Stadtplanung und Umwelt
16.06.2022 01:00;92;33;59;Sonnig;15;15;0;Stadt Konstanz, Amt für Stadtplanung und Umwelt
16.06.2022 02:00;78;32;46;Stellenweiser Regenfall;15;15;0;Stadt Konstanz, Amt für Stadtplanung und Umwelt
16.06.2022 03:00;50;22;28;Stellenweiser Regenfall;14;15;0;Stadt Konstanz, Amt für Stadtplanung und Umwelt
16.06.2022 04:00;32;16;16;Stellenweiser Regenfall;15;15;0;Stadt Konstanz, Amt für Stadtplanung und Umwelt
16.06.2022 05:00;49;28;21;Stellenweiser Regenfall;15;15;0.1;Stadt Konstanz, Amt für Stadtplanung und Umwelt
16.06.2022 06:00;83;63;20;Stellenweiser Regenfall;15;15;0.1;Stadt Konstanz, Amt für Stadtplanung und Umwelt
16.06.2022 07:00;101;64;37;Stellenweiser Regenfall;17;17;0;Stadt Konstanz, Amt für Stadtplanung und Umwelt
16.06.2022 08:00;204;106;98;Nieselregen mit Gewitter;19;19;0.1;Stadt Konstanz, Amt für Stadtplanung und Umwelt
16.06.2022 09:00;295;163;132;Nieselregen mit Gewitter;21;21;0.2;Stadt Konstanz, Amt für Stadtplanung und Umwelt
16.06.2022 10:00;452;260;192;Nieselregen mit Gewitter;22;22;0.1;Stadt Konstanz, Amt für Stadtplanung und Umwelt
16.06.2022 11:00;473;228;245;Nieselregen mit Gewitter;23;24;0.2;Stadt Konstanz, Amt für Stadtplanung und Umwelt
16.06.2022 12:00;486;213;273;Nieselregen mit Gewitter;25;26;0.3;Stadt Konstanz, Amt für Stadtplanung und Umwelt
16.06.2022 13:00;428;217;211;Nieselregen mit Gewitter;24;26;0.2;Stadt Konstanz, Amt für Stadtplanung und Umwelt
16.06.2022 14:00;455;243;212;Stellenweiser Nieselregen;24;26;0.1;Stadt Konstanz, Amt für Stadtplanung und Umwelt
16.06.2022 15:00;476;228;248;Stellenweiser Nieselregen;23;25;0.1;Stadt Konstanz, Amt für Stadtplanung und Umwelt
16.06.2022 16:00;523;257;266;Stellenweiser Nieselregen;23;25;0;Stadt Konstanz, Amt für Stadtplanung und Umwelt
16.06.2022 17:00;573;280;293;Stellenweiser Regenfall;22;25;0.1;Stadt Konstanz, Amt für Stadtplanung und Umwelt
16.06.2022 18:00;657;328;329;Stellenweiser Regenfall;22;25;0.2;Stadt Konstanz, Amt für Stadtplanung und Umwelt
16.06.2022 19:00;595;286;309;Stellenweiser Regenfall;20;20;0.1;Stadt Konstanz, Amt für Stadtplanung und Umwelt
16.06.2022 20:00;452;207;245;Sonnig;19;19;0;Stadt Konstanz, Amt für Stadtplanung und Umwelt
16.06.2022 21:00;391;157;234;Sonnig;17;17;0;Stadt Konstanz, Amt für Stadtplanung und Umwelt
16.06.2022 22:00;318;117;201;Sonnig;17;17;0;Stadt Konstanz, Amt für Stadtplanung und Umwelt
16.06.2022 23:00;195;70;125;Sonnig;16;16;0;Stadt Konstanz, Amt für Stadtplanung und Umwelt
17.06.2022 00:00;103;41;62;Sonnig;15;15;0;Stadt Konstanz, Amt für Stadtplanung und Umwelt
17.06.2022 01:00;43;16;27;Sonnig;15;15;0;Stadt Konstanz, Amt für Stadtplanung und Umwelt
17.06.2022 02:00;19;6;13;Sonnig;14;14;0;Stadt Konstanz, Amt für Stadtplanung und Umwelt
17.06.2022 03:00;12;6;6;Sonnig;13;13;0;Stadt Konstanz, Amt für Stadtplanung und Umwelt
17.06.2022 04:00;14;11;3;Sonnig;14;14;0;Stadt Konstanz, Amt für Stadtplanung und Umwelt
17.06.2022 05:00;53;36;17;Sonnig;15;15;0;Stadt Konstanz, Amt für Stadtplanung und Umwelt
17.06.2022 06:00;131;75;56;Sonnig;16;16;0;Stadt Konstanz, Amt für Stadtplanung und Umwelt
17.06.2022 07:00;337;197;140;Sonnig;17;17;0;Stadt Konstanz, Amt für Stadtplanung und Umwelt
17.06.2022 08:00;507;298;209;Sonnig;19;19;0;Stadt Konstanz, Amt für Stadtplanung und Umwelt
17.06.2022 09:00;676;408;268;Sonnig;21;21;0;Stadt Konstanz, Amt für Stadtplanung und Umwelt
17.06.2022 10:00;699;400;299;Sonnig;23;25;0;Stadt Konstanz, Amt für Stadtplanung und Umwelt
17.06.2022 11:00;838;414;424;Sonnig;25;26;0;Stadt Konstanz, Amt für Stadtplanung und Umwelt
17.06.2022 12:00;716;341;375;Sonnig;26;27;0;Stadt Konstanz, Amt für Stadtplanung und Umwelt
17.06.2022 13:00;826;392;434;Sonnig;27;28;0;Stadt Konstanz, Amt für Stadtplanung und Umwelt
17.06.2022 14:00;654;332;322;Sonnig;28;29;0;Stadt Konstanz, Amt für Stadtplanung und Umwelt
17.06.2022 15:00;775;358;417;Sonnig;29;30;0;Stadt Konstanz, Amt für Stadtplanung und Umwelt
17.06.2022 16:00;826;384;442;Sonnig;28;29;0;Stadt Konstanz, Amt für Stadtplanung und Umwelt
17.06.2022 17:00;793;375;418;Sonnig;27;28;0;Stadt Konstanz, Amt für Stadtplanung und Umwelt
17.06.2022 18:00;808;348;460;Sonnig;26;28;0;Stadt Konstanz, Amt für Stadtplanung und Umwelt
17.06.2022 19:00;640;330;310;Sonnig;23;24;0;Stadt Konstanz, Amt für Stadtplanung und Umwelt
17.06.2022 20:00;492;232;260;Sonnig;21;21;0;Stadt Konstanz, Amt für Stadtplanung und Umwelt
17.06.2022 21:00;399;178;221;Sonnig;18;18;0;Stadt Konstanz, Amt für Stadtplanung und Umwelt
17.06.2022 22:00;334;128;206;Sonnig;17;17;0;Stadt Konstanz, Amt für Stadtplanung und Umwelt
17.06.2022 23:00;261;98;163;Sonnig;16;16;0;Stadt Konstanz, Amt für Stadtplanung und Umwelt
18.06.2022 00:00;155;52;103;Sonnig;15;15;0;Stadt Konstanz, Amt für Stadtplanung und Umwelt
18.06.2022 01:00;98;42;56;Sonnig;15;15;0;Stadt Konstanz, Amt für Stadtplanung und Umwelt
18.06.2022 02:00;62;25;37;Sonnig;14;14;0;Stadt Konstanz, Amt für Stadtplanung und Umwelt
18.06.2022 03:00;57;26;31;Sonnig;14;14;0;Stadt Konstanz, Amt für Stadtplanung und Umwelt
18.06.2022 04:00;39;31;8;Sonnig;14;14;0;Stadt Konstanz, Amt für Stadtplanung und Umwelt
18.06.2022 05:00;42;23;19;Sonnig;15;15;0;Stadt Konstanz, Amt für Stadtplanung und Umwelt
18.06.2022 06:00;58;35;23;Sonnig;16;16;0;Stadt Konstanz, Amt für Stadtplanung und Umwelt
18.06.2022 07:00;100;38;62;Sonnig;18;18;0;Stadt Konstanz, Amt für Stadtplanung und Umwelt
18.06.2022 08:00;306;170;136;Sonnig;21;21;0;Stadt Konstanz, Amt für Stadtplanung und Umwelt
18.06.2022 09:00;459;263;196;Sonnig;24;25;0;Stadt Konstanz, Amt für Stadtplanung und Umwelt
18.06.2022 10:00;625;345;280;Sonnig;26;28;0;Stadt Konstanz, Amt für Stadtplanung und Umwelt
18.06.2022 11:00;609;300;309;Sonnig;29;30;0;Stadt Konstanz, Amt für Stadtplanung und Umwelt
18.06.2022 12:00;573;277;296;Sonnig;31;33;0;Stadt Konstanz, Amt für Stadtplanung und Umwelt
18.06.2022 13:00;570;281;289;Sonnig;32;33;0;Stadt Konstanz, Amt für Stadtplanung und Umwelt
18.06.2022 14:00;631;305;326;Sonnig;32;33;0;Stadt Konstanz, Amt für Stadtplanung und Umwelt
18.06.2022 15:00;553;252;301;Sonnig;33;34;0;Stadt Konstanz, Amt für Stadtplanung und Umwelt
18.06.2022 16:00;604;292;312;Sonnig;31;33;0;Stadt Konstanz, Amt für Stadtplanung und Umwelt
18.06.2022 17:00;631;327;304;Sonnig;30;32;0;Stadt Konstanz, Amt für Stadtplanung und Umwelt
18.06.2022 18:00;656;321;335;Sonnig;29;31;0;Stadt Konstanz, Amt für Stadtplanung und Umwelt
18.06.2022 19:00;610;318;292;Sonnig;26;27;0;Stadt Konstanz, Amt für Stadtplanung und Umwelt
18.06.2022 20:00;583;277;306;Sonnig;22;23;0;Stadt Konstanz, Amt für Stadtplanung und Umwelt
18.06.2022 21:00;419;203;216;Sonnig;19;19;0;Stadt Konstanz, Amt für Stadtplanung und Umwelt
18.06.2022 22:00;406;202;204;Sonnig;18;18;0;Stadt Konstanz, Amt für Stadtplanung und Umwelt
18.06.2022 23:00;285;96;189;Sonnig;17;17;0;Stadt Konstanz, Amt für Stadtplanung und Umwelt
19.06.2022 00:00;229;66;163;Sonnig;16;16;0;Stadt Konstanz, Amt für Stadtplanung und Umwelt
19.06.2022 01:00;142;49;93;Sonnig;16;16;0;Stadt Konstanz, Amt für Stadtplanung und Umwelt
19.06.2022 02:00;100;36;64;Sonnig;16;16;0;Stadt Konstanz, Amt für Stadtplanung und Umwelt
19.06.2022 03:00;52;21;31;Sonnig;16;16;0;Stadt Konstanz, Amt für Stadtplanung und Umwelt
19.06.2022 04:00;32;10;22;Sonnig;16;16;0;Stadt Konstanz, Amt für Stadtplanung und Umwelt
19.06.2022 05:00;43;22;21;Sonnig;17;17;0;Stadt Konstanz, Amt für Stadtplanung und Umwelt
19.06.2022 06:00;63;36;27;Sonnig;18;18;0;Stadt Konstanz, Amt für Stadtplanung und Umwelt
19.06.2022 07:00;89;44;45;Sonnig;20;20;0;Stadt Konstanz, Amt für Stadtplanung und Umwelt
19.06.2022 08:00;193;94;99;Sonnig;23;24;0;Stadt Konstanz, Amt für Stadtplanung und Umwelt
19.06.2022 09:00;333;183;150;Sonnig;26;27;0;Stadt Konstanz, Amt für Stadtplanung und Umwelt
19.06.2022 10:00;418;198;220;Sonnig;29;30;0;Stadt Konstanz, Amt für Stadtplanung und Umwelt
19.06.2022 11:00;403;187;216;Sonnig;31;33;0;Stadt Konstanz, Amt für Stadtplanung und Umwelt
19.06.2022 12:00;443;174;269;Sonnig;34;36;0;Stadt Konstanz, Amt für Stadtplanung und Umwelt
19.06.2022 13:00;464;238;226;Sonnig;34;37;0;Stadt Konstanz, Amt für Stadtplanung und Umwelt
19.06.2022 14:00;502;239;263;Sonnig;35;37;0;Stadt Konstanz, Amt für Stadtplanung und Umwelt
19.06.2022 15:00;428;212;216;Sonnig;36;38;0;Stadt Konstanz, Amt für Stadtplanung und Umwelt
19.06.2022 16:00;429;220;209;Sonnig;35;37;0;Stadt Konstanz, Amt für Stadtplanung und Umwelt
19.06.2022 17:00;553;308;245;Sonnig;34;37;0;Stadt Konstanz, Amt für Stadtplanung und Umwelt
19.06.2022 18:00;568;283;285;Sonnig;33;36;0;Stadt Konstanz, Amt für Stadtplanung und Umwelt
19.06.2022 19:00;532;259;273;Sonnig;29;33;0;Stadt Konstanz, Amt für Stadtplanung und Umwelt
19.06.2022 20:00;447;201;246;Stellenweise Gewitter und Niederschlaege;26;29;0;Stadt Konstanz, Amt für Stadtplanung und Umwelt
19.06.2022 21:00;345;128;217;Stellenweise Gewitter und Niederschlaege;23;25;0;Stadt Konstanz, Amt für Stadtplanung und Umwelt
19.06.2022 22:00;273;112;161;Stellenweise Gewitter und Niederschlaege;21;21;0;Stadt Konstanz, Amt für Stadtplanung und Umwelt
19.06.2022 23:00;111;39;72;Stellenweiser Regenfall;20;20;0.1;Stadt Konstanz, Amt für Stadtplanung und Umwelt
20.06.2022 00:00;51;22;29;Stellenweiser Regenfall;18;18;0.1;Stadt Konstanz, Amt für Stadtplanung und Umwelt
20.06.2022 01:00;27;8;19;Stellenweiser Regenfall;17;17;0.1;Stadt Konstanz, Amt für Stadtplanung und Umwelt
20.06.2022 02:00;16;9;7;Sonnig;17;17;0;Stadt Konstanz, Amt für Stadtplanung und Umwelt
20.06.2022 03:00;5;3;2;Sonnig;16;16;0;Stadt Konstanz, Amt für Stadtplanung und Umwelt
20.06.2022 04:00;14;10;4;Sonnig;17;17;0;Stadt Konstanz, Amt für Stadtplanung und Umwelt
20.06.2022 05:00;67;44;23;Sonnig;18;18;0;Stadt Konstanz, Amt für Stadtplanung und Umwelt
20.06.2022 06:00;216;119;97;Sonnig;18;18;0;Stadt Konstanz, Amt für Stadtplanung und Umwelt
20.06.2022 07:00;1124;700;424;Sonnig;20;20;0;Stadt Konstanz, Amt für Stadtplanung und Umwelt
20.06.2022 08:00;820;438;382;Sonnig;21;21;0;Stadt Konstanz, Amt für Stadtplanung und Umwelt
20.06.2022 09:00;867;497;370;Sonnig;22;25;0;Stadt Konstanz, Amt für Stadtplanung und Umwelt
20.06.2022 10:00;621;348;273;Sonnig;25;27;0;Stadt Konstanz, Amt für Stadtplanung und Umwelt
20.06.2022 11:00;647;291;356;Sonnig;28;29;0;Stadt Konstanz, Amt für Stadtplanung und Umwelt
20.06.2022 12:00;775;365;410;Sonnig;30;31;0;Stadt Konstanz, Amt für Stadtplanung und Umwelt
20.06.2022 13:00;1143;546;597;Sonnig;30;31;0;Stadt Konstanz, Amt für Stadtplanung und Umwelt
20.06.2022 14:00;748;361;387;Leicht bewoelkt;30;30;0;Stadt Konstanz, Amt für Stadtplanung und Umwelt
20.06.2022 15:00;1053;540;513;Leicht bewoelkt;30;30;0;Stadt Konstanz, Amt für Stadtplanung und Umwelt
20.06.2022 16:00;1044;518;526;Leicht bewoelkt;28;28;0;Stadt Konstanz, Amt für Stadtplanung und Umwelt
20.06.2022 17:00;1198;565;633;Nieselregen mit Gewitter;25;27;0.1;Stadt Konstanz, Amt für Stadtplanung und Umwelt
20.06.2022 18:00;1057;515;542;Nieselregen mit Gewitter;23;25;0.1;Stadt Konstanz, Amt für Stadtplanung und Umwelt
20.06.2022 19:00;878;428;450;Nieselregen mit Gewitter;21;21;0;Stadt Konstanz, Amt für Stadtplanung und Umwelt
20.06.2022 20:00;636;282;354;Stellenweiser Regenfall;18;18;0.3;Stadt Konstanz, Amt für Stadtplanung und Umwelt
20.06.2022 21:00;529;202;327;Stellenweiser Regenfall;16;16;0.4;Stadt Konstanz, Amt für Stadtplanung und Umwelt
20.06.2022 22:00;331;125;206;Stellenweiser Regenfall;15;15;0.2;Stadt Konstanz, Amt für Stadtplanung und Umwelt
20.06.2022 23:00;165;51;114;Stellenweiser Regenfall;15;15;0.2;Stadt Konstanz, Amt für Stadtplanung und Umwelt
21.06.2022 00:00;67;29;38;Stellenweiser Regenfall;15;15;0.4;Stadt Konstanz, Amt für Stadtplanung und Umwelt
21.06.2022 01:00;22;10;12;Stellenweiser Regenfall;14;14;0.2;Stadt Konstanz, Amt für Stadtplanung und Umwelt
21.06.2022 02:00;17;7;10;Leichter Nebel;14;14;0;Stadt Konstanz, Amt für Stadtplanung und Umwelt
21.06.2022 03:00;2;0;2;Leichter Nebel;14;14;0;Stadt Konstanz, Amt für Stadtplanung und Umwelt
21.06.2022 04:00;17;11;6;Leichter Nebel;15;15;0;Stadt Konstanz, Amt für Stadtplanung und Umwelt
21.06.2022 05:00;71;48;23;Leichter Nebel;15;15;0;Stadt Konstanz, Amt für Stadtplanung und Umwelt
21.06.2022 06:00;244;142;102;Leichter Nebel;16;16;0;Stadt Konstanz, Amt für Stadtplanung und Umwelt
21.06.2022 07:00;1150;744;406;Leichter Nebel;18;18;0;Stadt Konstanz, Amt für Stadtplanung und Umwelt
21.06.2022 08:00;1006;540;466;Stellenweiser Regenfall;19;19;0;Stadt Konstanz, Amt für Stadtplanung und Umwelt
21.06.2022 09:00;907;538;369;Stellenweiser Regenfall;21;21;0;Stadt Konstanz, Amt für Stadtplanung und Umwelt
21.06.2022 10:00;663;360;303;Stellenweiser Regenfall;23;24;0;Stadt Konstanz, Amt für Stadtplanung und Umwelt
21.06.2022 11:00;895;407;488;Sonnig;26;28;0;Stadt Konstanz, Amt für Stadtplanung und Umwelt
21.06.2022 12:00;814;341;473;Sonnig;29;31;0;Stadt Konstanz, Amt für Stadtplanung und Umwelt
21.06.2022 13:00;1097;478;619;Sonnig;30;32;0;Stadt Konstanz, Amt für Stadtplanung und Umwelt
21.06.2022 14:00;870;406;464;Sonnig;30;33;0;Stadt Konstanz, Amt für Stadtplanung und Umwelt
21.06.2022 15:00;1201;582;619;Sonnig;31;33;0;Stadt Konstanz, Amt für Stadtplanung und Umwelt
21.06.2022 16:00;1098;517;581;Sonnig;29;31;0;Stadt Konstanz, Amt für Stadtplanung und Umwelt
21.06.2022 17:00;1230;569;661;Stellenweiser Regenfall;27;29;0;Stadt Konstanz, Amt für Stadtplanung und Umwelt
21.06.2022 18:00;1150;519;631;Stellenweiser Regenfall;25;27;0;Stadt Konstanz, Amt für Stadtplanung und Umwelt
21.06.2022 19:00;988;480;508;Stellenweiser Regenfall;22;23;0;Stadt Konstanz, Amt für Stadtplanung und Umwelt
21.06.2022 20:00;604;242;362;Teilweise starker Regenfall;19;19;03. Mrz;Stadt Konstanz, Amt für Stadtplanung und Umwelt
21.06.2022 21:00;511;182;329;Teilweise starker Regenfall;16;16;04. Apr;Stadt Konstanz, Amt für Stadtplanung und Umwelt
21.06.2022 22:00;203;66;137;Teilweise starker Regenfall;16;16;02. Feb;Stadt Konstanz, Amt für Stadtplanung und Umwelt
21.06.2022 23:00;180;63;117;Stellenweiser Regenfall;15;15;0.6;Stadt Konstanz, Amt für Stadtplanung und Umwelt
22.06.2022 00:00;70;27;43;Stellenweiser Regenfall;15;15;01. Mrz;Stadt Konstanz, Amt für Stadtplanung und Umwelt
22.06.2022 01:00;43;16;27;Stellenweiser Regenfall;15;15;0.6;Stadt Konstanz, Amt für Stadtplanung und Umwelt
22.06.2022 02:00;23;11;12;Sonnig;14;15;0;Stadt Konstanz, Amt für Stadtplanung und Umwelt
22.06.2022 03:00;12;5;7;Sonnig;14;14;0;Stadt Konstanz, Amt für Stadtplanung und Umwelt
22.06.2022 04:00;13;10;3;Sonnig;15;15;0;Stadt Konstanz, Amt für Stadtplanung und Umwelt
22.06.2022 05:00;60;39;21;Leicht bewoelkt;15;16;0;Stadt Konstanz, Amt für Stadtplanung und Umwelt
22.06.2022 06:00;178;106;72;Leicht bewoelkt;16;16;0;Stadt Konstanz, Amt für Stadtplanung und Umwelt
22.06.2022 07:00;1040;638;402;Leicht bewoelkt;17;17;0;Stadt Konstanz, Amt für Stadtplanung und Umwelt
22.06.2022 08:00;863;476;387;Leicht bewoelkt;19;19;0;Stadt Konstanz, Amt für Stadtplanung und Umwelt
22.06.2022 09:00;806;476;330;Leicht bewoelkt;20;20;0;Stadt Konstanz, Amt für Stadtplanung und Umwelt
22.06.2022 10:00;463;252;211;Leicht bewoelkt;22;22;0;Stadt Konstanz, Amt für Stadtplanung und Umwelt
22.06.2022 11:00;403;164;239;Leicht bewoelkt;23;24;0;Stadt Konstanz, Amt für Stadtplanung und Umwelt
22.06.2022 12:00;525;229;296;Leicht bewoelkt;25;26;0;Stadt Konstanz, Amt für Stadtplanung und Umwelt
22.06.2022 13:00;924;431;493;Leicht bewoelkt;24;26;0;Stadt Konstanz, Amt für Stadtplanung und Umwelt
22.06.2022 14:00;654;330;324;Leicht bewoelkt;23;25;0;Stadt Konstanz, Amt für Stadtplanung und Umwelt
22.06.2022 15:00;832;403;429;Leicht bewoelkt;22;22;0;Stadt Konstanz, Amt für Stadtplanung und Umwelt
22.06.2022 16:00;889;431;458;Leicht bewoelkt;21;21;0;Stadt Konstanz, Amt für Stadtplanung und Umwelt
22.06.2022 17:00;1014;484;530;Leichter Regenschauer;20;20;0.1;Stadt Konstanz, Amt für Stadtplanung und Umwelt
22.06.2022 18:00;977;403;574;Leichter Regenschauer;20;20;0.1;Stadt Konstanz, Amt für Stadtplanung und Umwelt
22.06.2022 19:00;777;401;376;Leichter Regenschauer;19;19;0.1;Stadt Konstanz, Amt für Stadtplanung und Umwelt
22.06.2022 20:00;536;223;313;Leicht bewoelkt;18;18;0;Stadt Konstanz, Amt für Stadtplanung und Umwelt
22.06.2022 21:00;305;128;177;Leicht bewoelkt;16;16;0;Stadt Konstanz, Amt für Stadtplanung und Umwelt
22.06.2022 22:00;270;100;170;Leicht bewoelkt;16;16;0;Stadt Konstanz, Amt für Stadtplanung und Umwelt
22.06.2022 23:00;148;56;92;Leichter Regenschauer;16;16;0.2;Stadt Konstanz, Amt für Stadtplanung und Umwelt
23.06.2022 00:00;89;39;50;Leichter Regenschauer;16;16;0.4;Stadt Konstanz, Amt für Stadtplanung und Umwelt
23.06.2022 01:00;40;13;27;Leichter Regenschauer;16;16;0.2;Stadt Konstanz, Amt für Stadtplanung und Umwelt
23.06.2022 02:00;23;8;15;Leicht bewoelkt;15;15;0;Stadt Konstanz, Amt für Stadtplanung und Umwelt
23.06.2022 03:00;10;6;4;Leicht bewoelkt;15;15;0;Stadt Konstanz, Amt für Stadtplanung und Umwelt
23.06.2022 04:00;21;17;4;Leicht bewoelkt;16;16;0;Stadt Konstanz, Amt für Stadtplanung und Umwelt
23.06.2022 05:00;61;41;20;Leicht bewoelkt;16;16;0;Stadt Konstanz, Amt für Stadtplanung und Umwelt
23.06.2022 06:00;216;126;90;Leicht bewoelkt;17;17;0;Stadt Konstanz, Amt für Stadtplanung und Umwelt
23.06.2022 07:00;1188;782;406;Leicht bewoelkt;19;19;0;Stadt Konstanz, Amt für Stadtplanung und Umwelt
23.06.2022 08:00;912;503;409;Sonnig;21;21;0;Stadt Konstanz, Amt für Stadtplanung und Umwelt
23.06.2022 09:00;836;461;375;Sonnig;23;25;0;Stadt Konstanz, Amt für Stadtplanung und Umwelt
23.06.2022 10:00;608;343;265;Sonnig;25;27;0;Stadt Konstanz, Amt für Stadtplanung und Umwelt
23.06.2022 11:00;765;357;408;Sonnig;27;29;0;Stadt Konstanz, Amt für Stadtplanung und Umwelt
23.06.2022 12:00;928;411;517;Sonnig;30;31;0;Stadt Konstanz, Amt für Stadtplanung und Umwelt
23.06.2022 13:00;1108;502;606;Sonnig;29;31;0;Stadt Konstanz, Amt für Stadtplanung und Umwelt
23.06.2022 14:00;862;397;465;Sonnig;29;30;0;Stadt Konstanz, Amt für Stadtplanung und Umwelt
23.06.2022 15:00;1152;527;625;Sonnig;28;29;0;Stadt Konstanz, Amt für Stadtplanung und Umwelt
23.06.2022 16:00;1101;518;583;Sonnig;27;29;0;Stadt Konstanz, Amt für Stadtplanung und Umwelt
23.06.2022 17:00;1268;601;667;Stellenweise Gewitter und Niederschlaege;27;28;0;Stadt Konstanz, Amt für Stadtplanung und Umwelt
23.06.2022 18:00;1160;503;657;Stellenweise Gewitter und Niederschlaege;26;28;0;Stadt Konstanz, Amt für Stadtplanung und Umwelt
23.06.2022 19:00;890;419;471;Stellenweise Gewitter und Niederschlaege;24;25;0;Stadt Konstanz, Amt für Stadtplanung und Umwelt
23.06.2022 20:00;622;265;357;Nieselregen mit Gewitter;21;21;0.1;Stadt Konstanz, Amt für Stadtplanung und Umwelt
23.06.2022 21:00;558;234;324;Nieselregen mit Gewitter;19;19;0.2;Stadt Konstanz, Amt für Stadtplanung und Umwelt
23.06.2022 22:00;115;36;79;Nieselregen mit Gewitter;18;18;0.1;Stadt Konstanz, Amt für Stadtplanung und Umwelt
23.06.2022 23:00;186;67;119;Leichter Regenschauer;17;17;0.1;Stadt Konstanz, Amt für Stadtplanung und Umwelt
24.06.2022 00:00;73;26;47;Leichter Regenschauer;17;17;0.2;Stadt Konstanz, Amt für Stadtplanung und Umwelt
24.06.2022 01:00;44;21;23;Leichter Regenschauer;16;16;0.1;Stadt Konstanz, Amt für Stadtplanung und Umwelt
24.06.2022 02:00;28;13;15;Leichter Regenschauer;16;16;0.7;Stadt Konstanz, Amt für Stadtplanung und Umwelt
24.06.2022 03:00;19;10;9;Leichter Regenschauer;16;16;0.9;Stadt Konstanz, Amt für Stadtplanung und Umwelt
24.06.2022 04:00;17;14;3;Leichter Regenschauer;16;16;0.4;Stadt Konstanz, Amt für Stadtplanung und Umwelt
24.06.2022 05:00;54;28;26;Leichter Regenschauer;16;16;0.3;Stadt Konstanz, Amt für Stadtplanung und Umwelt
24.06.2022 06:00;180;102;78;Leichter Regenschauer;16;16;0.4;Stadt Konstanz, Amt für Stadtplanung und Umwelt
24.06.2022 07:00;1018;643;375;Leichter Regenschauer;17;17;0.2;Stadt Konstanz, Amt für Stadtplanung und Umwelt
24.06.2022 08:00;822;483;339;Bewoelkt;17;17;0;Stadt Konstanz, Amt für Stadtplanung und Umwelt
24.06.2022 09:00;827;502;325;Bewoelkt;18;18;0;Stadt Konstanz, Amt für Stadtplanung und Umwelt
24.06.2022 10:00;601;348;253;Bewoelkt;18;18;0;Stadt Konstanz, Amt für Stadtplanung und Umwelt
24.06.2022 11:00;765;380;385;Leichter Regenschauer;19;19;0.1;Stadt Konstanz, Amt für Stadtplanung und Umwelt
24.06.2022 12:00;842;408;434;Leichter Regenschauer;19;19;0.1;Stadt Konstanz, Amt für Stadtplanung und Umwelt
24.06.2022 13:00;903;340;563;Leichter Regenschauer;20;20;0;Stadt Konstanz, Amt für Stadtplanung und Umwelt
24.06.2022 14:00;563;246;317;Stellenweiser Regenfall;20;20;0;Stadt Konstanz, Amt für Stadtplanung und Umwelt
24.06.2022 15:00;557;273;284;Stellenweiser Regenfall;21;21;0;Stadt Konstanz, Amt für Stadtplanung und Umwelt
24.06.2022 16:00;465;200;265;Stellenweiser Regenfall;19;19;0;Stadt Konstanz, Amt für Stadtplanung und Umwelt
24.06.2022 17:00;402;177;225;Leichter Regenschauer;18;18;0.4;Stadt Konstanz, Amt für Stadtplanung und Umwelt
24.06.2022 18:00;373;155;218;Leichter Regenschauer;16;16;0.5;Stadt Konstanz, Amt für Stadtplanung und Umwelt
24.06.2022 19:00;385;170;215;Leichter Regenschauer;16;16;0.2;Stadt Konstanz, Amt für Stadtplanung und Umwelt
24.06.2022 20:00;296;133;163;Leichter Nebel;15;15;0;Stadt Konstanz, Amt für Stadtplanung und Umwelt
24.06.2022 21:00;240;123;117;Leichter Nebel;14;14;0;Stadt Konstanz, Amt für Stadtplanung und Umwelt
24.06.2022 22:00;203;82;121;Leichter Nebel;13;13;0;Stadt Konstanz, Amt für Stadtplanung und Umwelt
24.06.2022 23:00;132;53;79;Sonnig;12;12;0;Stadt Konstanz, Amt für Stadtplanung und Umwelt
25.06.2022 00:00;101;31;70;Sonnig;11;12;0;Stadt Konstanz, Amt für Stadtplanung und Umwelt
25.06.2022 01:00;95;36;59;Sonnig;11;11;0;Stadt Konstanz, Amt für Stadtplanung und Umwelt
25.06.2022 02:00;46;15;31;Sonnig;11;11;0;Stadt Konstanz, Amt für Stadtplanung und Umwelt
25.06.2022 03:00;23;12;11;Sonnig;10;10;0;Stadt Konstanz, Amt für Stadtplanung und Umwelt
25.06.2022 04:00;31;17;14;Sonnig;11;11;0;Stadt Konstanz, Amt für Stadtplanung und Umwelt
25.06.2022 05:00;27;16;11;Sonnig;12;12;0;Stadt Konstanz, Amt für Stadtplanung und Umwelt
25.06.2022 06:00;62;36;26;Sonnig;13;13;0;Stadt Konstanz, Amt für Stadtplanung und Umwelt
25.06.2022 07:00;145;71;74;Sonnig;15;15;0;Stadt Konstanz, Amt für Stadtplanung und Umwelt
25.06.2022 08:00;277;152;125;Sonnig;17;17;0;Stadt Konstanz, Amt für Stadtplanung und Umwelt
25.06.2022 09:00;525;316;209;Sonnig;20;20;0;Stadt Konstanz, Amt für Stadtplanung und Umwelt
25.06.2022 10:00;705;399;306;Sonnig;21;21;0;Stadt Konstanz, Amt für Stadtplanung und Umwelt
25.06.2022 11:00;812;424;388;Sonnig;23;23;0;Stadt Konstanz, Amt für Stadtplanung und Umwelt
25.06.2022 12:00;755;397;358;Sonnig;24;25;0;Stadt Konstanz, Amt für Stadtplanung und Umwelt
25.06.2022 13:00;809;432;377;Sonnig;26;27;0;Stadt Konstanz, Amt für Stadtplanung und Umwelt
25.06.2022 14:00;835;449;386;Sonnig;27;28;0;Stadt Konstanz, Amt für Stadtplanung und Umwelt
25.06.2022 15:00;812;395;417;Sonnig;28;29;0;Stadt Konstanz, Amt für Stadtplanung und Umwelt
25.06.2022 16:00;837;411;426;Sonnig;27;28;0;Stadt Konstanz, Amt für Stadtplanung und Umwelt
25.06.2022 17:00;909;424;485;Sonnig;27;28;0;Stadt Konstanz, Amt für Stadtplanung und Umwelt
25.06.2022 18:00;909;418;491;Sonnig;26;27;0;Stadt Konstanz, Amt für Stadtplanung und Umwelt
25.06.2022 19:00;791;386;405;Sonnig;23;24;0;Stadt Konstanz, Amt für Stadtplanung und Umwelt
25.06.2022 20:00;616;311;305;Sonnig;20;20;0;Stadt Konstanz, Amt für Stadtplanung und Umwelt
25.06.2022 21:00;522;237;285;Sonnig;17;17;0;Stadt Konstanz, Amt für Stadtplanung und Umwelt
25.06.2022 22:00;427;183;244;Sonnig;16;16;0;Stadt Konstanz, Amt für Stadtplanung und Umwelt
25.06.2022 23:00;393;113;280;Sonnig;15;15;0;Stadt Konstanz, Amt für Stadtplanung und Umwelt
26.06.2022 00:00;232;58;174;Sonnig;14;14;0;Stadt Konstanz, Amt für Stadtplanung und Umwelt
26.06.2022 01:00;184;44;140;Sonnig;14;14;0;Stadt Konstanz, Amt für Stadtplanung und Umwelt
26.06.2022 02:00;113;56;57;Leicht bewoelkt;13;13;0;Stadt Konstanz, Amt für Stadtplanung und Umwelt
26.06.2022 03:00;55;25;30;Leicht bewoelkt;13;13;0;Stadt Konstanz, Amt für Stadtplanung und Umwelt
26.06.2022 04:00;43;26;17;Leicht bewoelkt;14;14;0;Stadt Konstanz, Amt für Stadtplanung und Umwelt
26.06.2022 05:00;38;28;10;Leicht bewoelkt;15;15;0;Stadt Konstanz, Amt für Stadtplanung und Umwelt
26.06.2022 06:00;55;29;26;Leicht bewoelkt;16;16;0;Stadt Konstanz, Amt für Stadtplanung und Umwelt
26.06.2022 07:00;77;39;38;Leicht bewoelkt;17;17;0;Stadt Konstanz, Amt für Stadtplanung und Umwelt
26.06.2022 08:00;158;71;87;Sonnig;18;18;0;Stadt Konstanz, Amt für Stadtplanung und Umwelt
26.06.2022 09:00;344;201;143;Sonnig;19;19;0;Stadt Konstanz, Amt für Stadtplanung und Umwelt
26.06.2022 10:00;437;241;196;Sonnig;21;21;0;Stadt Konstanz, Amt für Stadtplanung und Umwelt
26.06.2022 11:00;511;250;261;Leicht bewoelkt;22;23;0;Stadt Konstanz, Amt für Stadtplanung und Umwelt
26.06.2022 12:00;511;247;264;Leicht bewoelkt;24;26;0;Stadt Konstanz, Amt für Stadtplanung und Umwelt
26.06.2022 13:00;611;313;298;Leicht bewoelkt;25;26;0;Stadt Konstanz, Amt für Stadtplanung und Umwelt
26.06.2022 14:00;687;312;375;Sonnig;26;27;0;Stadt Konstanz, Amt für Stadtplanung und Umwelt
26.06.2022 15:00;624;325;299;Sonnig;27;28;0;Stadt Konstanz, Amt für Stadtplanung und Umwelt
26.06.2022 16:00;619;310;309;Sonnig;27;28;0;Stadt Konstanz, Amt für Stadtplanung und Umwelt
26.06.2022 17:00;638;319;319;Sonnig;26;28;0;Stadt Konstanz, Amt für Stadtplanung und Umwelt
26.06.2022 18:00;695;370;325;Sonnig;26;27;0;Stadt Konstanz, Amt für Stadtplanung und Umwelt
26.06.2022 19:00;613;300;313;Sonnig;24;25;0;Stadt Konstanz, Amt für Stadtplanung und Umwelt
26.06.2022 20:00;519;221;298;Sonnig;22;22;0;Stadt Konstanz, Amt für Stadtplanung und Umwelt
26.06.2022 21:00;452;176;276;Sonnig;19;19;0;Stadt Konstanz, Amt für Stadtplanung und Umwelt
26.06.2022 22:00;262;99;163;Sonnig;18;18;0;Stadt Konstanz, Amt für Stadtplanung und Umwelt
26.06.2022 23:00;99;35;64;Sonnig;17;17;0;Stadt Konstanz, Amt für Stadtplanung und Umwelt
27.06.2022 00:00;52;19;33;Sonnig;16;16;0;Stadt Konstanz, Amt für Stadtplanung und Umwelt
27.06.2022 01:00;26;11;15;Sonnig;15;16;0;Stadt Konstanz, Amt für Stadtplanung und Umwelt
27.06.2022 02:00;10;6;4;Sonnig;15;15;0;Stadt Konstanz, Amt für Stadtplanung und Umwelt
27.06.2022 03:00;1;0;1;Sonnig;15;15;0;Stadt Konstanz, Amt für Stadtplanung und Umwelt
27.06.2022 04:00;14;13;1;Sonnig;16;16;0;Stadt Konstanz, Amt für Stadtplanung und Umwelt
27.06.2022 05:00;54;30;24;Bewoelkt;16;16;0;Stadt Konstanz, Amt für Stadtplanung und Umwelt
27.06.2022 06:00;200;119;81;Bewoelkt;17;17;0;Stadt Konstanz, Amt für Stadtplanung und Umwelt
27.06.2022 07:00;978;584;394;Bewoelkt;18;18;0;Stadt Konstanz, Amt für Stadtplanung und Umwelt
27.06.2022 08:00;900;516;384;Bewoelkt;19;19;0;Stadt Konstanz, Amt für Stadtplanung und Umwelt
27.06.2022 09:00;821;464;357;Bewoelkt;19;19;0;Stadt Konstanz, Amt für Stadtplanung und Umwelt
27.06.2022 10:00;580;331;249;Bewoelkt;20;20;0;Stadt Konstanz, Amt für Stadtplanung und Umwelt
27.06.2022 11:00;725;381;344;Leicht bewoelkt;21;21;0;Stadt Konstanz, Amt für Stadtplanung und Umwelt
27.06.2022 12:00;832;363;469;Leicht bewoelkt;22;25;0;Stadt Konstanz, Amt für Stadtplanung und Umwelt
27.06.2022 13:00;929;423;506;Leicht bewoelkt;22;25;0;Stadt Konstanz, Amt für Stadtplanung und Umwelt
27.06.2022 14:00;787;398;389;Leichter Regenschauer;22;22;0.1;Stadt Konstanz, Amt für Stadtplanung und Umwelt
27.06.2022 15:00;873;399;474;Leichter Regenschauer;21;21;0.1;Stadt Konstanz, Amt für Stadtplanung und Umwelt
27.06.2022 16:00;926;458;468;Leichter Regenschauer;20;20;0.1;Stadt Konstanz, Amt für Stadtplanung und Umwelt
27.06.2022 17:00;1019;482;537;Leichter Regenschauer;19;19;0.1;Stadt Konstanz, Amt für Stadtplanung und Umwelt
27.06.2022 18:00;823;379;444;Leichter Regenschauer;19;19;0.2;Stadt Konstanz, Amt für Stadtplanung und Umwelt
27.06.2022 19:00;485;209;276;Leichter Regenschauer;18;18;0.1;Stadt Konstanz, Amt für Stadtplanung und Umwelt
27.06.2022 20:00;306;125;181;Leichter Regenfall;17;17;0.8;Stadt Konstanz, Amt für Stadtplanung und Umwelt
27.06.2022 21:00;251;113;138;Leichter Regenfall;16;16;01. Jan;Stadt Konstanz, Amt für Stadtplanung und Umwelt
27.06.2022 22:00;160;72;88;Leichter Regenfall;15;15;0.5;Stadt Konstanz, Amt für Stadtplanung und Umwelt
27.06.2022 23:00;87;30;57;Leichter Regenfall;15;15;0.7;Stadt Konstanz, Amt für Stadtplanung und Umwelt
28.06.2022 00:00;37;22;15;Leichter Regenfall;14;15;01. Mai;Stadt Konstanz, Amt für Stadtplanung und Umwelt
28.06.2022 01:00;34;8;26;Leichter Regenfall;14;14;0.7;Stadt Konstanz, Amt für Stadtplanung und Umwelt
28.06.2022 02:00;12;9;3;Leichter Nebel;14;14;0;Stadt Konstanz, Amt für Stadtplanung und Umwelt
28.06.2022 03:00;6;4;2;Leichter Nebel;14;14;0;Stadt Konstanz, Amt für Stadtplanung und Umwelt
28.06.2022 04:00;11;9;2;Leichter Nebel;14;14;0;Stadt Konstanz, Amt für Stadtplanung und Umwelt
28.06.2022 05:00;56;33;23;Leichter Nebel;14;14;0;Stadt Konstanz, Amt für Stadtplanung und Umwelt
28.06.2022 06:00;191;109;82;Leichter Nebel;15;14;0;Stadt Konstanz, Amt für Stadtplanung und Umwelt
28.06.2022 07:00;925;586;339;Leichter Nebel;15;15;0;Stadt Konstanz, Amt für Stadtplanung und Umwelt
28.06.2022 08:00;797;440;357;Leicht bewoelkt;16;16;0;Stadt Konstanz, Amt für Stadtplanung und Umwelt
28.06.2022 09:00;878;520;358;Leicht bewoelkt;17;17;0;Stadt Konstanz, Amt für Stadtplanung und Umwelt
28.06.2022 10:00;622;335;287;Leicht bewoelkt;18;18;0;Stadt Konstanz, Amt für Stadtplanung und Umwelt
28.06.2022 11:00;742;350;392;Bewoelkt;19;19;0;Stadt Konstanz, Amt für Stadtplanung und Umwelt
28.06.2022 12:00;778;334;444;Bewoelkt;21;21;0;Stadt Konstanz, Amt für Stadtplanung und Umwelt
28.06.2022 13:00;895;405;490;Bewoelkt;21;21;0;Stadt Konstanz, Amt für Stadtplanung und Umwelt
28.06.2022 14:00;699;338;361;Stellenweiser Regenfall;22;22;0;Stadt Konstanz, Amt für Stadtplanung und Umwelt
28.06.2022 15:00;942;504;438;Stellenweiser Regenfall;22;22;0;Stadt Konstanz, Amt für Stadtplanung und Umwelt
28.06.2022 16:00;914;435;479;Stellenweiser Regenfall;21;21;0;Stadt Konstanz, Amt für Stadtplanung und Umwelt
28.06.2022 17:00;1001;430;571;Stellenweiser Regenfall;21;21;0;Stadt Konstanz, Amt für Stadtplanung und Umwelt
28.06.2022 18:00;810;374;436;Stellenweiser Regenfall;21;21;0;Stadt Konstanz, Amt für Stadtplanung und Umwelt
28.06.2022 19:00;653;317;336;Stellenweiser Regenfall;19;19;0;Stadt Konstanz, Amt für Stadtplanung und Umwelt
28.06.2022 20:00;500;236;264;Bewoelkt;18;18;0;Stadt Konstanz, Amt für Stadtplanung und Umwelt
28.06.2022 21:00;324;140;184;Bewoelkt;16;16;0;Stadt Konstanz, Amt für Stadtplanung und Umwelt
28.06.2022 22:00;286;115;171;Bewoelkt;16;16;0;Stadt Konstanz, Amt für Stadtplanung und Umwelt
28.06.2022 23:00;172;63;109;Leichter Nebel;15;15;0;Stadt Konstanz, Amt für Stadtplanung und Umwelt
29.06.2022 00:00;83;29;54;Leichter Nebel;15;15;0;Stadt Konstanz, Amt für Stadtplanung und Umwelt
29.06.2022 01:00;39;19;20;Leichter Nebel;15;15;0;Stadt Konstanz, Amt für Stadtplanung und Umwelt
29.06.2022 02:00;20;11;9;Leichter Regenschauer;14;14;0.2;Stadt Konstanz, Amt für Stadtplanung und Umwelt
29.06.2022 03:00;15;6;9;Leichter Regenschauer;14;14;0.3;Stadt Konstanz, Amt für Stadtplanung und Umwelt
29.06.2022 04:00;15;6;9;Leichter Regenschauer;15;15;0.2;Stadt Konstanz, Amt für Stadtplanung und Umwelt
29.06.2022 05:00;58;39;19;Leichter Regenschauer;16;16;0.2;Stadt Konstanz, Amt für Stadtplanung und Umwelt
29.06.2022 06:00;208;126;82;Leichter Regenschauer;17;17;0.3;Stadt Konstanz, Amt für Stadtplanung und Umwelt
29.06.2022 07:00;960;586;374;Leichter Regenschauer;17;17;0.1;Stadt Konstanz, Amt für Stadtplanung und Umwelt
29.06.2022 08:00;878;487;391;Bedeckt;18;18;0;Stadt Konstanz, Amt für Stadtplanung und Umwelt
29.06.2022 09:00;864;518;346;Bedeckt;19;19;0;Stadt Konstanz, Amt für Stadtplanung und Umwelt
29.06.2022 10:00;634;327;307;Bedeckt;20;20;0;Stadt Konstanz, Amt für Stadtplanung und Umwelt
29.06.2022 11:00;780;364;416;Stellenweiser Regenfall;22;22;0;Stadt Konstanz, Amt für Stadtplanung und Umwelt
29.06.2022 12:00;860;375;485;Stellenweiser Regenfall;23;25;0;Stadt Konstanz, Amt für Stadtplanung und Umwelt
29.06.2022 13:00;1038;530;508;Stellenweiser Regenfall;24;25;0;Stadt Konstanz, Amt für Stadtplanung und Umwelt
29.06.2022 14:00;819;411;408;Sonnig;24;26;0;Stadt Konstanz, Amt für Stadtplanung und Umwelt
29.06.2022 15:00;1043;483;560;Sonnig;24;26;0;Stadt Konstanz, Amt für Stadtplanung und Umwelt
29.06.2022 16:00;984;475;509;Sonnig;24;26;0;Stadt Konstanz, Amt für Stadtplanung und Umwelt
29.06.2022 17:00;1157;540;617;Stellenweiser Regenfall;23;25;0.2;Stadt Konstanz, Amt für Stadtplanung und Umwelt
29.06.2022 18:00;1032;473;559;Stellenweiser Regenfall;23;25;0.3;Stadt Konstanz, Amt für Stadtplanung und Umwelt
29.06.2022 19:00;796;373;423;Stellenweiser Regenfall;21;21;0.2;Stadt Konstanz, Amt für Stadtplanung und Umwelt
29.06.2022 20:00;596;294;302;Leicht bewoelkt;19;19;0;Stadt Konstanz, Amt für Stadtplanung und Umwelt
29.06.2022 21:00;572;265;307;Leicht bewoelkt;17;17;0;Stadt Konstanz, Amt für Stadtplanung und Umwelt
29.06.2022 22:00;383;154;229;Leicht bewoelkt;16;16;0;Stadt Konstanz, Amt für Stadtplanung und Umwelt
29.06.2022 23:00;246;81;165;Stellenweiser Regenfall;16;16;0;Stadt Konstanz, Amt für Stadtplanung und Umwelt
30.06.2022 00:00;107;28;79;Stellenweiser Regenfall;15;15;0.1;Stadt Konstanz, Amt für Stadtplanung und Umwelt
30.06.2022 01:00;61;26;35;Stellenweiser Regenfall;15;15;0;Stadt Konstanz, Amt für Stadtplanung und Umwelt
30.06.2022 02:00;23;13;10;Sonnig;15;15;0;Stadt Konstanz, Amt für Stadtplanung und Umwelt
30.06.2022 03:00;16;5;11;Sonnig;15;15;0;Stadt Konstanz, Amt für Stadtplanung und Umwelt
30.06.2022 04:00;15;8;7;Sonnig;15;15;0;Stadt Konstanz, Amt für Stadtplanung und Umwelt
30.06.2022 05:00;60;33;27;Sonnig;16;16;0;Stadt Konstanz, Amt für Stadtplanung und Umwelt
30.06.2022 06:00;210;113;97;Sonnig;17;17;0;Stadt Konstanz, Amt für Stadtplanung und Umwelt
30.06.2022 07:00;997;627;370;Sonnig;19;19;0;Stadt Konstanz, Amt für Stadtplanung und Umwelt
30.06.2022 08:00;918;504;414;Sonnig;21;21;0;Stadt Konstanz, Amt für Stadtplanung und Umwelt
30.06.2022 09:00;889;507;382;Sonnig;23;25;0;Stadt Konstanz, Amt für Stadtplanung und Umwelt
30.06.2022 10:00;695;365;330;Sonnig;25;27;0;Stadt Konstanz, Amt für Stadtplanung und Umwelt
30.06.2022 11:00;808;435;373;Sonnig;28;29;0;Stadt Konstanz, Amt für Stadtplanung und Umwelt
30.06.2022 12:00;849;352;497;Sonnig;30;32;0;Stadt Konstanz, Amt für Stadtplanung und Umwelt
30.06.2022 13:00;1052;430;622;Sonnig;29;31;0;Stadt Konstanz, Amt für Stadtplanung und Umwelt
30.06.2022 14:00;899;443;456;Stellenweise Gewitter und Niederschlaege;28;30;0;Stadt Konstanz, Amt für Stadtplanung und Umwelt
30.06.2022 15:00;1013;496;517;Stellenweise Gewitter und Niederschlaege;28;29;0;Stadt Konstanz, Amt für Stadtplanung und Umwelt
30.06.2022 16:00;918;442;476;Stellenweise Gewitter und Niederschlaege;25;26;0;Stadt Konstanz, Amt für Stadtplanung und Umwelt
30.06.2022 17:00;1183;612;571;Stellenweiser Regenfall;23;24;0.1;Stadt Konstanz, Amt für Stadtplanung und Umwelt
30.06.2022 18:00;1071;466;605;Stellenweiser Regenfall;21;21;0.2;Stadt Konstanz, Amt für Stadtplanung und Umwelt
30.06.2022 19:00;792;313;479;Stellenweiser Regenfall;19;19;0.1;Stadt Konstanz, Amt für Stadtplanung und Umwelt
30.06.2022 20:00;573;270;303;Leicht bewoelkt;17;17;0;Stadt Konstanz, Amt für Stadtplanung und Umwelt
30.06.2022 21:00;419;191;228;Leicht bewoelkt;15;15;0;Stadt Konstanz, Amt für Stadtplanung und Umwelt
30.06.2022 22:00;265;123;142;Leicht bewoelkt;16;16;0;Stadt Konstanz, Amt für Stadtplanung und Umwelt
30.06.2022 23:00;151;74;77;Leichter Regenschauer;16;16;0.2;Stadt Konstanz, Amt für Stadtplanung und Umwelt
01.07.2022 00:00;90;38;52;Leichter Regenschauer;17;17;0.4;Stadt Konstanz, Amt für Stadtplanung und Umwelt
01.07.2022 01:00;36;12;24;Leichter Regenschauer;16;16;0.2;Stadt Konstanz, Amt für Stadtplanung und Umwelt
01.07.2022 02:00;26;20;6;Nieselregen;15;15;0.1;Stadt Konstanz, Amt für Stadtplanung und Umwelt
01.07.2022 03:00;19;11;8;Nieselregen;14;14;0.1;Stadt Konstanz, Amt für Stadtplanung und Umwelt
01.07.2022 04:00;8;6;2;Nieselregen;14;13;0;Stadt Konstanz, Amt für Stadtplanung und Umwelt
01.07.2022 05:00;47;29;18;Leichter Regenfall;13;12;0.4;Stadt Konstanz, Amt für Stadtplanung und Umwelt
01.07.2022 06:00;107;66;41;Leichter Regenfall;12;11;0.5;Stadt Konstanz, Amt für Stadtplanung und Umwelt
01.07.2022 07:00;570;332;238;Leichter Regenfall;12;12;0.3;Stadt Konstanz, Amt für Stadtplanung und Umwelt
01.07.2022 08:00;522;291;231;Nieselregen;12;12;0.1;Stadt Konstanz, Amt für Stadtplanung und Umwelt
01.07.2022 09:00;372;233;139;Nieselregen;13;13;0.1;Stadt Konstanz, Amt für Stadtplanung und Umwelt
01.07.2022 10:00;283;157;126;Nieselregen;13;13;0.1;Stadt Konstanz, Amt für Stadtplanung und Umwelt
01.07.2022 11:00;372;182;190;Leichter Regenfall;13;13;0.3;Stadt Konstanz, Amt für Stadtplanung und Umwelt
01.07.2022 12:00;440;206;234;Leichter Regenfall;13;13;0.4;Stadt Konstanz, Amt für Stadtplanung und Umwelt
01.07.2022 13:00;726;310;416;Leichter Regenfall;14;14;0.2;Stadt Konstanz, Amt für Stadtplanung und Umwelt
01.07.2022 14:00;573;314;259;Stellenweiser Regenfall;15;15;0;Stadt Konstanz, Amt für Stadtplanung und Umwelt
01.07.2022 15:00;722;354;368;Stellenweiser Regenfall;15;15;0;Stadt Konstanz, Amt für Stadtplanung und Umwelt
01.07.2022 16:00;699;355;344;Stellenweiser Regenfall;16;16;0;Stadt Konstanz, Amt für Stadtplanung und Umwelt
01.07.2022 17:00;840;419;421;Stellenweiser Regenfall;17;17;0;Stadt Konstanz, Amt für Stadtplanung und Umwelt
01.07.2022 18:00;815;464;351;Stellenweiser Regenfall;17;17;0;Stadt Konstanz, Amt für Stadtplanung und Umwelt
01.07.2022 19:00;710;413;297;Stellenweiser Regenfall;16;16;0;Stadt Konstanz, Amt für Stadtplanung und Umwelt
01.07.2022 20:00;597;329;268;Sonnig;14;14;0;Stadt Konstanz, Amt für Stadtplanung und Umwelt
01.07.2022 21:00;388;194;194;Sonnig;12;12;0;Stadt Konstanz, Amt für Stadtplanung und Umwelt
01.07.2022 22:00;386;118;268;Sonnig;11;11;0;Stadt Konstanz, Amt für Stadtplanung und Umwelt
01.07.2022 23:00;392;84;308;Sonnig;10;10;0;Stadt Konstanz, Amt für Stadtplanung und Umwelt
02.07.2022 00:00;325;69;256;Sonnig;9;9;0;Stadt Konstanz, Amt für Stadtplanung und Umwelt
02.07.2022 01:00;163;40;123;Sonnig;8;8;0;Stadt Konstanz, Amt für Stadtplanung und Umwelt
02.07.2022 02:00;100;39;61;Sonnig;8;8;0;Stadt Konstanz, Amt für Stadtplanung und Umwelt
02.07.2022 03:00;61;15;46;Sonnig;8;7;0;Stadt Konstanz, Amt für Stadtplanung und Umwelt
02.07.2022 04:00;44;25;19;Sonnig;9;9;0;Stadt Konstanz, Amt für Stadtplanung und Umwelt
02.07.2022 05:00;34;17;17;Sonnig;10;10;0;Stadt Konstanz, Amt für Stadtplanung und Umwelt
02.07.2022 06:00;58;30;28;Sonnig;10;11;0;Stadt Konstanz, Amt für Stadtplanung und Umwelt
02.07.2022 07:00;137;71;66;Sonnig;13;13;0;Stadt Konstanz, Amt für Stadtplanung und Umwelt
02.07.2022 08:00;293;150;143;Sonnig;15;15;0;Stadt Konstanz, Amt für Stadtplanung und Umwelt
02.07.2022 09:00;649;441;208;Sonnig;18;18;0;Stadt Konstanz, Amt für Stadtplanung und Umwelt
02.07.2022 10:00;819;480;339;Sonnig;19;19;0;Stadt Konstanz, Amt für Stadtplanung und Umwelt
02.07.2022 11:00;779;395;384;Sonnig;21;21;0;Stadt Konstanz, Amt für Stadtplanung und Umwelt
02.07.2022 12:00;829;384;445;Sonnig;23;25;0;Stadt Konstanz, Amt für Stadtplanung und Umwelt
02.07.2022 13:00;813;411;402;Sonnig;24;25;0;Stadt Konstanz, Amt für Stadtplanung und Umwelt
02.07.2022 14:00;775;338;437;Sonnig;24;25;0;Stadt Konstanz, Amt für Stadtplanung und Umwelt
02.07.2022 15:00;868;416;452;Sonnig;25;26;0;Stadt Konstanz, Amt für Stadtplanung und Umwelt
02.07.2022 16:00;779;382;397;Sonnig;25;26;0;Stadt Konstanz, Amt für Stadtplanung und Umwelt
02.07.2022 17:00;787;399;388;Sonnig;24;26;0;Stadt Konstanz, Amt für Stadtplanung und Umwelt
02.07.2022 18:00;822;367;455;Sonnig;24;26;0;Stadt Konstanz, Amt für Stadtplanung und Umwelt
02.07.2022 19:00;685;343;342;Sonnig;21;21;0;Stadt Konstanz, Amt für Stadtplanung und Umwelt
02.07.2022 20:00;571;300;271;Sonnig;18;18;0;Stadt Konstanz, Amt für Stadtplanung und Umwelt
02.07.2022 21:00;503;245;258;Sonnig;15;15;0;Stadt Konstanz, Amt für Stadtplanung und Umwelt
02.07.2022 22:00;421;171;250;Sonnig;15;15;0;Stadt Konstanz, Amt für Stadtplanung und Umwelt
02.07.2022 23:00;307;107;200;Sonnig;14;14;0;Stadt Konstanz, Amt für Stadtplanung und Umwelt
03.07.2022 00:00;276;111;165;Sonnig;14;14;0;Stadt Konstanz, Amt für Stadtplanung und Umwelt
03.07.2022 01:00;154;55;99;Sonnig;13;13;0;Stadt Konstanz, Amt für Stadtplanung und Umwelt
03.07.2022 02:00;74;31;43;Sonnig;13;13;0;Stadt Konstanz, Amt für Stadtplanung und Umwelt
03.07.2022 03:00;77;30;47;Sonnig;13;13;0;Stadt Konstanz, Amt für Stadtplanung und Umwelt
03.07.2022 04:00;36;18;18;Sonnig;14;14;0;Stadt Konstanz, Amt für Stadtplanung und Umwelt
03.07.2022 05:00;21;12;9;Sonnig;14;14;0;Stadt Konstanz, Amt für Stadtplanung und Umwelt
03.07.2022 06:00;46;22;24;Sonnig;15;15;0;Stadt Konstanz, Amt für Stadtplanung und Umwelt
03.07.2022 07:00;65;22;43;Sonnig;18;18;0;Stadt Konstanz, Amt für Stadtplanung und Umwelt
03.07.2022 08:00;141;69;72;Sonnig;20;20;0;Stadt Konstanz, Amt für Stadtplanung und Umwelt
03.07.2022 09:00;399;188;211;Sonnig;23;25;0;Stadt Konstanz, Amt für Stadtplanung und Umwelt
03.07.2022 10:00;482;243;239;Sonnig;25;27;0;Stadt Konstanz, Amt für Stadtplanung und Umwelt
03.07.2022 11:00;518;270;248;Sonnig;27;29;0;Stadt Konstanz, Amt für Stadtplanung und Umwelt
03.07.2022 12:00;526;224;302;Sonnig;30;31;0;Stadt Konstanz, Amt für Stadtplanung und Umwelt
03.07.2022 13:00;582;309;273;Sonnig;30;32;0;Stadt Konstanz, Amt für Stadtplanung und Umwelt
03.07.2022 14:00;703;367;336;Sonnig;31;32;0;Stadt Konstanz, Amt für Stadtplanung und Umwelt
03.07.2022 15:00;616;342;274;Sonnig;32;33;0;Stadt Konstanz, Amt für Stadtplanung und Umwelt
03.07.2022 16:00;638;318;320;Sonnig;31;32;0;Stadt Konstanz, Amt für Stadtplanung und Umwelt
03.07.2022 17:00;683;344;339;Sonnig;30;31;0;Stadt Konstanz, Amt für Stadtplanung und Umwelt
03.07.2022 18:00;695;342;353;Sonnig;29;31;0;Stadt Konstanz, Amt für Stadtplanung und Umwelt
03.07.2022 19:00;603;294;309;Sonnig;25;27;0;Stadt Konstanz, Amt für Stadtplanung und Umwelt
03.07.2022 20:00;496;207;289;Sonnig;22;22;0;Stadt Konstanz, Amt für Stadtplanung und Umwelt
03.07.2022 21:00;364;134;230;Sonnig;18;18;0;Stadt Konstanz, Amt für Stadtplanung und Umwelt
03.07.2022 22:00;238;103;135;Sonnig;17;17;0;Stadt Konstanz, Amt für Stadtplanung und Umwelt
03.07.2022 23:00;128;40;88;Stellenweise Gewitter und Niederschlaege;16;16;0;Stadt Konstanz, Amt für Stadtplanung und Umwelt
04.07.2022 00:00;42;22;20;Stellenweise Gewitter und Niederschlaege;15;15;0.1;Stadt Konstanz, Amt für Stadtplanung und Umwelt
04.07.2022 01:00;32;10;22;Stellenweise Gewitter und Niederschlaege;15;15;0;Stadt Konstanz, Amt für Stadtplanung und Umwelt
04.07.2022 02:00;15;10;5;Stellenweise Gewitter und Niederschlaege;15;15;0;Stadt Konstanz, Amt für Stadtplanung und Umwelt
04.07.2022 03:00;6;1;5;Stellenweise Gewitter und Niederschlaege;15;15;0;Stadt Konstanz, Amt für Stadtplanung und Umwelt
04.07.2022 04:00;17;13;4;Stellenweise Gewitter und Niederschlaege;15;15;0;Stadt Konstanz, Amt für Stadtplanung und Umwelt
04.07.2022 05:00;33;24;9;Leichter Regenschauer;15;15;0.1;Stadt Konstanz, Amt für Stadtplanung und Umwelt
04.07.2022 06:00;136;85;51;Leichter Regenschauer;16;16;0.1;Stadt Konstanz, Amt für Stadtplanung und Umwelt
04.07.2022 07:00;781;477;304;Leichter Regenschauer;17;17;0;Stadt Konstanz, Amt für Stadtplanung und Umwelt
04.07.2022 08:00;739;388;351;Bedeckt;18;18;0;Stadt Konstanz, Amt für Stadtplanung und Umwelt
04.07.2022 09:00;630;344;286;Bedeckt;19;19;0;Stadt Konstanz, Amt für Stadtplanung und Umwelt
04.07.2022 10:00;576;338;238;Bedeckt;19;19;0;Stadt Konstanz, Amt für Stadtplanung und Umwelt
04.07.2022 11:00;578;262;316;Stellenweiser Regenfall;20;20;0;Stadt Konstanz, Amt für Stadtplanung und Umwelt
04.07.2022 12:00;713;325;388;Stellenweiser Regenfall;21;21;0;Stadt Konstanz, Amt für Stadtplanung und Umwelt
04.07.2022 13:00;872;428;444;Stellenweiser Regenfall;22;23;0;Stadt Konstanz, Amt für Stadtplanung und Umwelt
04.07.2022 14:00;714;375;339;Stellenweiser Regenfall;23;24;0;Stadt Konstanz, Amt für Stadtplanung und Umwelt
04.07.2022 15:00;893;447;446;Stellenweiser Regenfall;25;26;0;Stadt Konstanz, Amt für Stadtplanung und Umwelt
04.07.2022 16:00;918;440;478;Stellenweiser Regenfall;24;25;0;Stadt Konstanz, Amt für Stadtplanung und Umwelt
04.07.2022 17:00;880;358;522;Leichter Regenschauer;23;25;0.2;Stadt Konstanz, Amt für Stadtplanung und Umwelt
04.07.2022 18:00;653;306;347;Leichter Regenschauer;22;22;0.2;Stadt Konstanz, Amt für Stadtplanung und Umwelt
04.07.2022 19:00;495;244;251;Leichter Regenschauer;20;20;0.1;Stadt Konstanz, Amt für Stadtplanung und Umwelt
04.07.2022 20:00;336;134;202;Stellenweiser Regenfall;18;18;0.2;Stadt Konstanz, Amt für Stadtplanung und Umwelt
04.07.2022 21:00;285;125;160;Stellenweiser Regenfall;16;16;0.2;Stadt Konstanz, Amt für Stadtplanung und Umwelt
04.07.2022 22:00;179;78;101;Stellenweiser Regenfall;16;16;0.1;Stadt Konstanz, Amt für Stadtplanung und Umwelt
04.07.2022 23:00;98;48;50;Leichter Regenschauer;15;15;0.5;Stadt Konstanz, Amt für Stadtplanung und Umwelt
05.07.2022 00:00;39;15;24;Leichter Regenschauer;14;14;0.9;Stadt Konstanz, Amt für Stadtplanung und Umwelt
05.07.2022 01:00;19;10;9;Leichter Regenschauer;14;14;0.5;Stadt Konstanz, Amt für Stadtplanung und Umwelt
05.07.2022 02:00;11;6;5;Stellenweiser Regenfall;14;14;0;Stadt Konstanz, Amt für Stadtplanung und Umwelt
05.07.2022 03:00;4;1;3;Stellenweiser Regenfall;14;14;0;Stadt Konstanz, Amt für Stadtplanung und Umwelt
05.07.2022 04:00;12;5;7;Stellenweiser Regenfall;14;14;0;Stadt Konstanz, Amt für Stadtplanung und Umwelt
05.07.2022 05:00;48;34;14;Leichter Nebel;15;15;0;Stadt Konstanz, Amt für Stadtplanung und Umwelt
05.07.2022 06:00;200;112;88;Leichter Nebel;16;16;0;Stadt Konstanz, Amt für Stadtplanung und Umwelt
05.07.2022 07:00;736;409;327;Leichter Nebel;17;17;0;Stadt Konstanz, Amt für Stadtplanung und Umwelt
05.07.2022 08:00;945;526;419;Bewoelkt;19;19;0;Stadt Konstanz, Amt für Stadtplanung und Umwelt
05.07.2022 09:00;828;504;324;Bewoelkt;20;20;0;Stadt Konstanz, Amt für Stadtplanung und Umwelt
05.07.2022 10:00;751;420;331;Bewoelkt;22;22;0;Stadt Konstanz, Amt für Stadtplanung und Umwelt
05.07.2022 11:00;733;357;376;Stellenweiser Regenfall;23;24;0;Stadt Konstanz, Amt für Stadtplanung und Umwelt
05.07.2022 12:00;881;401;480;Stellenweiser Regenfall;25;26;0;Stadt Konstanz, Amt für Stadtplanung und Umwelt
05.07.2022 13:00;872;430;442;Stellenweiser Regenfall;26;27;0;Stadt Konstanz, Amt für Stadtplanung und Umwelt
05.07.2022 14:00;830;435;395;Sonnig;27;28;0;Stadt Konstanz, Amt für Stadtplanung und Umwelt
05.07.2022 15:00;1074;543;531;Sonnig;29;29;0;Stadt Konstanz, Amt für Stadtplanung und Umwelt
05.07.2022 16:00;1161;564;597;Sonnig;27;28;0;Stadt Konstanz, Amt für Stadtplanung und Umwelt
05.07.2022 17:00;1255;580;675;Leicht bewoelkt;25;27;0;Stadt Konstanz, Amt für Stadtplanung und Umwelt
05.07.2022 18:00;1157;555;602;Leicht bewoelkt;24;25;0;Stadt Konstanz, Amt für Stadtplanung und Umwelt
05.07.2022 19:00;927;435;492;Leicht bewoelkt;21;21;0;Stadt Konstanz, Amt für Stadtplanung und Umwelt
05.07.2022 20:00;644;298;346;Sonnig;18;18;0;Stadt Konstanz, Amt für Stadtplanung und Umwelt
05.07.2022 21:00;461;193;268;Sonnig;16;16;0;Stadt Konstanz, Amt für Stadtplanung und Umwelt
05.07.2022 22:00;351;130;221;Sonnig;15;15;0;Stadt Konstanz, Amt für Stadtplanung und Umwelt
05.07.2022 23:00;203;63;140;Sonnig;14;14;0;Stadt Konstanz, Amt für Stadtplanung und Umwelt
06.07.2022 00:00;118;35;83;Sonnig;14;14;0;Stadt Konstanz, Amt für Stadtplanung und Umwelt
06.07.2022 01:00;67;27;40;Sonnig;13;13;0;Stadt Konstanz, Amt für Stadtplanung und Umwelt
06.07.2022 02:00;15;8;7;Sonnig;13;13;0;Stadt Konstanz, Amt für Stadtplanung und Umwelt
06.07.2022 03:00;11;3;8;Sonnig;12;12;0;Stadt Konstanz, Amt für Stadtplanung und Umwelt
06.07.2022 04:00;18;10;8;Sonnig;13;13;0;Stadt Konstanz, Amt für Stadtplanung und Umwelt
06.07.2022 05:00;62;35;27;Sonnig;13;13;0;Stadt Konstanz, Amt für Stadtplanung und Umwelt
06.07.2022 06:00;242;126;116;Sonnig;14;14;0;Stadt Konstanz, Amt für Stadtplanung und Umwelt
06.07.2022 07:00;855;447;408;Sonnig;16;16;0;Stadt Konstanz, Amt für Stadtplanung und Umwelt
06.07.2022 08:00;972;556;416;Sonnig;18;18;0;Stadt Konstanz, Amt für Stadtplanung und Umwelt
06.07.2022 09:00;808;442;366;Sonnig;19;19;0;Stadt Konstanz, Amt für Stadtplanung und Umwelt
06.07.2022 10:00;711;373;338;Sonnig;21;21;0;Stadt Konstanz, Amt für Stadtplanung und Umwelt
06.07.2022 11:00;718;350;368;Sonnig;22;22;0;Stadt Konstanz, Amt für Stadtplanung und Umwelt
06.07.2022 12:00;849;385;464;Sonnig;23;25;0;Stadt Konstanz, Amt für Stadtplanung und Umwelt
06.07.2022 13:00;908;473;435;Sonnig;23;25;0;Stadt Konstanz, Amt für Stadtplanung und Umwelt
06.07.2022 14:00;856;436;420;Sonnig;24;25;0;Stadt Konstanz, Amt für Stadtplanung und Umwelt
06.07.2022 15:00;1005;497;508;Sonnig;24;25;0;Stadt Konstanz, Amt für Stadtplanung und Umwelt
06.07.2022 16:00;1182;571;611;Sonnig;24;25;0;Stadt Konstanz, Amt für Stadtplanung und Umwelt
06.07.2022 17:00;1173;573;600;Sonnig;23;25;0;Stadt Konstanz, Amt für Stadtplanung und Umwelt
06.07.2022 18:00;1107;512;595;Sonnig;23;25;0;Stadt Konstanz, Amt für Stadtplanung und Umwelt
06.07.2022 19:00;842;418;424;Sonnig;21;21;0;Stadt Konstanz, Amt für Stadtplanung und Umwelt
06.07.2022 20:00;621;328;293;Sonnig;19;19;0;Stadt Konstanz, Amt für Stadtplanung und Umwelt
06.07.2022 21:00;555;269;286;Sonnig;17;17;0;Stadt Konstanz, Amt für Stadtplanung und Umwelt
06.07.2022 22:00;465;196;269;Sonnig;15;15;0;Stadt Konstanz, Amt für Stadtplanung und Umwelt
06.07.2022 23:00;211;67;144;Leicht bewoelkt;14;14;0;Stadt Konstanz, Amt für Stadtplanung und Umwelt
07.07.2022 00:00;124;26;98;Leicht bewoelkt;13;12;0;Stadt Konstanz, Amt für Stadtplanung und Umwelt
07.07.2022 01:00;71;24;47;Leicht bewoelkt;12;12;0;Stadt Konstanz, Amt für Stadtplanung und Umwelt
07.07.2022 02:00;36;15;21;Sonnig;11;11;0;Stadt Konstanz, Amt für Stadtplanung und Umwelt
07.07.2022 03:00;38;21;17;Sonnig;11;11;0;Stadt Konstanz, Amt für Stadtplanung und Umwelt
07.07.2022 04:00;21;11;10;Sonnig;11;12;0;Stadt Konstanz, Amt für Stadtplanung und Umwelt
07.07.2022 05:00;57;37;20;Leicht bewoelkt;12;12;0;Stadt Konstanz, Amt für Stadtplanung und Umwelt
07.07.2022 06:00;193;105;88;Leicht bewoelkt;13;13;0;Stadt Konstanz, Amt für Stadtplanung und Umwelt
07.07.2022 07:00;990;619;371;Leicht bewoelkt;15;15;0;Stadt Konstanz, Amt für Stadtplanung und Umwelt
07.07.2022 08:00;909;485;424;Sonnig;17;17;0;Stadt Konstanz, Amt für Stadtplanung und Umwelt
07.07.2022 09:00;819;474;345;Sonnig;19;19;0;Stadt Konstanz, Amt für Stadtplanung und Umwelt
07.07.2022 10:00;651;372;279;Sonnig;20;20;0;Stadt Konstanz, Amt für Stadtplanung und Umwelt
07.07.2022 11:00;718;346;372;Leicht bewoelkt;21;21;0;Stadt Konstanz, Amt für Stadtplanung und Umwelt
07.07.2022 12:00;838;371;467;Leicht bewoelkt;22;24;0;Stadt Konstanz, Amt für Stadtplanung und Umwelt
07.07.2022 13:00;1097;481;616;Leicht bewoelkt;22;24;0;Stadt Konstanz, Amt für Stadtplanung und Umwelt
07.07.2022 14:00;784;373;411;Leicht bewoelkt;22;22;0;Stadt Konstanz, Amt für Stadtplanung und Umwelt
07.07.2022 15:00;1042;471;571;Leicht bewoelkt;21;21;0;Stadt Konstanz, Amt für Stadtplanung und Umwelt
07.07.2022 16:00;907;423;484;Leicht bewoelkt;21;21;0;Stadt Konstanz, Amt für Stadtplanung und Umwelt
07.07.2022 17:00;1046;488;558;Stellenweiser Regenfall;21;21;0;Stadt Konstanz, Amt für Stadtplanung und Umwelt
07.07.2022 18:00;1003;471;532;Stellenweiser Regenfall;20;20;0;Stadt Konstanz, Amt für Stadtplanung und Umwelt
07.07.2022 19:00;737;366;371;Stellenweiser Regenfall;18;18;0;Stadt Konstanz, Amt für Stadtplanung und Umwelt
07.07.2022 20:00;455;185;270;Stellenweiser Regenfall;16;16;0.2;Stadt Konstanz, Amt für Stadtplanung und Umwelt
07.07.2022 21:00;415;155;260;Stellenweiser Regenfall;14;14;0.3;Stadt Konstanz, Amt für Stadtplanung und Umwelt
07.07.2022 22:00;347;142;205;Stellenweiser Regenfall;14;14;0.1;Stadt Konstanz, Amt für Stadtplanung und Umwelt
07.07.2022 23:00;278;64;214;Stellenweiser Regenfall;14;14;0.1;Stadt Konstanz, Amt für Stadtplanung und Umwelt
08.07.2022 00:00;117;43;74;Stellenweiser Regenfall;13;14;0.1;Stadt Konstanz, Amt für Stadtplanung und Umwelt
08.07.2022 01:00;61;28;33;Stellenweiser Regenfall;12;12;0.1;Stadt Konstanz, Amt für Stadtplanung und Umwelt
08.07.2022 02:00;24;10;14;Leicht bewoelkt;11;11;0;Stadt Konstanz, Amt für Stadtplanung und Umwelt
08.07.2022 03:00;6;3;3;Leicht bewoelkt;10;9;0;Stadt Konstanz, Amt für Stadtplanung und Umwelt
08.07.2022 04:00;8;7;1;Leicht bewoelkt;10;9;0;Stadt Konstanz, Amt für Stadtplanung und Umwelt
08.07.2022 05:00;44;25;19;Leicht bewoelkt;10;10;0;Stadt Konstanz, Amt für Stadtplanung und Umwelt
08.07.2022 06:00;171;94;77;Leicht bewoelkt;11;10;0;Stadt Konstanz, Amt für Stadtplanung und Umwelt
08.07.2022 07:00;901;575;326;Leicht bewoelkt;12;12;0;Stadt Konstanz, Amt für Stadtplanung und Umwelt
08.07.2022 08:00;889;493;396;Sonnig;14;13;0;Stadt Konstanz, Amt für Stadtplanung und Umwelt
08.07.2022 09:00;793;474;319;Sonnig;15;15;0;Stadt Konstanz, Amt für Stadtplanung und Umwelt
08.07.2022 10:00;761;426;335;Sonnig;17;17;0;Stadt Konstanz, Amt für Stadtplanung und Umwelt
08.07.2022 11:00;793;359;434;Sonnig;18;18;0;Stadt Konstanz, Amt für Stadtplanung und Umwelt
08.07.2022 12:00;928;403;525;Sonnig;19;19;0;Stadt Konstanz, Amt für Stadtplanung und Umwelt
08.07.2022 13:00;1075;428;647;Sonnig;19;19;0;Stadt Konstanz, Amt für Stadtplanung und Umwelt
08.07.2022 14:00;935;475;460;Sonnig;20;20;0;Stadt Konstanz, Amt für Stadtplanung und Umwelt
08.07.2022 15:00;1038;494;544;Sonnig;21;21;0;Stadt Konstanz, Amt für Stadtplanung und Umwelt
08.07.2022 16:00;957;474;483;Sonnig;21;21;0;Stadt Konstanz, Amt für Stadtplanung und Umwelt
08.07.2022 17:00;1084;499;585;Sonnig;22;22;0;Stadt Konstanz, Amt für Stadtplanung und Umwelt
08.07.2022 18:00;1011;491;520;Sonnig;23;25;0;Stadt Konstanz, Amt für Stadtplanung und Umwelt
08.07.2022 19:00;860;439;421;Sonnig;19;19;0;Stadt Konstanz, Amt für Stadtplanung und Umwelt
08.07.2022 20:00;672;327;345;Sonnig;16;15;0;Stadt Konstanz, Amt für Stadtplanung und Umwelt
08.07.2022 21:00;475;214;261;Sonnig;12;12;0;Stadt Konstanz, Amt für Stadtplanung und Umwelt
08.07.2022 22:00;412;164;248;Sonnig;12;11;0;Stadt Konstanz, Amt für Stadtplanung und Umwelt
08.07.2022 23:00;397;130;267;Sonnig;12;11;0;Stadt Konstanz, Amt für Stadtplanung und Umwelt
09.07.2022 00:00;260;59;201;Sonnig;11;11;0;Stadt Konstanz, Amt für Stadtplanung und Umwelt
09.07.2022 01:00;164;51;113;Sonnig;11;11;0;Stadt Konstanz, Amt für Stadtplanung und Umwelt
09.07.2022 02:00;91;29;62;Sonnig;10;10;0;Stadt Konstanz, Amt für Stadtplanung und Umwelt
09.07.2022 03:00;50;7;43;Sonnig;10;10;0;Stadt Konstanz, Amt für Stadtplanung und Umwelt
09.07.2022 04:00;47;32;15;Sonnig;11;11;0;Stadt Konstanz, Amt für Stadtplanung und Umwelt
09.07.2022 05:00;40;20;20;Sonnig;11;11;0;Stadt Konstanz, Amt für Stadtplanung und Umwelt
09.07.2022 06:00;82;47;35;Sonnig;12;12;0;Stadt Konstanz, Amt für Stadtplanung und Umwelt
09.07.2022 07:00;133;72;61;Sonnig;14;14;0;Stadt Konstanz, Amt für Stadtplanung und Umwelt
09.07.2022 08:00;303;188;115;Sonnig;16;16;0;Stadt Konstanz, Amt für Stadtplanung und Umwelt
09.07.2022 09:00;577;314;263;Sonnig;19;19;0;Stadt Konstanz, Amt für Stadtplanung und Umwelt
09.07.2022 10:00;732;475;257;Sonnig;20;20;0;Stadt Konstanz, Amt für Stadtplanung und Umwelt
09.07.2022 11:00;842;492;350;Sonnig;21;21;0;Stadt Konstanz, Amt für Stadtplanung und Umwelt
09.07.2022 12:00;828;443;385;Sonnig;23;25;0;Stadt Konstanz, Amt für Stadtplanung und Umwelt
09.07.2022 13:00;720;349;371;Sonnig;23;25;0;Stadt Konstanz, Amt für Stadtplanung und Umwelt
09.07.2022 14:00;817;388;429;Sonnig;24;25;0;Stadt Konstanz, Amt für Stadtplanung und Umwelt
09.07.2022 15:00;894;413;481;Sonnig;24;25;0;Stadt Konstanz, Amt für Stadtplanung und Umwelt
09.07.2022 16:00;850;351;499;Sonnig;24;25;0;Stadt Konstanz, Amt für Stadtplanung und Umwelt
09.07.2022 17:00;791;384;407;Sonnig;23;25;0;Stadt Konstanz, Amt für Stadtplanung und Umwelt
09.07.2022 18:00;805;385;420;Sonnig;22;25;0;Stadt Konstanz, Amt für Stadtplanung und Umwelt
09.07.2022 19:00;786;417;369;Sonnig;20;20;0;Stadt Konstanz, Amt für Stadtplanung und Umwelt
09.07.2022 20:00;535;281;254;Sonnig;18;18;0;Stadt Konstanz, Amt für Stadtplanung und Umwelt
09.07.2022 21:00;426;186;240;Sonnig;15;15;0;Stadt Konstanz, Amt für Stadtplanung und Umwelt
09.07.2022 22:00;409;167;242;Sonnig;15;15;0;Stadt Konstanz, Amt für Stadtplanung und Umwelt
09.07.2022 23:00;434;113;321;Bewoelkt;15;15;0;Stadt Konstanz, Amt für Stadtplanung und Umwelt
10.07.2022 00:00;262;74;188;Bewoelkt;15;15;0;Stadt Konstanz, Amt für Stadtplanung und Umwelt
10.07.2022 01:00;167;55;112;Bewoelkt;15;14;0;Stadt Konstanz, Amt für Stadtplanung und Umwelt
10.07.2022 02:00;94;36;58;Bedeckt;14;14;0;Stadt Konstanz, Amt für Stadtplanung und Umwelt
10.07.2022 03:00;66;27;39;Bedeckt;14;14;0;Stadt Konstanz, Amt für Stadtplanung und Umwelt
10.07.2022 04:00;35;17;18;Bedeckt;14;15;0;Stadt Konstanz, Amt für Stadtplanung und Umwelt
10.07.2022 05:00;26;9;17;Bewoelkt;15;15;0;Stadt Konstanz, Amt für Stadtplanung und Umwelt
10.07.2022 06:00;53;32;21;Bewoelkt;15;15;0;Stadt Konstanz, Amt für Stadtplanung und Umwelt
10.07.2022 07:00;66;26;40;Bewoelkt;16;16;0;Stadt Konstanz, Amt für Stadtplanung und Umwelt
10.07.2022 08:00;138;55;83;Leicht bewoelkt;16;16;0;Stadt Konstanz, Amt für Stadtplanung und Umwelt
10.07.2022 09:00;341;172;169;Leicht bewoelkt;17;17;0;Stadt Konstanz, Amt für Stadtplanung und Umwelt
10.07.2022 10:00;391;227;164;Leicht bewoelkt;18;18;0;Stadt Konstanz, Amt für Stadtplanung und Umwelt
10.07.2022 11:00;435;224;211;Sonnig;19;19;0;Stadt Konstanz, Amt für Stadtplanung und Umwelt
10.07.2022 12:00;564;267;297;Sonnig;20;20;0;Stadt Konstanz, Amt für Stadtplanung und Umwelt
10.07.2022 13:00;550;288;262;Sonnig;21;21;0;Stadt Konstanz, Amt für Stadtplanung und Umwelt
10.07.2022 14:00;593;267;326;Leicht bewoelkt;21;21;0;Stadt Konstanz, Amt für Stadtplanung und Umwelt
10.07.2022 15:00;579;284;295;Leicht bewoelkt;22;22;0;Stadt Konstanz, Amt für Stadtplanung und Umwelt
10.07.2022 16:00;630;297;333;Leicht bewoelkt;21;21;0;Stadt Konstanz, Amt für Stadtplanung und Umwelt
10.07.2022 17:00;632;355;277;Sonnig;21;21;0;Stadt Konstanz, Amt für Stadtplanung und Umwelt
10.07.2022 18:00;591;289;302;Sonnig;21;21;0;Stadt Konstanz, Amt für Stadtplanung und Umwelt
10.07.2022 19:00;452;209;243;Sonnig;18;18;0;Stadt Konstanz, Amt für Stadtplanung und Umwelt
10.07.2022 20:00;363;182;181;Sonnig;15;15;0;Stadt Konstanz, Amt für Stadtplanung und Umwelt
10.07.2022 21:00;280;116;164;Sonnig;12;12;0;Stadt Konstanz, Amt für Stadtplanung und Umwelt
10.07.2022 22:00;166;80;86;Sonnig;12;11;0;Stadt Konstanz, Amt für Stadtplanung und Umwelt
10.07.2022 23:00;89;41;48;Sonnig;11;11;0;Stadt Konstanz, Amt für Stadtplanung und Umwelt
11.07.2022 00:00;52;22;30;Sonnig;10;10;0;Stadt Konstanz, Amt für Stadtplanung und Umwelt
11.07.2022 01:00;31;15;16;Sonnig;10;10;0;Stadt Konstanz, Amt für Stadtplanung und Umwelt
11.07.2022 02:00;12;7;5;Sonnig;9;9;0;Stadt Konstanz, Amt für Stadtplanung und Umwelt
11.07.2022 03:00;4;3;1;Sonnig;9;9;0;Stadt Konstanz, Amt für Stadtplanung und Umwelt
11.07.2022 04:00;10;5;5;Sonnig;10;10;0;Stadt Konstanz, Amt für Stadtplanung und Umwelt
11.07.2022 05:00;39;22;17;Sonnig;11;11;0;Stadt Konstanz, Amt für Stadtplanung und Umwelt
11.07.2022 06:00;205;137;68;Sonnig;12;12;0;Stadt Konstanz, Amt für Stadtplanung und Umwelt
11.07.2022 07:00;950;582;368;Sonnig;14;14;0;Stadt Konstanz, Amt für Stadtplanung und Umwelt
11.07.2022 08:00;905;527;378;Sonnig;15;15;0;Stadt Konstanz, Amt für Stadtplanung und Umwelt
11.07.2022 09:00;787;448;339;Sonnig;17;17;0;Stadt Konstanz, Amt für Stadtplanung und Umwelt
11.07.2022 10:00;652;356;296;Sonnig;19;19;0;Stadt Konstanz, Amt für Stadtplanung und Umwelt
11.07.2022 11:00;746;358;388;Sonnig;21;21;0;Stadt Konstanz, Amt für Stadtplanung und Umwelt
11.07.2022 12:00;825;400;425;Sonnig;22;24;0;Stadt Konstanz, Amt für Stadtplanung und Umwelt
11.07.2022 13:00;1060;504;556;Sonnig;23;25;0;Stadt Konstanz, Amt für Stadtplanung und Umwelt
11.07.2022 14:00;857;410;447;Sonnig;23;25;0;Stadt Konstanz, Amt für Stadtplanung und Umwelt
11.07.2022 15:00;1101;541;560;Sonnig;24;25;0;Stadt Konstanz, Amt für Stadtplanung und Umwelt
11.07.2022 16:00;1207;541;666;Sonnig;23;25;0;Stadt Konstanz, Amt für Stadtplanung und Umwelt
11.07.2022 17:00;1228;594;634;Sonnig;23;25;0;Stadt Konstanz, Amt für Stadtplanung und Umwelt
11.07.2022 18:00;1104;495;609;Sonnig;22;25;0;Stadt Konstanz, Amt für Stadtplanung und Umwelt
11.07.2022 19:00;853;423;430;Sonnig;19;19;0;Stadt Konstanz, Amt für Stadtplanung und Umwelt
11.07.2022 20:00;610;277;333;Sonnig;16;16;0;Stadt Konstanz, Amt für Stadtplanung und Umwelt
11.07.2022 21:00;477;177;300;Sonnig;13;13;0;Stadt Konstanz, Amt für Stadtplanung und Umwelt
11.07.2022 22:00;306;114;192;Sonnig;13;13;0;Stadt Konstanz, Amt für Stadtplanung und Umwelt
11.07.2022 23:00;197;77;120;Sonnig;12;12;0;Stadt Konstanz, Amt für Stadtplanung und Umwelt
12.07.2022 00:00;105;32;73;Sonnig;12;12;0;Stadt Konstanz, Amt für Stadtplanung und Umwelt
12.07.2022 01:00;28;11;17;Sonnig;12;12;0;Stadt Konstanz, Amt für Stadtplanung und Umwelt
12.07.2022 02:00;23;6;17;Sonnig;11;11;0;Stadt Konstanz, Amt für Stadtplanung und Umwelt
12.07.2022 03:00;8;6;2;Sonnig;11;11;0;Stadt Konstanz, Amt für Stadtplanung und Umwelt
12.07.2022 04:00;20;14;6;Sonnig;12;12;0;Stadt Konstanz, Amt für Stadtplanung und Umwelt
12.07.2022 05:00;47;30;17;Sonnig;12;13;0;Stadt Konstanz, Amt für Stadtplanung und Umwelt
12.07.2022 06:00;209;121;88;Sonnig;13;14;0;Stadt Konstanz, Amt für Stadtplanung und Umwelt
12.07.2022 07:00;840;639;201;Sonnig;15;16;0;Stadt Konstanz, Amt für Stadtplanung und Umwelt
12.07.2022 08:00;867;496;371;Sonnig;18;18;0;Stadt Konstanz, Amt für Stadtplanung und Umwelt
12.07.2022 09:00;800;482;318;Sonnig;20;20;0;Stadt Konstanz, Amt für Stadtplanung und Umwelt
12.07.2022 10:00;674;393;281;Sonnig;21;21;0;Stadt Konstanz, Amt für Stadtplanung und Umwelt
12.07.2022 11:00;703;338;365;Sonnig;22;23;0;Stadt Konstanz, Amt für Stadtplanung und Umwelt
12.07.2022 12:00;850;378;472;Sonnig;23;25;0;Stadt Konstanz, Amt für Stadtplanung und Umwelt
12.07.2022 13:00;914;426;488;Sonnig;24;25;0;Stadt Konstanz, Amt für Stadtplanung und Umwelt
12.07.2022 14:00;780;377;403;Sonnig;25;26;0;Stadt Konstanz, Amt für Stadtplanung und Umwelt
12.07.2022 15:00;1151;542;609;Sonnig;26;27;0;Stadt Konstanz, Amt für Stadtplanung und Umwelt
12.07.2022 16:00;1171;563;608;Sonnig;25;26;0;Stadt Konstanz, Amt für Stadtplanung und Umwelt
12.07.2022 17:00;1310;658;652;Sonnig;24;26;0;Stadt Konstanz, Amt für Stadtplanung und Umwelt
12.07.2022 18:00;1197;565;632;Sonnig;24;25;0;Stadt Konstanz, Amt für Stadtplanung und Umwelt
12.07.2022 19:00;964;461;503;Sonnig;21;21;0;Stadt Konstanz, Amt für Stadtplanung und Umwelt
12.07.2022 20:00;707;289;418;Sonnig;19;19;0;Stadt Konstanz, Amt für Stadtplanung und Umwelt
12.07.2022 21:00;565;224;341;Sonnig;16;16;0;Stadt Konstanz, Amt für Stadtplanung und Umwelt
12.07.2022 22:00;375;140;235;Sonnig;15;15;0;Stadt Konstanz, Amt für Stadtplanung und Umwelt
12.07.2022 23:00;230;75;155;Sonnig;14;14;0;Stadt Konstanz, Amt für Stadtplanung und Umwelt
13.07.2022 00:00;118;49;69;Sonnig;13;13;0;Stadt Konstanz, Amt für Stadtplanung und Umwelt
13.07.2022 01:00;57;29;28;Sonnig;12;13;0;Stadt Konstanz, Amt für Stadtplanung und Umwelt
13.07.2022 02:00;12;6;6;Sonnig;12;12;0;Stadt Konstanz, Amt für Stadtplanung und Umwelt
13.07.2022 03:00;11;3;8;Sonnig;11;11;0;Stadt Konstanz, Amt für Stadtplanung und Umwelt
13.07.2022 04:00;14;7;7;Sonnig;12;12;0;Stadt Konstanz, Amt für Stadtplanung und Umwelt
13.07.2022 05:00;70;41;29;Sonnig;12;12;0;Stadt Konstanz, Amt für Stadtplanung und Umwelt
13.07.2022 06:00;210;116;94;Sonnig;12;12;0;Stadt Konstanz, Amt für Stadtplanung und Umwelt
13.07.2022 07:00;1081;612;469;Sonnig;15;15;0;Stadt Konstanz, Amt für Stadtplanung und Umwelt
13.07.2022 08:00;958;520;438;Sonnig;18;18;0;Stadt Konstanz, Amt für Stadtplanung und Umwelt
13.07.2022 09:00;833;454;379;Sonnig;21;21;0;Stadt Konstanz, Amt für Stadtplanung und Umwelt
13.07.2022 10:00;702;405;297;Sonnig;23;25;0;Stadt Konstanz, Amt für Stadtplanung und Umwelt
13.07.2022 11:00;770;385;385;Sonnig;25;26;0;Stadt Konstanz, Amt für Stadtplanung und Umwelt
13.07.2022 12:00;902;377;525;Sonnig;27;27;0;Stadt Konstanz, Amt für Stadtplanung und Umwelt
13.07.2022 13:00;1145;513;632;Sonnig;28;27;0;Stadt Konstanz, Amt für Stadtplanung und Umwelt
13.07.2022 14:00;876;406;470;Leicht bewoelkt;28;28;0;Stadt Konstanz, Amt für Stadtplanung und Umwelt
13.07.2022 15:00;975;480;495;Leicht bewoelkt;29;28;0;Stadt Konstanz, Amt für Stadtplanung und Umwelt
13.07.2022 16:00;1094;539;555;Leicht bewoelkt;27;27;0;Stadt Konstanz, Amt für Stadtplanung und Umwelt
13.07.2022 17:00;1246;621;625;Leicht bewoelkt;25;26;0;Stadt Konstanz, Amt für Stadtplanung und Umwelt
13.07.2022 18:00;1152;561;591;Leicht bewoelkt;23;25;0;Stadt Konstanz, Amt für Stadtplanung und Umwelt
13.07.2022 19:00;875;406;469;Leicht bewoelkt;21;21;0;Stadt Konstanz, Amt für Stadtplanung und Umwelt
13.07.2022 20:00;631;341;290;Sonnig;20;20;0;Stadt Konstanz, Amt für Stadtplanung und Umwelt
13.07.2022 21:00;509;203;306;Sonnig;18;18;0;Stadt Konstanz, Amt für Stadtplanung und Umwelt
13.07.2022 22:00;462;163;299;Sonnig;18;18;0;Stadt Konstanz, Amt für Stadtplanung und Umwelt
13.07.2022 23:00;247;70;177;Leicht bewoelkt;17;17;0;Stadt Konstanz, Amt für Stadtplanung und Umwelt
14.07.2022 00:00;145;35;110;Leicht bewoelkt;17;17;0;Stadt Konstanz, Amt für Stadtplanung und Umwelt
14.07.2022 01:00;58;14;44;Leicht bewoelkt;17;17;0;Stadt Konstanz, Amt für Stadtplanung und Umwelt
14.07.2022 02:00;25;10;15;Sonnig;16;16;0;Stadt Konstanz, Amt für Stadtplanung und Umwelt
14.07.2022 03:00;14;3;11;Sonnig;15;15;0;Stadt Konstanz, Amt für Stadtplanung und Umwelt
14.07.2022 04:00;15;10;5;Sonnig;15;15;0;Stadt Konstanz, Amt für Stadtplanung und Umwelt
14.07.2022 05:00;52;34;18;Sonnig;15;15;0;Stadt Konstanz, Amt für Stadtplanung und Umwelt
14.07.2022 06:00;199;107;92;Sonnig;15;15;0;Stadt Konstanz, Amt für Stadtplanung und Umwelt
14.07.2022 07:00;841;561;280;Sonnig;18;18;0;Stadt Konstanz, Amt für Stadtplanung und Umwelt
14.07.2022 08:00;882;443;439;Sonnig;21;21;0;Stadt Konstanz, Amt für Stadtplanung und Umwelt
14.07.2022 09:00;804;455;349;Sonnig;24;25;0;Stadt Konstanz, Amt für Stadtplanung und Umwelt
14.07.2022 10:00;674;389;285;Sonnig;27;28;0;Stadt Konstanz, Amt für Stadtplanung und Umwelt
14.07.2022 11:00;833;433;400;Sonnig;29;30;0;Stadt Konstanz, Amt für Stadtplanung und Umwelt
14.07.2022 12:00;913;428;485;Sonnig;32;32;0;Stadt Konstanz, Amt für Stadtplanung und Umwelt
14.07.2022 13:00;1024;477;547;Sonnig;32;33;0;Stadt Konstanz, Amt für Stadtplanung und Umwelt
14.07.2022 14:00;874;453;421;Sonnig;33;33;0;Stadt Konstanz, Amt für Stadtplanung und Umwelt
14.07.2022 15:00;1065;478;587;Sonnig;34;34;0;Stadt Konstanz, Amt für Stadtplanung und Umwelt
14.07.2022 16:00;1017;469;548;Sonnig;32;32;0;Stadt Konstanz, Amt für Stadtplanung und Umwelt
14.07.2022 17:00;1089;542;547;Sonnig;30;30;0;Stadt Konstanz, Amt für Stadtplanung und Umwelt
14.07.2022 18:00;1102;527;575;Sonnig;28;28;0;Stadt Konstanz, Amt für Stadtplanung und Umwelt
14.07.2022 19:00;859;403;456;Sonnig;26;27;0;Stadt Konstanz, Amt für Stadtplanung und Umwelt
14.07.2022 20:00;724;340;384;Sonnig;24;26;0;Stadt Konstanz, Amt für Stadtplanung und Umwelt
14.07.2022 21:00;489;231;258;Sonnig;22;22;0;Stadt Konstanz, Amt für Stadtplanung und Umwelt
14.07.2022 22:00;463;179;284;Sonnig;19;19;0;Stadt Konstanz, Amt für Stadtplanung und Umwelt
14.07.2022 23:00;328;94;234;Leicht bewoelkt;17;17;0;Stadt Konstanz, Amt für Stadtplanung und Umwelt
15.07.2022 00:00;145;50;95;Leicht bewoelkt;15;15;0;Stadt Konstanz, Amt für Stadtplanung und Umwelt
15.07.2022 01:00;60;26;34;Leicht bewoelkt;15;15;0;Stadt Konstanz, Amt für Stadtplanung und Umwelt
15.07.2022 02:00;42;15;27;Sonnig;15;15;0;Stadt Konstanz, Amt für Stadtplanung und Umwelt
15.07.2022 03:00;11;5;6;Sonnig;14;14;0;Stadt Konstanz, Amt für Stadtplanung und Umwelt
15.07.2022 04:00;14;9;5;Sonnig;14;15;0;Stadt Konstanz, Amt für Stadtplanung und Umwelt
15.07.2022 05:00;46;32;14;Sonnig;15;15;0;Stadt Konstanz, Amt für Stadtplanung und Umwelt
15.07.2022 06:00;194;101;93;Sonnig;15;15;0;Stadt Konstanz, Amt für Stadtplanung und Umwelt
15.07.2022 07:00;908;584;324;Sonnig;17;17;0;Stadt Konstanz, Amt für Stadtplanung und Umwelt
15.07.2022 08:00;823;467;356;Sonnig;19;19;0;Stadt Konstanz, Amt für Stadtplanung und Umwelt
15.07.2022 09:00;899;519;380;Sonnig;21;21;0;Stadt Konstanz, Amt für Stadtplanung und Umwelt
15.07.2022 10:00;741;387;354;Sonnig;22;22;0;Stadt Konstanz, Amt für Stadtplanung und Umwelt
15.07.2022 11:00;825;395;430;Sonnig;23;24;0;Stadt Konstanz, Amt für Stadtplanung und Umwelt
15.07.2022 12:00;967;458;509;Sonnig;25;26;0;Stadt Konstanz, Amt für Stadtplanung und Umwelt
15.07.2022 13:00;1107;420;687;Sonnig;26;27;0;Stadt Konstanz, Amt für Stadtplanung und Umwelt
15.07.2022 14:00;902;454;448;Sonnig;28;28;0;Stadt Konstanz, Amt für Stadtplanung und Umwelt
15.07.2022 15:00;945;451;494;Sonnig;29;29;0;Stadt Konstanz, Amt für Stadtplanung und Umwelt
15.07.2022 16:00;945;467;478;Sonnig;27;28;0;Stadt Konstanz, Amt für Stadtplanung und Umwelt
15.07.2022 17:00;973;497;476;Leicht bewoelkt;25;27;0;Stadt Konstanz, Amt für Stadtplanung und Umwelt
15.07.2022 18:00;953;478;475;Leicht bewoelkt;24;25;0;Stadt Konstanz, Amt für Stadtplanung und Umwelt
15.07.2022 19:00;869;469;400;Leicht bewoelkt;21;21;0;Stadt Konstanz, Amt für Stadtplanung und Umwelt
15.07.2022 20:00;691;318;373;Leicht bewoelkt;19;19;0;Stadt Konstanz, Amt für Stadtplanung und Umwelt
15.07.2022 21:00;508;229;279;Leicht bewoelkt;16;16;0;Stadt Konstanz, Amt für Stadtplanung und Umwelt
15.07.2022 22:00;418;169;249;Leicht bewoelkt;15;15;0;Stadt Konstanz, Amt für Stadtplanung und Umwelt
15.07.2022 23:00;400;118;282;Sonnig;15;15;0;Stadt Konstanz, Amt für Stadtplanung und Umwelt
16.07.2022 00:00;254;69;185;Sonnig;14;14;0;Stadt Konstanz, Amt für Stadtplanung und Umwelt
16.07.2022 01:00;146;39;107;Sonnig;13;13;0;Stadt Konstanz, Amt für Stadtplanung und Umwelt
16.07.2022 02:00;112;39;73;Sonnig;13;13;0;Stadt Konstanz, Amt für Stadtplanung und Umwelt
16.07.2022 03:00;61;26;35;Sonnig;12;12;0;Stadt Konstanz, Amt für Stadtplanung und Umwelt
16.07.2022 04:00;45;22;23;Sonnig;12;12;0;Stadt Konstanz, Amt für Stadtplanung und Umwelt
16.07.2022 05:00;44;25;19;Sonnig;12;13;0;Stadt Konstanz, Amt für Stadtplanung und Umwelt
16.07.2022 06:00;64;38;26;Sonnig;13;13;0;Stadt Konstanz, Amt für Stadtplanung und Umwelt
16.07.2022 07:00;116;61;55;Sonnig;15;15;0;Stadt Konstanz, Amt für Stadtplanung und Umwelt
16.07.2022 08:00;309;172;137;Sonnig;17;17;0;Stadt Konstanz, Amt für Stadtplanung und Umwelt
16.07.2022 09:00;548;312;236;Sonnig;19;19;0;Stadt Konstanz, Amt für Stadtplanung und Umwelt
16.07.2022 10:00;697;381;316;Sonnig;21;21;0;Stadt Konstanz, Amt für Stadtplanung und Umwelt
16.07.2022 11:00;759;430;329;Sonnig;22;22;0;Stadt Konstanz, Amt für Stadtplanung und Umwelt
16.07.2022 12:00;778;428;350;Sonnig;23;25;0;Stadt Konstanz, Amt für Stadtplanung und Umwelt
16.07.2022 13:00;837;427;410;Sonnig;24;25;0;Stadt Konstanz, Amt für Stadtplanung und Umwelt
16.07.2022 14:00;781;377;404;Sonnig;24;25;0;Stadt Konstanz, Amt für Stadtplanung und Umwelt
16.07.2022 15:00;778;349;429;Sonnig;25;25;0;Stadt Konstanz, Amt für Stadtplanung und Umwelt
16.07.2022 16:00;755;357;398;Sonnig;24;25;0;Stadt Konstanz, Amt für Stadtplanung und Umwelt
16.07.2022 17:00;750;364;386;Sonnig;24;25;0;Stadt Konstanz, Amt für Stadtplanung und Umwelt
16.07.2022 18:00;810;413;397;Sonnig;24;25;0;Stadt Konstanz, Amt für Stadtplanung und Umwelt
16.07.2022 19:00;705;392;313;Sonnig;21;21;0;Stadt Konstanz, Amt für Stadtplanung und Umwelt
16.07.2022 20:00;637;274;363;Sonnig;18;18;0;Stadt Konstanz, Amt für Stadtplanung und Umwelt
16.07.2022 21:00;522;241;281;Sonnig;16;16;0;Stadt Konstanz, Amt für Stadtplanung und Umwelt
16.07.2022 22:00;440;210;230;Sonnig;15;15;0;Stadt Konstanz, Amt für Stadtplanung und Umwelt
16.07.2022 23:00;357;126;231;Sonnig;14;13;0;Stadt Konstanz, Amt für Stadtplanung und Umwelt
17.07.2022 00:00;298;118;180;Sonnig;13;12;0;Stadt Konstanz, Amt für Stadtplanung und Umwelt
17.07.2022 01:00;158;49;109;Sonnig;12;12;0;Stadt Konstanz, Amt für Stadtplanung und Umwelt
17.07.2022 02:00;115;39;76;Sonnig;12;11;0;Stadt Konstanz, Amt für Stadtplanung und Umwelt
17.07.2022 03:00;84;23;61;Sonnig;11;11;0;Stadt Konstanz, Amt für Stadtplanung und Umwelt
17.07.2022 04:00;40;22;18;Sonnig;11;12;0;Stadt Konstanz, Amt für Stadtplanung und Umwelt
17.07.2022 05:00;38;19;19;Sonnig;12;12;0;Stadt Konstanz, Amt für Stadtplanung und Umwelt
17.07.2022 06:00;46;31;15;Sonnig;12;13;0;Stadt Konstanz, Amt für Stadtplanung und Umwelt
17.07.2022 07:00;75;31;44;Sonnig;15;15;0;Stadt Konstanz, Amt für Stadtplanung und Umwelt
17.07.2022 08:00;203;96;107;Sonnig;17;18;0;Stadt Konstanz, Amt für Stadtplanung und Umwelt
17.07.2022 09:00;361;190;171;Sonnig;20;20;0;Stadt Konstanz, Amt für Stadtplanung und Umwelt
17.07.2022 10:00;418;235;183;Sonnig;22;23;0;Stadt Konstanz, Amt für Stadtplanung und Umwelt
17.07.2022 11:00;523;265;258;Sonnig;25;25;0;Stadt Konstanz, Amt für Stadtplanung und Umwelt
17.07.2022 12:00;500;237;263;Sonnig;27;27;0;Stadt Konstanz, Amt für Stadtplanung und Umwelt
17.07.2022 13:00;588;291;297;Sonnig;28;28;0;Stadt Konstanz, Amt für Stadtplanung und Umwelt
17.07.2022 14:00;606;274;332;Sonnig;28;29;0;Stadt Konstanz, Amt für Stadtplanung und Umwelt
17.07.2022 15:00;626;327;299;Sonnig;29;29;0;Stadt Konstanz, Amt für Stadtplanung und Umwelt
17.07.2022 16:00;587;339;248;Sonnig;28;29;0;Stadt Konstanz, Amt für Stadtplanung und Umwelt
17.07.2022 17:00;671;327;344;Sonnig;28;28;0;Stadt Konstanz, Amt für Stadtplanung und Umwelt
17.07.2022 18:00;665;326;339;Sonnig;27;28;0;Stadt Konstanz, Amt für Stadtplanung und Umwelt
17.07.2022 19:00;600;332;268;Sonnig;23;24;0;Stadt Konstanz, Amt für Stadtplanung und Umwelt
17.07.2022 20:00;510;213;297;Sonnig;20;20;0;Stadt Konstanz, Amt für Stadtplanung und Umwelt
17.07.2022 21:00;395;171;224;Sonnig;16;16;0;Stadt Konstanz, Amt für Stadtplanung und Umwelt
17.07.2022 22:00;265;93;172;Sonnig;16;16;0;Stadt Konstanz, Amt für Stadtplanung und Umwelt
17.07.2022 23:00;103;42;61;Sonnig;15;15;0;Stadt Konstanz, Amt für Stadtplanung und Umwelt
18.07.2022 00:00;77;35;42;Sonnig;14;15;0;Stadt Konstanz, Amt für Stadtplanung und Umwelt
18.07.2022 01:00;16;9;7;Sonnig;14;14;0;Stadt Konstanz, Amt für Stadtplanung und Umwelt
18.07.2022 02:00;11;9;2;Sonnig;13;13;0;Stadt Konstanz, Amt für Stadtplanung und Umwelt
18.07.2022 03:00;4;3;1;Sonnig;12;12;0;Stadt Konstanz, Amt für Stadtplanung und Umwelt
18.07.2022 04:00;12;7;5;Sonnig;13;13;0;Stadt Konstanz, Amt für Stadtplanung und Umwelt
18.07.2022 05:00;46;30;16;Sonnig;13;13;0;Stadt Konstanz, Amt für Stadtplanung und Umwelt
18.07.2022 06:00;210;123;87;Sonnig;13;13;0;Stadt Konstanz, Amt für Stadtplanung und Umwelt
18.07.2022 07:00;1013;622;391;Sonnig;16;16;0;Stadt Konstanz, Amt für Stadtplanung und Umwelt
18.07.2022 08:00;934;509;425;Sonnig;19;19;0;Stadt Konstanz, Amt für Stadtplanung und Umwelt
18.07.2022 09:00;763;438;325;Sonnig;22;25;0;Stadt Konstanz, Amt für Stadtplanung und Umwelt
18.07.2022 10:00;726;398;328;Sonnig;25;26;0;Stadt Konstanz, Amt für Stadtplanung und Umwelt
18.07.2022 11:00;806;363;443;Sonnig;27;28;0;Stadt Konstanz, Amt für Stadtplanung und Umwelt
18.07.2022 12:00;896;379;517;Sonnig;29;30;0;Stadt Konstanz, Amt für Stadtplanung und Umwelt
18.07.2022 13:00;1022;449;573;Sonnig;30;30;0;Stadt Konstanz, Amt für Stadtplanung und Umwelt
18.07.2022 14:00;846;414;432;Sonnig;31;31;0;Stadt Konstanz, Amt für Stadtplanung und Umwelt
18.07.2022 15:00;995;507;488;Sonnig;31;32;0;Stadt Konstanz, Amt für Stadtplanung und Umwelt
18.07.2022 16:00;1056;504;552;Sonnig;30;31;0;Stadt Konstanz, Amt für Stadtplanung und Umwelt
18.07.2022 17:00;1194;584;610;Sonnig;29;30;0;Stadt Konstanz, Amt für Stadtplanung und Umwelt
18.07.2022 18:00;1022;483;539;Sonnig;28;29;0;Stadt Konstanz, Amt für Stadtplanung und Umwelt
18.07.2022 19:00;805;410;395;Sonnig;24;25;0;Stadt Konstanz, Amt für Stadtplanung und Umwelt
18.07.2022 20:00;646;306;340;Sonnig;21;21;0;Stadt Konstanz, Amt für Stadtplanung und Umwelt
18.07.2022 21:00;539;206;333;Sonnig;18;18;0;Stadt Konstanz, Amt für Stadtplanung und Umwelt
18.07.2022 22:00;386;140;246;Sonnig;17;17;0;Stadt Konstanz, Amt für Stadtplanung und Umwelt
18.07.2022 23:00;202;74;128;Sonnig;16;16;0;Stadt Konstanz, Amt für Stadtplanung und Umwelt
19.07.2022 00:00;90;33;57;Sonnig;15;15;0;Stadt Konstanz, Amt für Stadtplanung und Umwelt
19.07.2022 01:00;55;23;32;Sonnig;14;15;0;Stadt Konstanz, Amt für Stadtplanung und Umwelt
19.07.2022 02:00;16;7;9;Sonnig;14;14;0;Stadt Konstanz, Amt für Stadtplanung und Umwelt
19.07.2022 03:00;13;9;4;Sonnig;13;13;0;Stadt Konstanz, Amt für Stadtplanung und Umwelt
19.07.2022 04:00;14;10;4;Sonnig;13;14;0;Stadt Konstanz, Amt für Stadtplanung und Umwelt
19.07.2022 05:00;64;41;23;Sonnig;13;14;0;Stadt Konstanz, Amt für Stadtplanung und Umwelt
19.07.2022 06:00;223;121;102;Sonnig;14;14;0;Stadt Konstanz, Amt für Stadtplanung und Umwelt
19.07.2022 07:00;1118;683;435;Sonnig;17;17;0;Stadt Konstanz, Amt für Stadtplanung und Umwelt
19.07.2022 08:00;947;523;424;Sonnig;20;20;0;Stadt Konstanz, Amt für Stadtplanung und Umwelt
19.07.2022 09:00;870;472;398;Sonnig;23;25;0;Stadt Konstanz, Amt für Stadtplanung und Umwelt
19.07.2022 10:00;696;398;298;Sonnig;26;27;0;Stadt Konstanz, Amt für Stadtplanung und Umwelt
19.07.2022 11:00;729;350;379;Sonnig;28;29;0;Stadt Konstanz, Amt für Stadtplanung und Umwelt
19.07.2022 12:00;957;380;577;Sonnig;31;32;0;Stadt Konstanz, Amt für Stadtplanung und Umwelt
19.07.2022 13:00;1030;453;577;Sonnig;32;33;0;Stadt Konstanz, Amt für Stadtplanung und Umwelt
19.07.2022 14:00;827;382;445;Sonnig;33;34;0;Stadt Konstanz, Amt für Stadtplanung und Umwelt
19.07.2022 15:00;933;447;486;Sonnig;33;34;0;Stadt Konstanz, Amt für Stadtplanung und Umwelt
19.07.2022 16:00;1072;534;538;Sonnig;32;33;0;Stadt Konstanz, Amt für Stadtplanung und Umwelt
19.07.2022 17:00;1176;625;551;Sonnig;31;32;0;Stadt Konstanz, Amt für Stadtplanung und Umwelt
19.07.2022 18:00;1100;589;511;Sonnig;29;31;0;Stadt Konstanz, Amt für Stadtplanung und Umwelt
19.07.2022 19:00;878;415;463;Sonnig;26;27;0;Stadt Konstanz, Amt für Stadtplanung und Umwelt
19.07.2022 20:00;652;314;338;Sonnig;23;23;0;Stadt Konstanz, Amt für Stadtplanung und Umwelt
19.07.2022 21:00;587;225;362;Sonnig;20;20;0;Stadt Konstanz, Amt für Stadtplanung und Umwelt
19.07.2022 22:00;464;177;287;Sonnig;19;19;0;Stadt Konstanz, Amt für Stadtplanung und Umwelt
19.07.2022 23:00;254;93;161;Sonnig;18;18;0;Stadt Konstanz, Amt für Stadtplanung und Umwelt
20.07.2022 00:00;98;37;61;Sonnig;18;18;0;Stadt Konstanz, Amt für Stadtplanung und Umwelt
20.07.2022 01:00;73;35;38;Sonnig;18;18;0;Stadt Konstanz, Amt für Stadtplanung und Umwelt
20.07.2022 02:00;26;9;17;Sonnig;17;17;0;Stadt Konstanz, Amt für Stadtplanung und Umwelt
20.07.2022 03:00;7;4;3;Sonnig;17;17;0;Stadt Konstanz, Amt für Stadtplanung und Umwelt
20.07.2022 04:00;21;10;11;Sonnig;17;17;0;Stadt Konstanz, Amt für Stadtplanung und Umwelt
20.07.2022 05:00;58;42;16;Sonnig;18;18;0;Stadt Konstanz, Amt für Stadtplanung und Umwelt
20.07.2022 06:00;203;114;89;Sonnig;18;18;0;Stadt Konstanz, Amt für Stadtplanung und Umwelt
20.07.2022 07:00;1008;611;397;Sonnig;21;21;0;Stadt Konstanz, Amt für Stadtplanung und Umwelt
20.07.2022 08:00;932;526;406;Sonnig;23;24;0;Stadt Konstanz, Amt für Stadtplanung und Umwelt
20.07.2022 09:00;888;466;422;Sonnig;26;27;0;Stadt Konstanz, Amt für Stadtplanung und Umwelt
20.07.2022 10:00;713;398;315;Sonnig;28;30;0;Stadt Konstanz, Amt für Stadtplanung und Umwelt
20.07.2022 11:00;751;365;386;Sonnig;31;33;0;Stadt Konstanz, Amt für Stadtplanung und Umwelt
20.07.2022 12:00;917;383;534;Sonnig;33;36;0;Stadt Konstanz, Amt für Stadtplanung und Umwelt
20.07.2022 13:00;1106;470;636;Sonnig;34;37;0;Stadt Konstanz, Amt für Stadtplanung und Umwelt
20.07.2022 14:00;801;365;436;Sonnig;35;37;0;Stadt Konstanz, Amt für Stadtplanung und Umwelt
20.07.2022 15:00;863;398;465;Sonnig;35;38;0;Stadt Konstanz, Amt für Stadtplanung und Umwelt
20.07.2022 16:00;1019;502;517;Sonnig;33;36;0;Stadt Konstanz, Amt für Stadtplanung und Umwelt
20.07.2022 17:00;1118;553;565;Sonnig;32;34;0;Stadt Konstanz, Amt für Stadtplanung und Umwelt
20.07.2022 18:00;1075;505;570;Sonnig;30;32;0;Stadt Konstanz, Amt für Stadtplanung und Umwelt
20.07.2022 19:00;618;284;334;Sonnig;26;27;0;Stadt Konstanz, Amt für Stadtplanung und Umwelt
20.07.2022 20:00;390;196;194;Leichter Regenschauer;22;22;0.4;Stadt Konstanz, Amt für Stadtplanung und Umwelt
20.07.2022 21:00;354;132;222;Leichter Regenschauer;18;18;0.5;Stadt Konstanz, Amt für Stadtplanung und Umwelt
20.07.2022 22:00;262;104;158;Leichter Regenschauer;17;17;0.3;Stadt Konstanz, Amt für Stadtplanung und Umwelt
20.07.2022 23:00;171;64;107;Stellenweiser Regenfall;17;17;0.2;Stadt Konstanz, Amt für Stadtplanung und Umwelt
21.07.2022 00:00;65;17;48;Stellenweiser Regenfall;17;17;0.4;Stadt Konstanz, Amt für Stadtplanung und Umwelt
21.07.2022 01:00;42;15;27;Stellenweiser Regenfall;17;17;0.2;Stadt Konstanz, Amt für Stadtplanung und Umwelt
21.07.2022 02:00;25;13;12;Sonnig;16;16;0;Stadt Konstanz, Amt für Stadtplanung und Umwelt
21.07.2022 03:00;11;8;3;Sonnig;16;16;0;Stadt Konstanz, Amt für Stadtplanung und Umwelt
21.07.2022 04:00;15;11;4;Sonnig;17;17;0;Stadt Konstanz, Amt für Stadtplanung und Umwelt
21.07.2022 05:00;49;25;24;Leichter Nebel;17;17;0;Stadt Konstanz, Amt für Stadtplanung und Umwelt
21.07.2022 06:00;175;94;81;Leichter Nebel;17;17;0;Stadt Konstanz, Amt für Stadtplanung und Umwelt
21.07.2022 07:00;923;576;347;Leichter Nebel;18;18;0;Stadt Konstanz, Amt für Stadtplanung und Umwelt
21.07.2022 08:00;872;451;421;Leicht bewoelkt;20;20;0;Stadt Konstanz, Amt für Stadtplanung und Umwelt
21.07.2022 09:00;720;390;330;Leicht bewoelkt;21;21;0;Stadt Konstanz, Amt für Stadtplanung und Umwelt
21.07.2022 10:00;632;340;292;Leicht bewoelkt;22;22;0;Stadt Konstanz, Amt für Stadtplanung und Umwelt
21.07.2022 11:00;683;336;347;Leicht bewoelkt;22;24;0;Stadt Konstanz, Amt für Stadtplanung und Umwelt
21.07.2022 12:00;889;432;457;Leicht bewoelkt;23;25;0;Stadt Konstanz, Amt für Stadtplanung und Umwelt
21.07.2022 13:00;1057;444;613;Leicht bewoelkt;23;25;0;Stadt Konstanz, Amt für Stadtplanung und Umwelt
21.07.2022 14:00;873;423;450;Stellenweiser Regenfall;23;25;0;Stadt Konstanz, Amt für Stadtplanung und Umwelt
21.07.2022 15:00;1041;525;516;Stellenweiser Regenfall;22;25;0;Stadt Konstanz, Amt für Stadtplanung und Umwelt
21.07.2022 16:00;1060;499;561;Stellenweiser Regenfall;22;25;0;Stadt Konstanz, Amt für Stadtplanung und Umwelt
21.07.2022 17:00;1188;583;605;Leichter Regenschauer;22;22;0.1;Stadt Konstanz, Amt für Stadtplanung und Umwelt
21.07.2022 18:00;1061;543;518;Leichter Regenschauer;22;22;0.1;Stadt Konstanz, Amt für Stadtplanung und Umwelt
21.07.2022 19:00;864;453;411;Leichter Regenschauer;20;20;0;Stadt Konstanz, Amt für Stadtplanung und Umwelt
21.07.2022 20:00;688;306;382;Leicht bewoelkt;19;19;0;Stadt Konstanz, Amt für Stadtplanung und Umwelt
21.07.2022 21:00;544;216;328;Leicht bewoelkt;17;17;0;Stadt Konstanz, Amt für Stadtplanung und Umwelt
21.07.2022 22:00;465;201;264;Leicht bewoelkt;17;17;0;Stadt Konstanz, Amt für Stadtplanung und Umwelt
21.07.2022 23:00;311;91;220;Sonnig;17;17;0;Stadt Konstanz, Amt für Stadtplanung und Umwelt
22.07.2022 00:00;139;41;98;Sonnig;17;17;0;Stadt Konstanz, Amt für Stadtplanung und Umwelt
22.07.2022 01:00;72;22;50;Sonnig;16;16;0;Stadt Konstanz, Amt für Stadtplanung und Umwelt
22.07.2022 02:00;27;10;17;Sonnig;16;16;0;Stadt Konstanz, Amt für Stadtplanung und Umwelt
22.07.2022 03:00;16;11;5;Sonnig;16;16;0;Stadt Konstanz, Amt für Stadtplanung und Umwelt
22.07.2022 04:00;22;14;8;Sonnig;16;16;0;Stadt Konstanz, Amt für Stadtplanung und Umwelt
22.07.2022 05:00;66;31;35;Sonnig;16;16;0;Stadt Konstanz, Amt für Stadtplanung und Umwelt
22.07.2022 06:00;190;108;82;Sonnig;17;17;0;Stadt Konstanz, Amt für Stadtplanung und Umwelt
22.07.2022 07:00;849;575;274;Sonnig;19;19;0;Stadt Konstanz, Amt für Stadtplanung und Umwelt
22.07.2022 08:00;871;491;380;Sonnig;22;22;0;Stadt Konstanz, Amt für Stadtplanung und Umwelt
22.07.2022 09:00;851;459;392;Sonnig;24;26;0;Stadt Konstanz, Amt für Stadtplanung und Umwelt
22.07.2022 10:00;747;384;363;Sonnig;26;28;0;Stadt Konstanz, Amt für Stadtplanung und Umwelt
22.07.2022 11:00;855;414;441;Sonnig;29;31;0;Stadt Konstanz, Amt für Stadtplanung und Umwelt
22.07.2022 12:00;988;399;589;Sonnig;31;33;0;Stadt Konstanz, Amt für Stadtplanung und Umwelt
22.07.2022 13:00;1030;436;594;Sonnig;32;34;0;Stadt Konstanz, Amt für Stadtplanung und Umwelt
22.07.2022 14:00;812;409;403;Sonnig;32;35;0;Stadt Konstanz, Amt für Stadtplanung und Umwelt
22.07.2022 15:00;792;394;398;Sonnig;33;36;0;Stadt Konstanz, Amt für Stadtplanung und Umwelt
22.07.2022 16:00;886;448;438;Sonnig;32;35;0;Stadt Konstanz, Amt für Stadtplanung und Umwelt
22.07.2022 17:00;939;481;458;Sonnig;31;34;0;Stadt Konstanz, Amt für Stadtplanung und Umwelt
22.07.2022 18:00;880;477;403;Sonnig;30;33;0;Stadt Konstanz, Amt für Stadtplanung und Umwelt
22.07.2022 19:00;755;412;343;Sonnig;26;28;0;Stadt Konstanz, Amt für Stadtplanung und Umwelt
22.07.2022 20:00;621;283;338;Sonnig;22;23;0;Stadt Konstanz, Amt für Stadtplanung und Umwelt
22.07.2022 21:00;553;259;294;Sonnig;21;21;0.1;Stadt Konstanz, Amt für Stadtplanung und Umwelt
22.07.2022 22:00;429;194;235;Sonnig;19;19;0;Stadt Konstanz, Amt für Stadtplanung und Umwelt
22.07.2022 23:00;341;128;213;Sonnig;18;18;0;Stadt Konstanz, Amt für Stadtplanung und Umwelt
23.07.2022 00:00;339;109;230;Stellenweiser Regenfall;17;17;0.1;Stadt Konstanz, Amt für Stadtplanung und Umwelt
23.07.2022 01:00;143;49;94;Stellenweiser Regenfall;16;16;0;Stadt Konstanz, Amt für Stadtplanung und Umwelt
23.07.2022 02:00;100;44;56;Leicht bewoelkt;16;16;0;Stadt Konstanz, Amt für Stadtplanung und Umwelt
23.07.2022 03:00;45;21;24;Leicht bewoelkt;15;15;0;Stadt Konstanz, Amt für Stadtplanung und Umwelt
23.07.2022 04:00;34;18;16;Leicht bewoelkt;16;16;0;Stadt Konstanz, Amt für Stadtplanung und Umwelt
23.07.2022 05:00;28;15;13;Stellenweise Gewitter und Niederschlaege;16;16;0;Stadt Konstanz, Amt für Stadtplanung und Umwelt
23.07.2022 06:00;37;23;14;Stellenweise Gewitter und Niederschlaege;17;17;0;Stadt Konstanz, Amt für Stadtplanung und Umwelt
23.07.2022 07:00;53;25;28;Stellenweise Gewitter und Niederschlaege;17;17;0;Stadt Konstanz, Amt für Stadtplanung und Umwelt
23.07.2022 08:00;141;86;55;Leichter Regenschauer;18;18;0.2;Stadt Konstanz, Amt für Stadtplanung und Umwelt
23.07.2022 09:00;253;143;110;Leichter Regenschauer;19;19;0.3;Stadt Konstanz, Amt für Stadtplanung und Umwelt
23.07.2022 10:00;360;204;156;Leichter Regenschauer;21;21;0.1;Stadt Konstanz, Amt für Stadtplanung und Umwelt
23.07.2022 11:00;464;245;219;Stellenweiser Regenfall;23;24;0;Stadt Konstanz, Amt für Stadtplanung und Umwelt
23.07.2022 12:00;502;286;216;Stellenweiser Regenfall;25;26;0;Stadt Konstanz, Amt für Stadtplanung und Umwelt
23.07.2022 13:00;535;286;249;Stellenweiser Regenfall;26;27;0;Stadt Konstanz, Amt für Stadtplanung und Umwelt
23.07.2022 14:00;559;260;299;Stellenweiser Regenfall;26;27;0;Stadt Konstanz, Amt für Stadtplanung und Umwelt
23.07.2022 15:00;628;306;322;Stellenweiser Regenfall;27;28;0;Stadt Konstanz, Amt für Stadtplanung und Umwelt
23.07.2022 16:00;708;334;374;Stellenweiser Regenfall;26;27;0;Stadt Konstanz, Amt für Stadtplanung und Umwelt
23.07.2022 17:00;699;335;364;Stellenweiser Regenfall;25;27;0;Stadt Konstanz, Amt für Stadtplanung und Umwelt
23.07.2022 18:00;700;348;352;Stellenweiser Regenfall;25;26;0;Stadt Konstanz, Amt für Stadtplanung und Umwelt
23.07.2022 19:00;561;271;290;Stellenweiser Regenfall;23;24;0;Stadt Konstanz, Amt für Stadtplanung und Umwelt
23.07.2022 20:00;492;254;238;Stellenweiser Regenfall;20;20;0.2;Stadt Konstanz, Amt für Stadtplanung und Umwelt
23.07.2022 21:00;421;210;211;Stellenweiser Regenfall;18;18;0.2;Stadt Konstanz, Amt für Stadtplanung und Umwelt
23.07.2022 22:00;324;128;196;Stellenweiser Regenfall;17;17;0.1;Stadt Konstanz, Amt für Stadtplanung und Umwelt
23.07.2022 23:00;286;98;188;Stellenweiser Regenfall;16;16;0.2;Stadt Konstanz, Amt für Stadtplanung und Umwelt
24.07.2022 00:00;213;67;146;Stellenweiser Regenfall;16;16;0.2;Stadt Konstanz, Amt für Stadtplanung und Umwelt
24.07.2022 01:00;175;53;122;Stellenweiser Regenfall;16;16;0.1;Stadt Konstanz, Amt für Stadtplanung und Umwelt
24.07.2022 02:00;120;44;76;Leicht bewoelkt;16;16;0;Stadt Konstanz, Amt für Stadtplanung und Umwelt
24.07.2022 03:00;88;31;57;Leicht bewoelkt;16;16;0;Stadt Konstanz, Amt für Stadtplanung und Umwelt
24.07.2022 04:00;60;22;38;Leicht bewoelkt;17;17;0;Stadt Konstanz, Amt für Stadtplanung und Umwelt
24.07.2022 05:00;46;22;24;Sonnig;17;17;0;Stadt Konstanz, Amt für Stadtplanung und Umwelt
24.07.2022 06:00;54;34;20;Sonnig;17;17;0;Stadt Konstanz, Amt für Stadtplanung und Umwelt
24.07.2022 07:00;77;34;43;Sonnig;19;19;0;Stadt Konstanz, Amt für Stadtplanung und Umwelt
24.07.2022 08:00;193;93;100;Sonnig;21;21;0;Stadt Konstanz, Amt für Stadtplanung und Umwelt
24.07.2022 09:00;357;169;188;Sonnig;23;25;0;Stadt Konstanz, Amt für Stadtplanung und Umwelt
24.07.2022 10:00;439;207;232;Sonnig;25;27;0;Stadt Konstanz, Amt für Stadtplanung und Umwelt
24.07.2022 11:00;510;247;263;Sonnig;27;28;0;Stadt Konstanz, Amt für Stadtplanung und Umwelt
24.07.2022 12:00;571;294;277;Sonnig;29;30;0;Stadt Konstanz, Amt für Stadtplanung und Umwelt
24.07.2022 13:00;597;299;298;Sonnig;30;31;0;Stadt Konstanz, Amt für Stadtplanung und Umwelt
24.07.2022 14:00;570;282;288;Sonnig;31;32;0;Stadt Konstanz, Amt für Stadtplanung und Umwelt
24.07.2022 15:00;512;264;248;Sonnig;32;33;0;Stadt Konstanz, Amt für Stadtplanung und Umwelt
24.07.2022 16:00;606;309;297;Sonnig;30;32;0;Stadt Konstanz, Amt für Stadtplanung und Umwelt
24.07.2022 17:00;600;285;315;Sonnig;29;31;0;Stadt Konstanz, Amt für Stadtplanung und Umwelt
24.07.2022 18:00;695;338;357;Sonnig;28;29;0;Stadt Konstanz, Amt für Stadtplanung und Umwelt
24.07.2022 19:00;599;313;286;Sonnig;25;26;0;Stadt Konstanz, Amt für Stadtplanung und Umwelt
24.07.2022 20:00;493;235;258;Sonnig;22;23;0;Stadt Konstanz, Amt für Stadtplanung und Umwelt
24.07.2022 21:00;428;186;242;Sonnig;19;19;0;Stadt Konstanz, Amt für Stadtplanung und Umwelt
24.07.2022 22:00;261;87;174;Sonnig;19;19;0;Stadt Konstanz, Amt für Stadtplanung und Umwelt
24.07.2022 23:00;149;57;92;Sonnig;18;18;0;Stadt Konstanz, Amt für Stadtplanung und Umwelt
25.07.2022 00:00;52;23;29;Sonnig;17;17;0;Stadt Konstanz, Amt für Stadtplanung und Umwelt
25.07.2022 01:00;37;20;17;Sonnig;17;17;0;Stadt Konstanz, Amt für Stadtplanung und Umwelt
25.07.2022 02:00;13;6;7;Sonnig;17;17;0;Stadt Konstanz, Amt für Stadtplanung und Umwelt
25.07.2022 03:00;9;7;2;Sonnig;16;16;0;Stadt Konstanz, Amt für Stadtplanung und Umwelt
25.07.2022 04:00;11;7;4;Sonnig;17;17;0;Stadt Konstanz, Amt für Stadtplanung und Umwelt
25.07.2022 05:00;59;38;21;Sonnig;17;17;0;Stadt Konstanz, Amt für Stadtplanung und Umwelt
25.07.2022 06:00;181;108;73;Sonnig;18;18;0;Stadt Konstanz, Amt für Stadtplanung und Umwelt
25.07.2022 07:00;893;504;389;Sonnig;20;20;0;Stadt Konstanz, Amt für Stadtplanung und Umwelt
25.07.2022 08:00;917;499;418;Sonnig;23;24;0;Stadt Konstanz, Amt für Stadtplanung und Umwelt
25.07.2022 09:00;710;403;307;Sonnig;26;27;0;Stadt Konstanz, Amt für Stadtplanung und Umwelt
25.07.2022 10:00;652;329;323;Sonnig;29;30;0;Stadt Konstanz, Amt für Stadtplanung und Umwelt
25.07.2022 11:00;711;323;388;Sonnig;31;33;0;Stadt Konstanz, Amt für Stadtplanung und Umwelt
25.07.2022 12:00;813;336;477;Sonnig;34;36;0;Stadt Konstanz, Amt für Stadtplanung und Umwelt
25.07.2022 13:00;946;397;549;Sonnig;35;36;0;Stadt Konstanz, Amt für Stadtplanung und Umwelt
25.07.2022 14:00;812;429;383;Sonnig;35;37;0;Stadt Konstanz, Amt für Stadtplanung und Umwelt
25.07.2022 15:00;843;431;412;Sonnig;36;37;0;Stadt Konstanz, Amt für Stadtplanung und Umwelt
25.07.2022 16:00;973;475;498;Sonnig;31;33;0;Stadt Konstanz, Amt für Stadtplanung und Umwelt
25.07.2022 17:00;1115;532;583;Bewoelkt;27;29;0;Stadt Konstanz, Amt für Stadtplanung und Umwelt
25.07.2022 18:00;991;484;507;Bewoelkt;22;25;0;Stadt Konstanz, Amt für Stadtplanung und Umwelt
25.07.2022 19:00;837;424;413;Bewoelkt;20;20;0;Stadt Konstanz, Amt für Stadtplanung und Umwelt
25.07.2022 20:00;587;253;334;Bewoelkt;18;18;0;Stadt Konstanz, Amt für Stadtplanung und Umwelt
25.07.2022 21:00;474;203;271;Bewoelkt;16;16;0;Stadt Konstanz, Amt für Stadtplanung und Umwelt
25.07.2022 22:00;329;115;214;Bewoelkt;16;16;0;Stadt Konstanz, Amt für Stadtplanung und Umwelt
25.07.2022 23:00;158;54;104;Leichter Regenschauer;16;16;0.1;Stadt Konstanz, Amt für Stadtplanung und Umwelt
26.07.2022 00:00;81;40;41;Leichter Regenschauer;16;16;0.1;Stadt Konstanz, Amt für Stadtplanung und Umwelt
26.07.2022 01:00;45;18;27;Leichter Regenschauer;16;16;0;Stadt Konstanz, Amt für Stadtplanung und Umwelt
26.07.2022 02:00;28;20;8;Leichter Regenschauer;16;16;0.1;Stadt Konstanz, Amt für Stadtplanung und Umwelt
26.07.2022 03:00;23;10;13;Leichter Regenschauer;16;16;0.1;Stadt Konstanz, Amt für Stadtplanung und Umwelt
26.07.2022 04:00;13;7;6;Leichter Regenschauer;16;16;0.1;Stadt Konstanz, Amt für Stadtplanung und Umwelt
26.07.2022 05:00;49;31;18;Stellenweiser Regenfall;17;17;0.1;Stadt Konstanz, Amt für Stadtplanung und Umwelt
26.07.2022 06:00;188;97;91;Stellenweiser Regenfall;17;17;0.1;Stadt Konstanz, Amt für Stadtplanung und Umwelt
26.07.2022 07:00;610;336;274;Stellenweiser Regenfall;18;18;0.1;Stadt Konstanz, Amt für Stadtplanung und Umwelt
26.07.2022 08:00;927;493;434;Stellenweiser Regenfall;20;20;0;Stadt Konstanz, Amt für Stadtplanung und Umwelt
26.07.2022 09:00;735;490;245;Stellenweiser Regenfall;21;21;0;Stadt Konstanz, Amt für Stadtplanung und Umwelt
26.07.2022 10:00;606;331;275;Stellenweiser Regenfall;23;25;0;Stadt Konstanz, Amt für Stadtplanung und Umwelt
26.07.2022 11:00;724;377;347;Stellenweiser Regenfall;25;26;0;Stadt Konstanz, Amt für Stadtplanung und Umwelt
26.07.2022 12:00;753;260;493;Stellenweiser Regenfall;26;26;0;Stadt Konstanz, Amt für Stadtplanung und Umwelt
26.07.2022 13:00;932;416;516;Stellenweiser Regenfall;27;27;0;Stadt Konstanz, Amt für Stadtplanung und Umwelt
26.07.2022 14:00;859;397;462;Leicht bewoelkt;27;27;0;Stadt Konstanz, Amt für Stadtplanung und Umwelt
26.07.2022 15:00;906;428;478;Leicht bewoelkt;27;27;0;Stadt Konstanz, Amt für Stadtplanung und Umwelt
26.07.2022 16:00;1040;509;531;Leicht bewoelkt;26;27;0;Stadt Konstanz, Amt für Stadtplanung und Umwelt
26.07.2022 17:00;1110;542;568;Bewoelkt;25;26;0;Stadt Konstanz, Amt für Stadtplanung und Umwelt
26.07.2022 18:00;1046;475;571;Bewoelkt;23;25;0;Stadt Konstanz, Amt für Stadtplanung und Umwelt
26.07.2022 19:00;763;338;425;Bewoelkt;22;22;0;Stadt Konstanz, Amt für Stadtplanung und Umwelt
26.07.2022 20:00;571;262;309;Leicht bewoelkt;20;20;0;Stadt Konstanz, Amt für Stadtplanung und Umwelt
26.07.2022 21:00;473;209;264;Leicht bewoelkt;19;19;0;Stadt Konstanz, Amt für Stadtplanung und Umwelt
26.07.2022 22:00;363;145;218;Leicht bewoelkt;17;17;0;Stadt Konstanz, Amt für Stadtplanung und Umwelt
26.07.2022 23:00;182;55;127;Sonnig;16;16;0;Stadt Konstanz, Amt für Stadtplanung und Umwelt
27.07.2022 00:00;161;55;106;Sonnig;15;15;0;Stadt Konstanz, Amt für Stadtplanung und Umwelt
27.07.2022 01:00;55;20;35;Sonnig;15;15;0;Stadt Konstanz, Amt für Stadtplanung und Umwelt
27.07.2022 02:00;28;13;15;Sonnig;14;14;0;Stadt Konstanz, Amt für Stadtplanung und Umwelt
27.07.2022 03:00;10;5;5;Sonnig;13;14;0;Stadt Konstanz, Amt für Stadtplanung und Umwelt
27.07.2022 04:00;14;5;9;Sonnig;13;14;0;Stadt Konstanz, Amt für Stadtplanung und Umwelt
27.07.2022 05:00;55;31;24;Sonnig;14;14;0;Stadt Konstanz, Amt für Stadtplanung und Umwelt
27.07.2022 06:00;204;113;91;Sonnig;14;14;0;Stadt Konstanz, Amt für Stadtplanung und Umwelt
27.07.2022 07:00;679;327;352;Sonnig;16;16;0;Stadt Konstanz, Amt für Stadtplanung und Umwelt
27.07.2022 08:00;938;540;398;Sonnig;18;18;0;Stadt Konstanz, Amt für Stadtplanung und Umwelt
27.07.2022 09:00;1110;741;369;Sonnig;20;20;0;Stadt Konstanz, Amt für Stadtplanung und Umwelt
27.07.2022 10:00;933;382;551;Sonnig;21;21;0;Stadt Konstanz, Amt für Stadtplanung und Umwelt
27.07.2022 11:00;849;368;481;Sonnig;23;23;0;Stadt Konstanz, Amt für Stadtplanung und Umwelt
27.07.2022 12:00;992;490;502;Sonnig;24;25;0;Stadt Konstanz, Amt für Stadtplanung und Umwelt
27.07.2022 13:00;884;415;469;Sonnig;25;25;0;Stadt Konstanz, Amt für Stadtplanung und Umwelt
27.07.2022 14:00;941;440;501;Sonnig;25;26;0;Stadt Konstanz, Amt für Stadtplanung und Umwelt
27.07.2022 15:00;988;510;478;Sonnig;26;26;0;Stadt Konstanz, Amt für Stadtplanung und Umwelt
27.07.2022 16:00;1131;583;548;Sonnig;25;26;0;Stadt Konstanz, Amt für Stadtplanung und Umwelt
27.07.2022 17:00;1145;639;506;Leicht bewoelkt;24;25;0;Stadt Konstanz, Amt für Stadtplanung und Umwelt
27.07.2022 18:00;1236;738;498;Leicht bewoelkt;23;25;0;Stadt Konstanz, Amt für Stadtplanung und Umwelt
27.07.2022 19:00;950;531;419;Leicht bewoelkt;22;22;0;Stadt Konstanz, Amt für Stadtplanung und Umwelt
27.07.2022 20:00;737;373;364;Leicht bewoelkt;20;20;0;Stadt Konstanz, Amt für Stadtplanung und Umwelt
27.07.2022 21:00;607;298;309;Leicht bewoelkt;18;18;0;Stadt Konstanz, Amt für Stadtplanung und Umwelt
27.07.2022 22:00;491;168;323;Leicht bewoelkt;17;17;0;Stadt Konstanz, Amt für Stadtplanung und Umwelt
27.07.2022 23:00;426;87;339;Sonnig;16;16;0;Stadt Konstanz, Amt für Stadtplanung und Umwelt
28.07.2022 00:00;367;40;327;Sonnig;15;15;0;Stadt Konstanz, Amt für Stadtplanung und Umwelt
28.07.2022 01:00;250;32;218;Sonnig;14;14;0;Stadt Konstanz, Amt für Stadtplanung und Umwelt
28.07.2022 02:00;78;16;62;Sonnig;13;13;0;Stadt Konstanz, Amt für Stadtplanung und Umwelt
28.07.2022 03:00;36;18;18;Sonnig;13;13;0;Stadt Konstanz, Amt für Stadtplanung und Umwelt
28.07.2022 04:00;20;11;9;Sonnig;13;13;0;Stadt Konstanz, Amt für Stadtplanung und Umwelt
28.07.2022 05:00;60;42;18;Sonnig;13;13;0;Stadt Konstanz, Amt für Stadtplanung und Umwelt
28.07.2022 06:00;188;99;89;Sonnig;13;13;0;Stadt Konstanz, Amt für Stadtplanung und Umwelt
28.07.2022 07:00;505;269;236;Sonnig;15;16;0;Stadt Konstanz, Amt für Stadtplanung und Umwelt
28.07.2022 08:00;737;413;324;Sonnig;18;18;0;Stadt Konstanz, Amt für Stadtplanung und Umwelt
28.07.2022 09:00;666;373;293;Sonnig;20;20;0;Stadt Konstanz, Amt für Stadtplanung und Umwelt
28.07.2022 10:00;691;360;331;Sonnig;23;23;0;Stadt Konstanz, Amt für Stadtplanung und Umwelt
28.07.2022 11:00;773;366;407;Sonnig;25;26;0;Stadt Konstanz, Amt für Stadtplanung und Umwelt
28.07.2022 12:00;867;416;451;Sonnig;28;29;0;Stadt Konstanz, Amt für Stadtplanung und Umwelt
28.07.2022 13:00;838;420;418;Sonnig;29;30;0;Stadt Konstanz, Amt für Stadtplanung und Umwelt
28.07.2022 14:00;761;406;355;Sonnig;29;30;0;Stadt Konstanz, Amt für Stadtplanung und Umwelt
28.07.2022 15:00;844;428;416;Sonnig;30;31;0;Stadt Konstanz, Amt für Stadtplanung und Umwelt
28.07.2022 16:00;1011;507;504;Sonnig;29;30;0;Stadt Konstanz, Amt für Stadtplanung und Umwelt
28.07.2022 17:00;1055;518;537;Stellenweise Gewitter und Niederschlaege;27;28;0;Stadt Konstanz, Amt für Stadtplanung und Umwelt
28.07.2022 18:00;1021;521;500;Stellenweise Gewitter und Niederschlaege;26;27;0;Stadt Konstanz, Amt für Stadtplanung und Umwelt
28.07.2022 19:00;856;446;410;Stellenweise Gewitter und Niederschlaege;23;24;0;Stadt Konstanz, Amt für Stadtplanung und Umwelt
28.07.2022 20:00;431;200;231;Sonnig;21;21;0;Stadt Konstanz, Amt für Stadtplanung und Umwelt
28.07.2022 21:00;414;223;191;Sonnig;18;18;0;Stadt Konstanz, Amt für Stadtplanung und Umwelt
28.07.2022 22:00;332;119;213;Sonnig;18;18;0;Stadt Konstanz, Amt für Stadtplanung und Umwelt
28.07.2022 23:00;203;49;154;Sonnig;17;17;0;Stadt Konstanz, Amt für Stadtplanung und Umwelt
29.07.2022 00:00;194;29;165;Sonnig;16;16;0;Stadt Konstanz, Amt für Stadtplanung und Umwelt
29.07.2022 01:00;123;20;103;Sonnig;16;16;0;Stadt Konstanz, Amt für Stadtplanung und Umwelt
29.07.2022 02:00;37;14;23;Leicht bewoelkt;16;16;0;Stadt Konstanz, Amt für Stadtplanung und Umwelt
29.07.2022 03:00;12;9;3;Leicht bewoelkt;16;16;0;Stadt Konstanz, Amt für Stadtplanung und Umwelt
29.07.2022 04:00;20;13;7;Leicht bewoelkt;16;16;0;Stadt Konstanz, Amt für Stadtplanung und Umwelt
29.07.2022 05:00;51;34;17;Leicht bewoelkt;17;17;0;Stadt Konstanz, Amt für Stadtplanung und Umwelt
29.07.2022 06:00;162;85;77;Leicht bewoelkt;17;17;0;Stadt Konstanz, Amt für Stadtplanung und Umwelt
29.07.2022 07:00;335;177;158;Leicht bewoelkt;18;18;0;Stadt Konstanz, Amt für Stadtplanung und Umwelt
29.07.2022 08:00;581;322;259;Stellenweiser Regenfall;19;19;0;Stadt Konstanz, Amt für Stadtplanung und Umwelt
29.07.2022 09:00;562;323;239;Stellenweiser Regenfall;20;20;0;Stadt Konstanz, Amt für Stadtplanung und Umwelt
29.07.2022 10:00;599;344;255;Stellenweiser Regenfall;21;21;0;Stadt Konstanz, Amt für Stadtplanung und Umwelt
29.07.2022 11:00;626;329;297;Stellenweiser Regenfall;23;24;0.1;Stadt Konstanz, Amt für Stadtplanung und Umwelt
29.07.2022 12:00;697;338;359;Stellenweiser Regenfall;24;26;0.1;Stadt Konstanz, Amt für Stadtplanung und Umwelt
29.07.2022 13:00;708;359;349;Stellenweiser Regenfall;25;26;0;Stadt Konstanz, Amt für Stadtplanung und Umwelt
29.07.2022 14:00;738;378;360;Sonnig;26;27;0;Stadt Konstanz, Amt für Stadtplanung und Umwelt
29.07.2022 15:00;831;421;410;Sonnig;28;28;0;Stadt Konstanz, Amt für Stadtplanung und Umwelt
29.07.2022 16:00;717;364;353;Sonnig;25;25;0;Stadt Konstanz, Amt für Stadtplanung und Umwelt
29.07.2022 17:00;443;223;220;Stellenweiser Regenfall;22;22;0.2;Stadt Konstanz, Amt für Stadtplanung und Umwelt
29.07.2022 18:00;503;239;264;Stellenweiser Regenfall;19;19;0.3;Stadt Konstanz, Amt für Stadtplanung und Umwelt
29.07.2022 19:00;542;297;245;Stellenweiser Regenfall;18;18;0.2;Stadt Konstanz, Amt für Stadtplanung und Umwelt
29.07.2022 20:00;379;236;143;Leicht bewoelkt;17;17;0;Stadt Konstanz, Amt für Stadtplanung und Umwelt
29.07.2022 21:00;358;201;157;Leicht bewoelkt;16;16;0;Stadt Konstanz, Amt für Stadtplanung und Umwelt
29.07.2022 22:00;231;99;132;Leicht bewoelkt;16;15;0;Stadt Konstanz, Amt für Stadtplanung und Umwelt
29.07.2022 23:00;219;69;150;Leichter Regenfall;15;15;0.4;Stadt Konstanz, Amt für Stadtplanung und Umwelt
30.07.2022 00:00;203;45;158;Leichter Regenfall;15;14;0.9;Stadt Konstanz, Amt für Stadtplanung und Umwelt
30.07.2022 01:00;231;27;204;Leichter Regenfall;15;14;0.4;Stadt Konstanz, Amt für Stadtplanung und Umwelt
30.07.2022 02:00;78;23;55;Leichter Regenfall;15;14;0.8;Stadt Konstanz, Amt für Stadtplanung und Umwelt
30.07.2022 03:00;77;22;55;Leichter Regenfall;15;14;1;Stadt Konstanz, Amt für Stadtplanung und Umwelt
30.07.2022 04:00;30;18;12;Leichter Regenfall;15;14;0.5;Stadt Konstanz, Amt für Stadtplanung und Umwelt
30.07.2022 05:00;35;18;17;Leichter Regenfall;15;15;0.7;Stadt Konstanz, Amt für Stadtplanung und Umwelt
30.07.2022 06:00;62;36;26;Leichter Regenfall;15;15;0.9;Stadt Konstanz, Amt für Stadtplanung und Umwelt
30.07.2022 07:00;113;59;54;Leichter Regenfall;16;16;0.5;Stadt Konstanz, Amt für Stadtplanung und Umwelt
30.07.2022 08:00;231;106;125;Stellenweiser Regenfall;16;16;0;Stadt Konstanz, Amt für Stadtplanung und Umwelt
30.07.2022 09:00;444;255;189;Stellenweiser Regenfall;17;17;0;Stadt Konstanz, Amt für Stadtplanung und Umwelt
30.07.2022 10:00;684;354;330;Stellenweiser Regenfall;19;19;0;Stadt Konstanz, Amt für Stadtplanung und Umwelt
30.07.2022 11:00;741;402;339;Stellenweiser Regenfall;21;21;0;Stadt Konstanz, Amt für Stadtplanung und Umwelt
30.07.2022 12:00;828;445;383;Stellenweiser Regenfall;22;25;0;Stadt Konstanz, Amt für Stadtplanung und Umwelt
30.07.2022 13:00;762;381;381;Stellenweiser Regenfall;23;25;0;Stadt Konstanz, Amt für Stadtplanung und Umwelt
30.07.2022 14:00;831;409;422;Leicht bewoelkt;24;25;0;Stadt Konstanz, Amt für Stadtplanung und Umwelt
30.07.2022 15:00;740;374;366;Leicht bewoelkt;25;26;0;Stadt Konstanz, Amt für Stadtplanung und Umwelt
30.07.2022 16:00;796;378;418;Leicht bewoelkt;24;25;0;Stadt Konstanz, Amt für Stadtplanung und Umwelt
30.07.2022 17:00;829;425;404;Leicht bewoelkt;24;25;0;Stadt Konstanz, Amt für Stadtplanung und Umwelt
30.07.2022 18:00;694;374;320;Leicht bewoelkt;23;25;0;Stadt Konstanz, Amt für Stadtplanung und Umwelt
30.07.2022 19:00;626;344;282;Leicht bewoelkt;21;21;0;Stadt Konstanz, Amt für Stadtplanung und Umwelt
30.07.2022 20:00;574;352;222;Sonnig;19;19;0;Stadt Konstanz, Amt für Stadtplanung und Umwelt
30.07.2022 21:00;378;214;164;Sonnig;18;18;0;Stadt Konstanz, Amt für Stadtplanung und Umwelt
30.07.2022 22:00;256;116;140;Sonnig;16;16;0;Stadt Konstanz, Amt für Stadtplanung und Umwelt
30.07.2022 23:00;306;98;208;Leicht bewoelkt;15;15;0;Stadt Konstanz, Amt für Stadtplanung und Umwelt
31.07.2022 00:00;272;44;228;Leicht bewoelkt;14;14;0;Stadt Konstanz, Amt für Stadtplanung und Umwelt
31.07.2022 01:00;204;26;178;Leicht bewoelkt;13;14;0;Stadt Konstanz, Amt für Stadtplanung und Umwelt
31.07.2022 02:00;121;27;94;Sonnig;13;14;0;Stadt Konstanz, Amt für Stadtplanung und Umwelt
31.07.2022 03:00;67;24;43;Sonnig;13;14;0;Stadt Konstanz, Amt für Stadtplanung und Umwelt
31.07.2022 04:00;60;29;31;Sonnig;13;14;0;Stadt Konstanz, Amt für Stadtplanung und Umwelt
31.07.2022 05:00;39;14;25;Leicht bewoelkt;14;14;0;Stadt Konstanz, Amt für Stadtplanung und Umwelt
31.07.2022 06:00;33;19;14;Leicht bewoelkt;14;15;0;Stadt Konstanz, Amt für Stadtplanung und Umwelt
31.07.2022 07:00;84;44;40;Leicht bewoelkt;15;16;0;Stadt Konstanz, Amt für Stadtplanung und Umwelt
31.07.2022 08:00;108;50;58;Leicht bewoelkt;17;17;0;Stadt Konstanz, Amt für Stadtplanung und Umwelt
31.07.2022 09:00;352;192;160;Leicht bewoelkt;18;18;0;Stadt Konstanz, Amt für Stadtplanung und Umwelt
31.07.2022 10:00;441;207;234;Leicht bewoelkt;20;20;0;Stadt Konstanz, Amt für Stadtplanung und Umwelt
31.07.2022 11:00;495;237;258;Sonnig;23;23;0;Stadt Konstanz, Amt für Stadtplanung und Umwelt
31.07.2022 12:00;548;251;297;Sonnig;25;26;0;Stadt Konstanz, Amt für Stadtplanung und Umwelt
31.07.2022 13:00;533;246;287;Sonnig;24;25;0;Stadt Konstanz, Amt für Stadtplanung und Umwelt
31.07.2022 14:00;558;262;296;Leicht bewoelkt;24;25;0;Stadt Konstanz, Amt für Stadtplanung und Umwelt
31.07.2022 15:00;552;289;263;Leicht bewoelkt;23;25;0;Stadt Konstanz, Amt für Stadtplanung und Umwelt
31.07.2022 16:00;597;288;309;Leicht bewoelkt;24;25;0;Stadt Konstanz, Amt für Stadtplanung und Umwelt
31.07.2022 17:00;740;373;367;Leicht bewoelkt;24;26;0;Stadt Konstanz, Amt für Stadtplanung und Umwelt
31.07.2022 18:00;531;285;246;Leicht bewoelkt;25;26;0;Stadt Konstanz, Amt für Stadtplanung und Umwelt
31.07.2022 19:00;420;182;238;Leicht bewoelkt;23;23;0;Stadt Konstanz, Amt für Stadtplanung und Umwelt
31.07.2022 20:00;419;195;224;Leicht bewoelkt;21;21;0;Stadt Konstanz, Amt für Stadtplanung und Umwelt
31.07.2022 21:00;322;151;171;Leicht bewoelkt;19;19;0;Stadt Konstanz, Amt für Stadtplanung und Umwelt
31.07.2022 22:00;193;87;106;Leicht bewoelkt;19;19;0;Stadt Konstanz, Amt für Stadtplanung und Umwelt
31.07.2022 23:00;132;55;77;Leicht bewoelkt;19;19;0;Stadt Konstanz, Amt für Stadtplanung und Umwelt
01.08.2022 00:00;60;27;33;Leicht bewoelkt;19;19;0;Stadt Konstanz, Amt für Stadtplanung und Umwelt
01.08.2022 01:00;21;7;14;Leicht bewoelkt;18;18;0;Stadt Konstanz, Amt für Stadtplanung und Umwelt
01.08.2022 02:00;20;5;15;Leicht bewoelkt;18;18;0;Stadt Konstanz, Amt für Stadtplanung und Umwelt
01.08.2022 03:00;18;9;9;Leicht bewoelkt;18;18;0;Stadt Konstanz, Amt für Stadtplanung und Umwelt
01.08.2022 04:00;17;10;7;Leicht bewoelkt;17;17;0;Stadt Konstanz, Amt für Stadtplanung und Umwelt
01.08.2022 05:00;39;19;20;Leicht bewoelkt;17;17;0;Stadt Konstanz, Amt für Stadtplanung und Umwelt
01.08.2022 06:00;160;92;68;Leicht bewoelkt;17;17;0;Stadt Konstanz, Amt für Stadtplanung und Umwelt
01.08.2022 07:00;391;197;194;Leicht bewoelkt;19;19;0;Stadt Konstanz, Amt für Stadtplanung und Umwelt
01.08.2022 08:00;675;340;335;Leicht bewoelkt;21;21;0;Stadt Konstanz, Amt für Stadtplanung und Umwelt
01.08.2022 09:00;661;377;284;Leicht bewoelkt;23;25;0;Stadt Konstanz, Amt für Stadtplanung und Umwelt
01.08.2022 10:00;717;371;346;Leicht bewoelkt;25;26;0;Stadt Konstanz, Amt für Stadtplanung und Umwelt
01.08.2022 11:00;762;377;385;Sonnig;26;27;0;Stadt Konstanz, Amt für Stadtplanung und Umwelt
01.08.2022 12:00;774;354;420;Sonnig;28;28;0;Stadt Konstanz, Amt für Stadtplanung und Umwelt
01.08.2022 13:00;818;368;450;Sonnig;27;27;0;Stadt Konstanz, Amt für Stadtplanung und Umwelt
01.08.2022 14:00;795;399;396;Leicht bewoelkt;25;26;0;Stadt Konstanz, Amt für Stadtplanung und Umwelt
01.08.2022 15:00;779;376;403;Leicht bewoelkt;24;25;0;Stadt Konstanz, Amt für Stadtplanung und Umwelt
01.08.2022 16:00;997;511;486;Leicht bewoelkt;24;26;0;Stadt Konstanz, Amt für Stadtplanung und Umwelt
01.08.2022 17:00;994;485;509;Leicht bewoelkt;25;26;0;Stadt Konstanz, Amt für Stadtplanung und Umwelt
01.08.2022 18:00;879;447;432;Leicht bewoelkt;25;26;0;Stadt Konstanz, Amt für Stadtplanung und Umwelt
01.08.2022 19:00;653;330;323;Leicht bewoelkt;22;23;0;Stadt Konstanz, Amt für Stadtplanung und Umwelt
01.08.2022 20:00;505;220;285;Stellenweiser Regenfall;20;20;0.1;Stadt Konstanz, Amt für Stadtplanung und Umwelt
01.08.2022 21:00;419;182;237;Stellenweiser Regenfall;17;17;0.1;Stadt Konstanz, Amt für Stadtplanung und Umwelt
01.08.2022 22:00;251;110;141;Stellenweiser Regenfall;17;17;0;Stadt Konstanz, Amt für Stadtplanung und Umwelt
01.08.2022 23:00;128;42;86;Leicht bewoelkt;17;17;0;Stadt Konstanz, Amt für Stadtplanung und Umwelt
02.08.2022 00:00;69;31;38;Leicht bewoelkt;17;17;0;Stadt Konstanz, Amt für Stadtplanung und Umwelt
02.08.2022 01:00;37;11;26;Leicht bewoelkt;16;16;0;Stadt Konstanz, Amt für Stadtplanung und Umwelt
02.08.2022 02:00;15;4;11;Sonnig;16;16;0;Stadt Konstanz, Amt für Stadtplanung und Umwelt
02.08.2022 03:00;19;13;6;Sonnig;15;15;0;Stadt Konstanz, Amt für Stadtplanung und Umwelt
02.08.2022 04:00;21;16;5;Sonnig;15;15;0;Stadt Konstanz, Amt für Stadtplanung und Umwelt
02.08.2022 05:00;43;24;19;Sonnig;15;15;0;Stadt Konstanz, Amt für Stadtplanung und Umwelt
02.08.2022 06:00;180;102;78;Sonnig;16;16;0;Stadt Konstanz, Amt für Stadtplanung und Umwelt
02.08.2022 07:00;459;242;217;Sonnig;18;18;0;Stadt Konstanz, Amt für Stadtplanung und Umwelt
02.08.2022 08:00;790;451;339;Sonnig;21;21;0;Stadt Konstanz, Amt für Stadtplanung und Umwelt
02.08.2022 09:00;734;439;295;Sonnig;24;25;0;Stadt Konstanz, Amt für Stadtplanung und Umwelt
02.08.2022 10:00;698;377;321;Sonnig;26;27;0;Stadt Konstanz, Amt für Stadtplanung und Umwelt
02.08.2022 11:00;705;299;406;Sonnig;28;29;0;Stadt Konstanz, Amt für Stadtplanung und Umwelt
02.08.2022 12:00;787;320;467;Sonnig;30;31;0;Stadt Konstanz, Amt für Stadtplanung und Umwelt
02.08.2022 13:00;740;390;350;Sonnig;30;31;0;Stadt Konstanz, Amt für Stadtplanung und Umwelt
02.08.2022 14:00;766;402;364;Sonnig;30;30;0;Stadt Konstanz, Amt für Stadtplanung und Umwelt
02.08.2022 15:00;810;386;424;Sonnig;30;30;0;Stadt Konstanz, Amt für Stadtplanung und Umwelt
02.08.2022 16:00;936;443;493;Sonnig;29;30;0;Stadt Konstanz, Amt für Stadtplanung und Umwelt
02.08.2022 17:00;989;469;520;Sonnig;29;30;0;Stadt Konstanz, Amt für Stadtplanung und Umwelt
02.08.2022 18:00;947;431;516;Sonnig;29;30;0;Stadt Konstanz, Amt für Stadtplanung und Umwelt
02.08.2022 19:00;762;359;403;Sonnig;26;27;0;Stadt Konstanz, Amt für Stadtplanung und Umwelt
02.08.2022 20:00;557;257;300;Sonnig;23;23;0;Stadt Konstanz, Amt für Stadtplanung und Umwelt
02.08.2022 21:00;431;184;247;Sonnig;20;20;0;Stadt Konstanz, Amt für Stadtplanung und Umwelt
02.08.2022 22:00;347;148;199;Sonnig;19;19;0;Stadt Konstanz, Amt für Stadtplanung und Umwelt
02.08.2022 23:00;177;63;114;Sonnig;18;18;0;Stadt Konstanz, Amt für Stadtplanung und Umwelt
03.08.2022 00:00;84;31;53;Sonnig;17;17;0;Stadt Konstanz, Amt für Stadtplanung und Umwelt
03.08.2022 01:00;47;23;24;Sonnig;17;17;0;Stadt Konstanz, Amt für Stadtplanung und Umwelt
03.08.2022 02:00;23;14;9;Sonnig;16;16;0;Stadt Konstanz, Amt für Stadtplanung und Umwelt
03.08.2022 03:00;13;8;5;Sonnig;16;16;0;Stadt Konstanz, Amt für Stadtplanung und Umwelt
03.08.2022 04:00;18;7;11;Sonnig;16;16;0;Stadt Konstanz, Amt für Stadtplanung und Umwelt
03.08.2022 05:00;53;35;18;Sonnig;16;16;0;Stadt Konstanz, Amt für Stadtplanung und Umwelt
03.08.2022 06:00;184;99;85;Sonnig;16;16;0;Stadt Konstanz, Amt für Stadtplanung und Umwelt
03.08.2022 07:00;495;254;241;Sonnig;19;19;0;Stadt Konstanz, Amt für Stadtplanung und Umwelt
03.08.2022 08:00;765;456;309;Sonnig;21;21;0;Stadt Konstanz, Amt für Stadtplanung und Umwelt
03.08.2022 09:00;717;406;311;Sonnig;24;26;0;Stadt Konstanz, Amt für Stadtplanung und Umwelt
03.08.2022 10:00;626;315;311;Sonnig;27;28;0;Stadt Konstanz, Amt für Stadtplanung und Umwelt
03.08.2022 11:00;675;325;350;Sonnig;29;31;0;Stadt Konstanz, Amt für Stadtplanung und Umwelt
03.08.2022 12:00;745;332;413;Sonnig;32;33;0;Stadt Konstanz, Amt für Stadtplanung und Umwelt
03.08.2022 13:00;692;340;352;Sonnig;32;34;0;Stadt Konstanz, Amt für Stadtplanung und Umwelt
03.08.2022 14:00;736;345;391;Sonnig;33;34;0;Stadt Konstanz, Amt für Stadtplanung und Umwelt
03.08.2022 15:00;759;396;363;Sonnig;34;35;0;Stadt Konstanz, Amt für Stadtplanung und Umwelt
03.08.2022 16:00;912;455;457;Sonnig;32;34;0;Stadt Konstanz, Amt für Stadtplanung und Umwelt
03.08.2022 17:00;1041;499;542;Sonnig;31;33;0;Stadt Konstanz, Amt für Stadtplanung und Umwelt
03.08.2022 18:00;1018;479;539;Sonnig;30;32;0;Stadt Konstanz, Amt für Stadtplanung und Umwelt
03.08.2022 19:00;726;355;371;Sonnig;27;28;0;Stadt Konstanz, Amt für Stadtplanung und Umwelt
03.08.2022 20:00;649;310;339;Sonnig;24;25;0;Stadt Konstanz, Amt für Stadtplanung und Umwelt
03.08.2022 21:00;476;210;266;Sonnig;21;21;0;Stadt Konstanz, Amt für Stadtplanung und Umwelt
03.08.2022 22:00;365;141;224;Sonnig;20;20;0;Stadt Konstanz, Amt für Stadtplanung und Umwelt
03.08.2022 23:00;210;80;130;Sonnig;19;19;0;Stadt Konstanz, Amt für Stadtplanung und Umwelt
04.08.2022 00:00;133;43;90;Sonnig;18;18;0;Stadt Konstanz, Amt für Stadtplanung und Umwelt
04.08.2022 01:00;51;19;32;Sonnig;18;18;0;Stadt Konstanz, Amt für Stadtplanung und Umwelt
04.08.2022 02:00;32;17;15;Sonnig;17;17;0;Stadt Konstanz, Amt für Stadtplanung und Umwelt
04.08.2022 03:00;7;5;2;Sonnig;17;17;0;Stadt Konstanz, Amt für Stadtplanung und Umwelt
04.08.2022 04:00;10;9;1;Sonnig;17;17;0;Stadt Konstanz, Amt für Stadtplanung und Umwelt
04.08.2022 05:00;66;39;27;Sonnig;17;17;0;Stadt Konstanz, Amt für Stadtplanung und Umwelt
04.08.2022 06:00;185;106;79;Sonnig;17;17;0;Stadt Konstanz, Amt für Stadtplanung und Umwelt
04.08.2022 07:00;449;232;217;Sonnig;20;20;0;Stadt Konstanz, Amt für Stadtplanung und Umwelt
04.08.2022 08:00;703;372;331;Sonnig;23;24;0;Stadt Konstanz, Amt für Stadtplanung und Umwelt
04.08.2022 09:00;608;331;277;Sonnig;26;27;0;Stadt Konstanz, Amt für Stadtplanung und Umwelt
04.08.2022 10:00;609;319;290;Sonnig;28;30;0;Stadt Konstanz, Amt für Stadtplanung und Umwelt
04.08.2022 11:00;601;272;329;Sonnig;31;33;0;Stadt Konstanz, Amt für Stadtplanung und Umwelt
04.08.2022 12:00;721;323;398;Sonnig;33;36;0;Stadt Konstanz, Amt für Stadtplanung und Umwelt
04.08.2022 13:00;636;333;303;Sonnig;34;36;0;Stadt Konstanz, Amt für Stadtplanung und Umwelt
04.08.2022 14:00;593;290;303;Sonnig;35;37;0;Stadt Konstanz, Amt für Stadtplanung und Umwelt
04.08.2022 15:00;704;343;361;Sonnig;35;37;0;Stadt Konstanz, Amt für Stadtplanung und Umwelt
04.08.2022 16:00;880;475;405;Sonnig;34;36;0;Stadt Konstanz, Amt für Stadtplanung und Umwelt
04.08.2022 17:00;911;480;431;Sonnig;32;35;0;Stadt Konstanz, Amt für Stadtplanung und Umwelt
04.08.2022 18:00;844;408;436;Sonnig;31;34;0;Stadt Konstanz, Amt für Stadtplanung und Umwelt
04.08.2022 19:00;735;377;358;Sonnig;28;31;0;Stadt Konstanz, Amt für Stadtplanung und Umwelt
04.08.2022 20:00;602;267;335;Sonnig;25;28;0;Stadt Konstanz, Amt für Stadtplanung und Umwelt
04.08.2022 21:00;493;196;297;Sonnig;22;25;0;Stadt Konstanz, Amt für Stadtplanung und Umwelt
04.08.2022 22:00;371;143;228;Sonnig;22;22;0;Stadt Konstanz, Amt für Stadtplanung und Umwelt
04.08.2022 23:00;225;77;148;Sonnig;21;21;0;Stadt Konstanz, Amt für Stadtplanung und Umwelt
05.08.2022 00:00;122;37;85;Sonnig;20;20;0;Stadt Konstanz, Amt für Stadtplanung und Umwelt
05.08.2022 01:00;64;25;39;Sonnig;20;20;0;Stadt Konstanz, Amt für Stadtplanung und Umwelt
05.08.2022 02:00;26;7;19;Sonnig;19;19;0;Stadt Konstanz, Amt für Stadtplanung und Umwelt
05.08.2022 03:00;16;5;11;Sonnig;19;19;0;Stadt Konstanz, Amt für Stadtplanung und Umwelt
05.08.2022 04:00;18;10;8;Sonnig;19;19;0;Stadt Konstanz, Amt für Stadtplanung und Umwelt
05.08.2022 05:00;58;33;25;Sonnig;19;19;0;Stadt Konstanz, Amt für Stadtplanung und Umwelt
05.08.2022 06:00;162;95;67;Sonnig;19;19;0;Stadt Konstanz, Amt für Stadtplanung und Umwelt
05.08.2022 07:00;418;223;195;Sonnig;22;22;0;Stadt Konstanz, Amt für Stadtplanung und Umwelt
05.08.2022 08:00;621;332;289;Sonnig;24;25;0;Stadt Konstanz, Amt für Stadtplanung und Umwelt
05.08.2022 09:00;679;402;277;Sonnig;27;27;0;Stadt Konstanz, Amt für Stadtplanung und Umwelt
05.08.2022 10:00;664;354;310;Sonnig;29;30;0;Stadt Konstanz, Amt für Stadtplanung und Umwelt
05.08.2022 11:00;649;301;348;Sonnig;32;33;0;Stadt Konstanz, Amt für Stadtplanung und Umwelt
05.08.2022 12:00;690;285;405;Sonnig;34;36;0;Stadt Konstanz, Amt für Stadtplanung und Umwelt
05.08.2022 13:00;693;306;387;Sonnig;34;36;0;Stadt Konstanz, Amt für Stadtplanung und Umwelt
05.08.2022 14:00;713;342;371;Sonnig;35;37;0;Stadt Konstanz, Amt für Stadtplanung und Umwelt
05.08.2022 15:00;679;324;355;Sonnig;35;37;0;Stadt Konstanz, Amt für Stadtplanung und Umwelt
05.08.2022 16:00;737;355;382;Sonnig;33;34;0;Stadt Konstanz, Amt für Stadtplanung und Umwelt
05.08.2022 17:00;833;434;399;Leicht bewoelkt;30;32;0;Stadt Konstanz, Amt für Stadtplanung und Umwelt
05.08.2022 18:00;770;433;337;Leicht bewoelkt;27;29;0;Stadt Konstanz, Amt für Stadtplanung und Umwelt
05.08.2022 19:00;738;397;341;Leicht bewoelkt;25;26;0;Stadt Konstanz, Amt für Stadtplanung und Umwelt
05.08.2022 20:00;296;107;189;Teilweise maessiger Regenfall;22;23;01. Jan;Stadt Konstanz, Amt für Stadtplanung und Umwelt
05.08.2022 21:00;209;68;141;Teilweise maessiger Regenfall;19;19;01. Mai;Stadt Konstanz, Amt für Stadtplanung und Umwelt
05.08.2022 22:00;222;68;154;Teilweise maessiger Regenfall;19;19;0.7;Stadt Konstanz, Amt für Stadtplanung und Umwelt
05.08.2022 23:00;118;41;77;Leichter Regenschauer;18;18;0.3;Stadt Konstanz, Amt für Stadtplanung und Umwelt
06.08.2022 00:00;123;44;79;Leichter Regenschauer;18;18;0.6;Stadt Konstanz, Amt für Stadtplanung und Umwelt
06.08.2022 01:00;91;25;66;Leichter Regenschauer;17;17;0.3;Stadt Konstanz, Amt für Stadtplanung und Umwelt
06.08.2022 02:00;49;11;38;Leichter Regenschauer;17;17;0.1;Stadt Konstanz, Amt für Stadtplanung und Umwelt
06.08.2022 03:00;43;21;22;Leichter Regenschauer;17;17;0.2;Stadt Konstanz, Amt für Stadtplanung und Umwelt
06.08.2022 04:00;20;9;11;Leichter Regenschauer;17;17;0.1;Stadt Konstanz, Amt für Stadtplanung und Umwelt
06.08.2022 05:00;43;19;24;Leichter Regenschauer;17;17;0.1;Stadt Konstanz, Amt für Stadtplanung und Umwelt
06.08.2022 06:00;44;19;25;Leichter Regenschauer;17;17;0.1;Stadt Konstanz, Amt für Stadtplanung und Umwelt
06.08.2022 07:00;69;36;33;Leichter Regenschauer;18;18;0;Stadt Konstanz, Amt für Stadtplanung und Umwelt
06.08.2022 08:00;204;95;109;Bedeckt;18;18;0;Stadt Konstanz, Amt für Stadtplanung und Umwelt
06.08.2022 09:00;328;184;144;Bedeckt;18;18;0;Stadt Konstanz, Amt für Stadtplanung und Umwelt
06.08.2022 10:00;353;165;188;Bedeckt;19;19;0;Stadt Konstanz, Amt für Stadtplanung und Umwelt
06.08.2022 11:00;418;250;168;Bedeckt;20;20;0;Stadt Konstanz, Amt für Stadtplanung und Umwelt
06.08.2022 12:00;425;254;171;Bedeckt;21;21;0;Stadt Konstanz, Amt für Stadtplanung und Umwelt
06.08.2022 13:00;422;209;213;Bedeckt;22;25;0;Stadt Konstanz, Amt für Stadtplanung und Umwelt
06.08.2022 14:00;554;257;297;Leicht bewoelkt;23;25;0;Stadt Konstanz, Amt für Stadtplanung und Umwelt
06.08.2022 15:00;575;286;289;Leicht bewoelkt;24;26;0;Stadt Konstanz, Amt für Stadtplanung und Umwelt
06.08.2022 16:00;613;290;323;Leicht bewoelkt;24;26;0;Stadt Konstanz, Amt für Stadtplanung und Umwelt
06.08.2022 17:00;571;260;311;Leicht bewoelkt;24;26;0;Stadt Konstanz, Amt für Stadtplanung und Umwelt
06.08.2022 18:00;569;252;317;Leicht bewoelkt;24;26;0;Stadt Konstanz, Amt für Stadtplanung und Umwelt
06.08.2022 19:00;428;189;239;Leicht bewoelkt;22;22;0;Stadt Konstanz, Amt für Stadtplanung und Umwelt
06.08.2022 20:00;377;181;196;Sonnig;20;20;0;Stadt Konstanz, Amt für Stadtplanung und Umwelt
06.08.2022 21:00;312;150;162;Sonnig;17;17;0;Stadt Konstanz, Amt für Stadtplanung und Umwelt
06.08.2022 22:00;225;95;130;Sonnig;17;17;0;Stadt Konstanz, Amt für Stadtplanung und Umwelt
06.08.2022 23:00;208;90;118;Leicht bewoelkt;16;16;0;Stadt Konstanz, Amt für Stadtplanung und Umwelt
07.08.2022 00:00;216;95;121;Leicht bewoelkt;15;15;0;Stadt Konstanz, Amt für Stadtplanung und Umwelt
07.08.2022 01:00;112;42;70;Leicht bewoelkt;15;15;0;Stadt Konstanz, Amt für Stadtplanung und Umwelt
07.08.2022 02:00;80;44;36;Leicht bewoelkt;14;14;0;Stadt Konstanz, Amt für Stadtplanung und Umwelt
07.08.2022 03:00;56;19;37;Leicht bewoelkt;14;13;0;Stadt Konstanz, Amt für Stadtplanung und Umwelt
07.08.2022 04:00;31;20;11;Leicht bewoelkt;14;13;0;Stadt Konstanz, Amt für Stadtplanung und Umwelt
07.08.2022 05:00;30;16;14;Leicht bewoelkt;14;13;0;Stadt Konstanz, Amt für Stadtplanung und Umwelt
07.08.2022 06:00;44;23;21;Leicht bewoelkt;14;13;0;Stadt Konstanz, Amt für Stadtplanung und Umwelt
07.08.2022 07:00;62;37;25;Leicht bewoelkt;16;15;0;Stadt Konstanz, Amt für Stadtplanung und Umwelt
07.08.2022 08:00;100;52;48;Leicht bewoelkt;18;18;0;Stadt Konstanz, Amt für Stadtplanung und Umwelt
07.08.2022 09:00;290;148;142;Leicht bewoelkt;20;20;0;Stadt Konstanz, Amt für Stadtplanung und Umwelt
07.08.2022 10:00;329;150;179;Leicht bewoelkt;21;21;0;Stadt Konstanz, Amt für Stadtplanung und Umwelt
07.08.2022 11:00;404;185;219;Sonnig;23;24;0;Stadt Konstanz, Amt für Stadtplanung und Umwelt
07.08.2022 12:00;431;212;219;Sonnig;25;26;0;Stadt Konstanz, Amt für Stadtplanung und Umwelt
07.08.2022 13:00;497;252;245;Sonnig;25;26;0;Stadt Konstanz, Amt für Stadtplanung und Umwelt
07.08.2022 14:00;588;251;337;Leicht bewoelkt;26;26;0;Stadt Konstanz, Amt für Stadtplanung und Umwelt
07.08.2022 15:00;549;255;294;Leicht bewoelkt;26;26;0;Stadt Konstanz, Amt für Stadtplanung und Umwelt
07.08.2022 16:00;590;300;290;Leicht bewoelkt;25;26;0;Stadt Konstanz, Amt für Stadtplanung und Umwelt
07.08.2022 17:00;555;282;273;Sonnig;25;26;0;Stadt Konstanz, Amt für Stadtplanung und Umwelt
07.08.2022 18:00;465;253;212;Sonnig;24;26;0;Stadt Konstanz, Amt für Stadtplanung und Umwelt
07.08.2022 19:00;380;202;178;Sonnig;22;22;0;Stadt Konstanz, Amt für Stadtplanung und Umwelt
07.08.2022 20:00;295;155;140;Sonnig;19;19;0;Stadt Konstanz, Amt für Stadtplanung und Umwelt
07.08.2022 21:00;260;119;141;Sonnig;16;16;0;Stadt Konstanz, Amt für Stadtplanung und Umwelt
07.08.2022 22:00;154;62;92;Sonnig;15;15;0;Stadt Konstanz, Amt für Stadtplanung und Umwelt
07.08.2022 23:00;109;36;73;Sonnig;14;14;0;Stadt Konstanz, Amt für Stadtplanung und Umwelt
08.08.2022 00:00;50;19;31;Sonnig;13;13;0;Stadt Konstanz, Amt für Stadtplanung und Umwelt
08.08.2022 01:00;26;16;10;Sonnig;13;13;0;Stadt Konstanz, Amt für Stadtplanung und Umwelt
08.08.2022 02:00;7;3;4;Sonnig;12;12;0;Stadt Konstanz, Amt für Stadtplanung und Umwelt
08.08.2022 03:00;14;9;5;Sonnig;12;12;0;Stadt Konstanz, Amt für Stadtplanung und Umwelt
08.08.2022 04:00;14;7;7;Sonnig;12;11;0;Stadt Konstanz, Amt für Stadtplanung und Umwelt
08.08.2022 05:00;49;31;18;Sonnig;12;11;0;Stadt Konstanz, Amt für Stadtplanung und Umwelt
08.08.2022 06:00;181;102;79;Sonnig;11;11;0;Stadt Konstanz, Amt für Stadtplanung und Umwelt
08.08.2022 07:00;368;201;167;Sonnig;14;14;0;Stadt Konstanz, Amt für Stadtplanung und Umwelt
08.08.2022 08:00;575;311;264;Sonnig;17;17;0;Stadt Konstanz, Amt für Stadtplanung und Umwelt
08.08.2022 09:00;510;280;230;Sonnig;20;20;0;Stadt Konstanz, Amt für Stadtplanung und Umwelt
08.08.2022 10:00;572;321;251;Sonnig;22;22;0;Stadt Konstanz, Amt für Stadtplanung und Umwelt
08.08.2022 11:00;679;316;363;Sonnig;24;24;0;Stadt Konstanz, Amt für Stadtplanung und Umwelt
08.08.2022 12:00;723;341;382;Sonnig;26;26;0;Stadt Konstanz, Amt für Stadtplanung und Umwelt
08.08.2022 13:00;736;378;358;Sonnig;27;27;0;Stadt Konstanz, Amt für Stadtplanung und Umwelt
08.08.2022 14:00;715;362;353;Sonnig;28;28;0;Stadt Konstanz, Amt für Stadtplanung und Umwelt
08.08.2022 15:00;767;371;396;Sonnig;30;30;0;Stadt Konstanz, Amt für Stadtplanung und Umwelt
08.08.2022 16:00;874;432;442;Sonnig;28;29;0;Stadt Konstanz, Amt für Stadtplanung und Umwelt
08.08.2022 17:00;928;443;485;Sonnig;27;28;0;Stadt Konstanz, Amt für Stadtplanung und Umwelt
08.08.2022 18:00;898;434;464;Sonnig;26;27;0;Stadt Konstanz, Amt für Stadtplanung und Umwelt
08.08.2022 19:00;688;318;370;Sonnig;23;23;0;Stadt Konstanz, Amt für Stadtplanung und Umwelt
08.08.2022 20:00;551;232;319;Sonnig;19;19;0;Stadt Konstanz, Amt für Stadtplanung und Umwelt
08.08.2022 21:00;395;166;229;Sonnig;16;16;0;Stadt Konstanz, Amt für Stadtplanung und Umwelt
08.08.2022 22:00;259;105;154;Sonnig;15;15;0;Stadt Konstanz, Amt für Stadtplanung und Umwelt
08.08.2022 23:00;153;70;83;Sonnig;14;14;0;Stadt Konstanz, Amt für Stadtplanung und Umwelt
09.08.2022 00:00;92;33;59;Sonnig;13;14;0;Stadt Konstanz, Amt für Stadtplanung und Umwelt
09.08.2022 01:00;31;17;14;Sonnig;13;13;0;Stadt Konstanz, Amt für Stadtplanung und Umwelt
09.08.2022 02:00;33;14;19;Sonnig;12;12;0;Stadt Konstanz, Amt für Stadtplanung und Umwelt
09.08.2022 03:00;18;11;7;Sonnig;12;11;0;Stadt Konstanz, Amt für Stadtplanung und Umwelt
09.08.2022 04:00;10;7;3;Sonnig;12;11;0;Stadt Konstanz, Amt für Stadtplanung und Umwelt
09.08.2022 05:00;51;33;18;Sonnig;11;11;0;Stadt Konstanz, Amt für Stadtplanung und Umwelt
09.08.2022 06:00;184;114;70;Sonnig;11;11;0;Stadt Konstanz, Amt für Stadtplanung und Umwelt
09.08.2022 07:00;418;231;187;Sonnig;14;14;0;Stadt Konstanz, Amt für Stadtplanung und Umwelt
09.08.2022 08:00;606;339;267;Sonnig;17;17;0;Stadt Konstanz, Amt für Stadtplanung und Umwelt
09.08.2022 09:00;618;359;259;Sonnig;21;21;0;Stadt Konstanz, Amt für Stadtplanung und Umwelt
09.08.2022 10:00;685;356;329;Sonnig;23;23;0;Stadt Konstanz, Amt für Stadtplanung und Umwelt
09.08.2022 11:00;660;337;323;Sonnig;25;25;0;Stadt Konstanz, Amt für Stadtplanung und Umwelt
09.08.2022 12:00;699;305;394;Sonnig;27;27;0;Stadt Konstanz, Amt für Stadtplanung und Umwelt
09.08.2022 13:00;784;383;401;Sonnig;28;27;0;Stadt Konstanz, Amt für Stadtplanung und Umwelt
09.08.2022 14:00;672;335;337;Sonnig;29;28;0;Stadt Konstanz, Amt für Stadtplanung und Umwelt
09.08.2022 15:00;804;392;412;Sonnig;30;29;0;Stadt Konstanz, Amt für Stadtplanung und Umwelt
09.08.2022 16:00;837;414;423;Sonnig;29;28;0;Stadt Konstanz, Amt für Stadtplanung und Umwelt
09.08.2022 17:00;1002;517;485;Sonnig;28;28;0;Stadt Konstanz, Amt für Stadtplanung und Umwelt
09.08.2022 18:00;950;414;536;Sonnig;27;27;0;Stadt Konstanz, Amt für Stadtplanung und Umwelt
09.08.2022 19:00;652;324;328;Sonnig;24;24;0;Stadt Konstanz, Amt für Stadtplanung und Umwelt
09.08.2022 20:00;523;240;283;Sonnig;21;21;0;Stadt Konstanz, Amt für Stadtplanung und Umwelt
09.08.2022 21:00;437;186;251;Sonnig;18;18;0;Stadt Konstanz, Amt für Stadtplanung und Umwelt
09.08.2022 22:00;277;113;164;Sonnig;17;17;0;Stadt Konstanz, Amt für Stadtplanung und Umwelt
09.08.2022 23:00;182;58;124;Sonnig;16;16;0;Stadt Konstanz, Amt für Stadtplanung und Umwelt
10.08.2022 00:00;94;36;58;Sonnig;16;16;0;Stadt Konstanz, Amt für Stadtplanung und Umwelt
10.08.2022 01:00;40;10;30;Sonnig;15;15;0;Stadt Konstanz, Amt für Stadtplanung und Umwelt
10.08.2022 02:00;21;9;12;Sonnig;14;14;0;Stadt Konstanz, Amt für Stadtplanung und Umwelt
10.08.2022 03:00;5;1;4;Sonnig;13;13;0;Stadt Konstanz, Amt für Stadtplanung und Umwelt
10.08.2022 04:00;11;10;1;Sonnig;12;12;0;Stadt Konstanz, Amt für Stadtplanung und Umwelt
10.08.2022 05:00;52;31;21;Sonnig;12;11;0;Stadt Konstanz, Amt für Stadtplanung und Umwelt
10.08.2022 06:00;206;115;91;Sonnig;11;11;0;Stadt Konstanz, Amt für Stadtplanung und Umwelt
10.08.2022 07:00;387;210;177;Sonnig;14;14;0;Stadt Konstanz, Amt für Stadtplanung und Umwelt
10.08.2022 08:00;549;300;249;Sonnig;17;17;0;Stadt Konstanz, Amt für Stadtplanung und Umwelt
10.08.2022 09:00;572;308;264;Sonnig;20;20;0;Stadt Konstanz, Amt für Stadtplanung und Umwelt
10.08.2022 10:00;598;302;296;Sonnig;23;22;0;Stadt Konstanz, Amt für Stadtplanung und Umwelt
10.08.2022 11:00;672;342;330;Sonnig;25;25;0;Stadt Konstanz, Amt für Stadtplanung und Umwelt
10.08.2022 12:00;709;348;361;Sonnig;27;27;0;Stadt Konstanz, Amt für Stadtplanung und Umwelt
10.08.2022 13:00;729;347;382;Sonnig;28;27;0;Stadt Konstanz, Amt für Stadtplanung und Umwelt
10.08.2022 14:00;698;368;330;Sonnig;29;28;0;Stadt Konstanz, Amt für Stadtplanung und Umwelt
10.08.2022 15:00;703;338;365;Sonnig;30;29;0;Stadt Konstanz, Amt für Stadtplanung und Umwelt
10.08.2022 16:00;878;449;429;Sonnig;29;28;0;Stadt Konstanz, Amt für Stadtplanung und Umwelt
10.08.2022 17:00;944;492;452;Sonnig;28;28;0;Stadt Konstanz, Amt für Stadtplanung und Umwelt
10.08.2022 18:00;900;439;461;Sonnig;27;27;0;Stadt Konstanz, Amt für Stadtplanung und Umwelt
10.08.2022 19:00;743;398;345;Sonnig;24;24;0;Stadt Konstanz, Amt für Stadtplanung und Umwelt
10.08.2022 20:00;606;285;321;Sonnig;20;20;0;Stadt Konstanz, Amt für Stadtplanung und Umwelt
10.08.2022 21:00;452;178;274;Sonnig;17;17;0;Stadt Konstanz, Amt für Stadtplanung und Umwelt
10.08.2022 22:00;398;111;287;Sonnig;16;16;0;Stadt Konstanz, Amt für Stadtplanung und Umwelt
10.08.2022 23:00;247;57;190;Sonnig;15;15;0;Stadt Konstanz, Amt für Stadtplanung und Umwelt
11.08.2022 00:00;152;26;126;Sonnig;14;14;0;Stadt Konstanz, Amt für Stadtplanung und Umwelt
11.08.2022 01:00;57;14;43;Sonnig;13;13;0;Stadt Konstanz, Amt für Stadtplanung und Umwelt
11.08.2022 02:00;28;12;16;Sonnig;12;12;0;Stadt Konstanz, Amt für Stadtplanung und Umwelt
11.08.2022 03:00;11;3;8;Sonnig;11;11;0;Stadt Konstanz, Amt für Stadtplanung und Umwelt
11.08.2022 04:00;11;4;7;Sonnig;11;11;0;Stadt Konstanz, Amt für Stadtplanung und Umwelt
11.08.2022 05:00;63;43;20;Sonnig;11;11;0;Stadt Konstanz, Amt für Stadtplanung und Umwelt
11.08.2022 06:00;171;96;75;Sonnig;11;11;0;Stadt Konstanz, Amt für Stadtplanung und Umwelt
11.08.2022 07:00;403;224;179;Sonnig;13;13;0;Stadt Konstanz, Amt für Stadtplanung und Umwelt
11.08.2022 08:00;516;301;215;Sonnig;16;16;0;Stadt Konstanz, Amt für Stadtplanung und Umwelt
11.08.2022 09:00;527;307;220;Sonnig;19;19;0;Stadt Konstanz, Amt für Stadtplanung und Umwelt
11.08.2022 10:00;596;312;284;Sonnig;21;21;0;Stadt Konstanz, Amt für Stadtplanung und Umwelt
11.08.2022 11:00;666;305;361;Sonnig;23;24;0;Stadt Konstanz, Amt für Stadtplanung und Umwelt
11.08.2022 12:00;731;355;376;Sonnig;25;26;0;Stadt Konstanz, Amt für Stadtplanung und Umwelt
11.08.2022 13:00;720;357;363;Sonnig;27;27;0;Stadt Konstanz, Amt für Stadtplanung und Umwelt
11.08.2022 14:00;643;308;335;Sonnig;28;29;0;Stadt Konstanz, Amt für Stadtplanung und Umwelt
11.08.2022 15:00;726;384;342;Sonnig;30;30;0;Stadt Konstanz, Amt für Stadtplanung und Umwelt
11.08.2022 16:00;915;439;476;Sonnig;29;29;0;Stadt Konstanz, Amt für Stadtplanung und Umwelt
11.08.2022 17:00;882;481;401;Sonnig;28;28;0;Stadt Konstanz, Amt für Stadtplanung und Umwelt
11.08.2022 18:00;856;396;460;Sonnig;27;28;0;Stadt Konstanz, Amt für Stadtplanung und Umwelt
11.08.2022 19:00;711;348;363;Sonnig;24;25;0;Stadt Konstanz, Amt für Stadtplanung und Umwelt
11.08.2022 20:00;562;286;276;Sonnig;21;21;0;Stadt Konstanz, Amt für Stadtplanung und Umwelt
11.08.2022 21:00;429;182;247;Sonnig;19;19;0;Stadt Konstanz, Amt für Stadtplanung und Umwelt
11.08.2022 22:00;342;100;242;Sonnig;18;18;0;Stadt Konstanz, Amt für Stadtplanung und Umwelt
11.08.2022 23:00;220;56;164;Sonnig;17;17;0;Stadt Konstanz, Amt für Stadtplanung und Umwelt
12.08.2022 00:00;161;30;131;Sonnig;16;16;0;Stadt Konstanz, Amt für Stadtplanung und Umwelt
12.08.2022 01:00;58;11;47;Sonnig;16;16;0;Stadt Konstanz, Amt für Stadtplanung und Umwelt
12.08.2022 02:00;33;14;19;Sonnig;15;15;0;Stadt Konstanz, Amt für Stadtplanung und Umwelt
12.08.2022 03:00;26;13;13;Sonnig;15;15;0;Stadt Konstanz, Amt für Stadtplanung und Umwelt
12.08.2022 04:00;26;20;6;Sonnig;14;14;0;Stadt Konstanz, Amt für Stadtplanung und Umwelt
12.08.2022 05:00;57;35;22;Sonnig;13;12;0;Stadt Konstanz, Amt für Stadtplanung und Umwelt
12.08.2022 06:00;164;103;61;Sonnig;12;11;0;Stadt Konstanz, Amt für Stadtplanung und Umwelt
12.08.2022 07:00;339;194;145;Sonnig;15;14;0;Stadt Konstanz, Amt für Stadtplanung und Umwelt
12.08.2022 08:00;529;306;223;Sonnig;18;18;0;Stadt Konstanz, Amt für Stadtplanung und Umwelt
12.08.2022 09:00;596;343;253;Sonnig;21;21;0;Stadt Konstanz, Amt für Stadtplanung und Umwelt
12.08.2022 10:00;634;361;273;Sonnig;23;23;0;Stadt Konstanz, Amt für Stadtplanung und Umwelt
12.08.2022 11:00;727;362;365;Sonnig;26;25;0;Stadt Konstanz, Amt für Stadtplanung und Umwelt
12.08.2022 12:00;793;331;462;Sonnig;28;28;0;Stadt Konstanz, Amt für Stadtplanung und Umwelt
12.08.2022 13:00;806;328;478;Sonnig;29;28;0;Stadt Konstanz, Amt für Stadtplanung und Umwelt
12.08.2022 14:00;695;350;345;Sonnig;29;28;0;Stadt Konstanz, Amt für Stadtplanung und Umwelt
12.08.2022 15:00;789;371;418;Sonnig;29;28;0;Stadt Konstanz, Amt für Stadtplanung und Umwelt
12.08.2022 16:00;740;392;348;Sonnig;28;27;0;Stadt Konstanz, Amt für Stadtplanung und Umwelt
12.08.2022 17:00;812;442;370;Sonnig;27;27;0;Stadt Konstanz, Amt für Stadtplanung und Umwelt
12.08.2022 18:00;801;419;382;Sonnig;26;26;0;Stadt Konstanz, Amt für Stadtplanung und Umwelt
12.08.2022 19:00;707;372;335;Sonnig;22;22;0;Stadt Konstanz, Amt für Stadtplanung und Umwelt
12.08.2022 20:00;591;295;296;Sonnig;19;18;0;Stadt Konstanz, Amt für Stadtplanung und Umwelt
12.08.2022 21:00;502;216;286;Sonnig;15;15;0;Stadt Konstanz, Amt für Stadtplanung und Umwelt
12.08.2022 22:00;372;130;242;Sonnig;14;14;0;Stadt Konstanz, Amt für Stadtplanung und Umwelt
12.08.2022 23:00;312;88;224;Sonnig;13;13;0;Stadt Konstanz, Amt für Stadtplanung und Umwelt
13.08.2022 00:00;219;36;183;Sonnig;12;12;0;Stadt Konstanz, Amt für Stadtplanung und Umwelt
13.08.2022 01:00;118;23;95;Sonnig;11;11;0;Stadt Konstanz, Amt für Stadtplanung und Umwelt
13.08.2022 02:00;70;11;59;Sonnig;10;10;0;Stadt Konstanz, Amt für Stadtplanung und Umwelt
13.08.2022 03:00;55;16;39;Sonnig;10;10;0;Stadt Konstanz, Amt für Stadtplanung und Umwelt
13.08.2022 04:00;35;15;20;Sonnig;10;9;0;Stadt Konstanz, Amt für Stadtplanung und Umwelt
13.08.2022 05:00;41;24;17;Sonnig;9;9;0;Stadt Konstanz, Amt für Stadtplanung und Umwelt
13.08.2022 06:00;67;38;29;Sonnig;9;9;0;Stadt Konstanz, Amt für Stadtplanung und Umwelt
13.08.2022 07:00;94;50;44;Sonnig;13;12;0;Stadt Konstanz, Amt für Stadtplanung und Umwelt
13.08.2022 08:00;215;110;105;Sonnig;16;16;0;Stadt Konstanz, Amt für Stadtplanung und Umwelt
13.08.2022 09:00;432;259;173;Sonnig;19;19;0;Stadt Konstanz, Amt für Stadtplanung und Umwelt
13.08.2022 10:00;617;338;279;Sonnig;21;21;0;Stadt Konstanz, Amt für Stadtplanung und Umwelt
13.08.2022 11:00;705;368;337;Sonnig;22;23;0;Stadt Konstanz, Amt für Stadtplanung und Umwelt
13.08.2022 12:00;783;388;395;Sonnig;24;25;0;Stadt Konstanz, Amt für Stadtplanung und Umwelt
13.08.2022 13:00;817;372;445;Sonnig;26;26;0;Stadt Konstanz, Amt für Stadtplanung und Umwelt
13.08.2022 14:00;705;330;375;Sonnig;28;27;0;Stadt Konstanz, Amt für Stadtplanung und Umwelt
13.08.2022 15:00;931;379;552;Sonnig;29;28;0;Stadt Konstanz, Amt für Stadtplanung und Umwelt
13.08.2022 16:00;960;432;528;Sonnig;29;28;0;Stadt Konstanz, Amt für Stadtplanung und Umwelt
13.08.2022 17:00;861;414;447;Sonnig;28;27;0;Stadt Konstanz, Amt für Stadtplanung und Umwelt
13.08.2022 18:00;908;453;455;Sonnig;27;27;0;Stadt Konstanz, Amt für Stadtplanung und Umwelt
13.08.2022 19:00;816;434;382;Sonnig;23;23;0;Stadt Konstanz, Amt für Stadtplanung und Umwelt
13.08.2022 20:00;727;328;399;Sonnig;19;19;0;Stadt Konstanz, Amt für Stadtplanung und Umwelt
13.08.2022 21:00;648;232;416;Sonnig;16;16;0;Stadt Konstanz, Amt für Stadtplanung und Umwelt
13.08.2022 22:00;339;130;209;Sonnig;15;15;0;Stadt Konstanz, Amt für Stadtplanung und Umwelt
13.08.2022 23:00;868;495;373;Sonnig;14;14;0;Stadt Konstanz, Amt für Stadtplanung und Umwelt
14.08.2022 00:00;472;179;293;Sonnig;13;13;0;Stadt Konstanz, Amt für Stadtplanung und Umwelt
14.08.2022 01:00;266;66;200;Sonnig;12;12;0;Stadt Konstanz, Amt für Stadtplanung und Umwelt
14.08.2022 02:00;141;24;117;Sonnig;12;12;0;Stadt Konstanz, Amt für Stadtplanung und Umwelt
14.08.2022 03:00;96;31;65;Sonnig;11;11;0;Stadt Konstanz, Amt für Stadtplanung und Umwelt
14.08.2022 04:00;42;23;19;Sonnig;11;11;0;Stadt Konstanz, Amt für Stadtplanung und Umwelt
14.08.2022 05:00;57;29;28;Sonnig;11;11;0;Stadt Konstanz, Amt für Stadtplanung und Umwelt
14.08.2022 06:00;41;26;15;Sonnig;11;11;0;Stadt Konstanz, Amt für Stadtplanung und Umwelt
14.08.2022 07:00;51;23;28;Sonnig;14;14;0;Stadt Konstanz, Amt für Stadtplanung und Umwelt
14.08.2022 08:00;105;65;40;Sonnig;17;17;0;Stadt Konstanz, Amt für Stadtplanung und Umwelt
14.08.2022 09:00;268;153;115;Sonnig;20;20;0;Stadt Konstanz, Amt für Stadtplanung und Umwelt
14.08.2022 10:00;355;174;181;Sonnig;22;22;0;Stadt Konstanz, Amt für Stadtplanung und Umwelt
14.08.2022 11:00;483;255;228;Bewoelkt;24;24;0;Stadt Konstanz, Amt für Stadtplanung und Umwelt
14.08.2022 12:00;507;226;281;Bewoelkt;26;26;0;Stadt Konstanz, Amt für Stadtplanung und Umwelt
14.08.2022 13:00;495;234;261;Bewoelkt;27;27;0;Stadt Konstanz, Amt für Stadtplanung und Umwelt
14.08.2022 14:00;496;200;296;Sonnig;29;29;0;Stadt Konstanz, Amt für Stadtplanung und Umwelt
14.08.2022 15:00;529;264;265;Sonnig;31;30;0;Stadt Konstanz, Amt für Stadtplanung und Umwelt
14.08.2022 16:00;543;281;262;Sonnig;29;29;0;Stadt Konstanz, Amt für Stadtplanung und Umwelt
14.08.2022 17:00;548;312;236;Sonnig;28;28;0;Stadt Konstanz, Amt für Stadtplanung und Umwelt
14.08.2022 18:00;553;297;256;Sonnig;26;27;0;Stadt Konstanz, Amt für Stadtplanung und Umwelt
14.08.2022 19:00;374;183;191;Sonnig;23;24;0;Stadt Konstanz, Amt für Stadtplanung und Umwelt
14.08.2022 20:00;341;158;183;Sonnig;20;20;0;Stadt Konstanz, Amt für Stadtplanung und Umwelt
14.08.2022 21:00;247;86;161;Sonnig;17;17;0;Stadt Konstanz, Amt für Stadtplanung und Umwelt
14.08.2022 22:00;154;57;97;Sonnig;17;17;0;Stadt Konstanz, Amt für Stadtplanung und Umwelt
14.08.2022 23:00;74;24;50;Leicht bewoelkt;16;16;0;Stadt Konstanz, Amt für Stadtplanung und Umwelt
15.08.2022 00:00;29;9;20;Leicht bewoelkt;15;15;0;Stadt Konstanz, Amt für Stadtplanung und Umwelt
15.08.2022 01:00;33;19;14;Leicht bewoelkt;15;15;0;Stadt Konstanz, Amt für Stadtplanung und Umwelt
15.08.2022 02:00;7;5;2;Leicht bewoelkt;15;15;0;Stadt Konstanz, Amt für Stadtplanung und Umwelt
15.08.2022 03:00;3;0;3;Leicht bewoelkt;15;15;0;Stadt Konstanz, Amt für Stadtplanung und Umwelt
15.08.2022 04:00;10;8;2;Leicht bewoelkt;15;15;0;Stadt Konstanz, Amt für Stadtplanung und Umwelt
15.08.2022 05:00;38;32;6;Stellenweiser Regenfall;15;15;0.1;Stadt Konstanz, Amt für Stadtplanung und Umwelt
15.08.2022 06:00;152;90;62;Stellenweiser Regenfall;15;15;0.1;Stadt Konstanz, Amt für Stadtplanung und Umwelt
15.08.2022 07:00;358;193;165;Stellenweiser Regenfall;16;16;0;Stadt Konstanz, Amt für Stadtplanung und Umwelt
15.08.2022 08:00;449;273;176;Stellenweiser Regenfall;17;17;0;Stadt Konstanz, Amt für Stadtplanung und Umwelt
15.08.2022 09:00;480;272;208;Stellenweiser Regenfall;19;19;0;Stadt Konstanz, Amt für Stadtplanung und Umwelt
15.08.2022 10:00;598;305;293;Stellenweiser Regenfall;20;20;0;Stadt Konstanz, Amt für Stadtplanung und Umwelt
15.08.2022 11:00;627;325;302;Stellenweiser Regenfall;21;21;0;Stadt Konstanz, Amt für Stadtplanung und Umwelt
15.08.2022 12:00;666;337;329;Stellenweiser Regenfall;23;25;0;Stadt Konstanz, Amt für Stadtplanung und Umwelt
15.08.2022 13:00;716;361;355;Stellenweiser Regenfall;24;25;0;Stadt Konstanz, Amt für Stadtplanung und Umwelt
15.08.2022 14:00;628;307;321;Sonnig;25;26;0;Stadt Konstanz, Amt für Stadtplanung und Umwelt
15.08.2022 15:00;758;374;384;Sonnig;26;27;0;Stadt Konstanz, Amt für Stadtplanung und Umwelt
15.08.2022 16:00;826;376;450;Sonnig;26;26;0;Stadt Konstanz, Amt für Stadtplanung und Umwelt
15.08.2022 17:00;630;277;353;Sonnig;25;26;0;Stadt Konstanz, Amt für Stadtplanung und Umwelt
15.08.2022 18:00;482;211;271;Sonnig;24;26;0;Stadt Konstanz, Amt für Stadtplanung und Umwelt
15.08.2022 19:00;346;156;190;Sonnig;22;22;0;Stadt Konstanz, Amt für Stadtplanung und Umwelt
15.08.2022 20:00;329;178;151;Sonnig;19;19;0;Stadt Konstanz, Amt für Stadtplanung und Umwelt
15.08.2022 21:00;195;87;108;Sonnig;17;17;0;Stadt Konstanz, Amt für Stadtplanung und Umwelt
15.08.2022 22:00;172;72;100;Sonnig;16;16;0;Stadt Konstanz, Amt für Stadtplanung und Umwelt
15.08.2022 23:00;100;34;66;Stellenweiser Regenfall;15;15;0.1;Stadt Konstanz, Amt für Stadtplanung und Umwelt
16.08.2022 00:00;69;21;48;Stellenweiser Regenfall;14;14;0.2;Stadt Konstanz, Amt für Stadtplanung und Umwelt
16.08.2022 01:00;30;10;20;Stellenweiser Regenfall;14;14;0.1;Stadt Konstanz, Amt für Stadtplanung und Umwelt
16.08.2022 02:00;20;10;10;Sonnig;13;14;0;Stadt Konstanz, Amt für Stadtplanung und Umwelt
16.08.2022 03:00;7;1;6;Sonnig;13;14;0;Stadt Konstanz, Amt für Stadtplanung und Umwelt
16.08.2022 04:00;14;7;7;Sonnig;13;13;0;Stadt Konstanz, Amt für Stadtplanung und Umwelt
16.08.2022 05:00;47;29;18;Sonnig;13;13;0;Stadt Konstanz, Amt für Stadtplanung und Umwelt
16.08.2022 06:00;191;112;79;Sonnig;13;13;0;Stadt Konstanz, Amt für Stadtplanung und Umwelt
16.08.2022 07:00;378;213;165;Sonnig;16;16;0;Stadt Konstanz, Amt für Stadtplanung und Umwelt
16.08.2022 08:00;534;330;204;Sonnig;18;18;0;Stadt Konstanz, Amt für Stadtplanung und Umwelt
16.08.2022 09:00;565;298;267;Sonnig;21;21;0;Stadt Konstanz, Amt für Stadtplanung und Umwelt
16.08.2022 10:00;654;371;283;Sonnig;24;27;0;Stadt Konstanz, Amt für Stadtplanung und Umwelt
16.08.2022 11:00;709;374;335;Sonnig;27;29;0;Stadt Konstanz, Amt für Stadtplanung und Umwelt
16.08.2022 12:00;696;315;381;Sonnig;30;31;0;Stadt Konstanz, Amt für Stadtplanung und Umwelt
16.08.2022 13:00;753;361;392;Sonnig;31;31;0;Stadt Konstanz, Amt für Stadtplanung und Umwelt
16.08.2022 14:00;732;341;391;Sonnig;32;32;0;Stadt Konstanz, Amt für Stadtplanung und Umwelt
16.08.2022 15:00;767;413;354;Sonnig;33;32;0;Stadt Konstanz, Amt für Stadtplanung und Umwelt
16.08.2022 16:00;845;392;453;Sonnig;31;31;0;Stadt Konstanz, Amt für Stadtplanung und Umwelt
16.08.2022 17:00;949;461;488;Sonnig;29;29;0;Stadt Konstanz, Amt für Stadtplanung und Umwelt
16.08.2022 18:00;886;370;516;Sonnig;27;27;0;Stadt Konstanz, Amt für Stadtplanung und Umwelt
16.08.2022 19:00;683;328;355;Sonnig;25;25;0;Stadt Konstanz, Amt für Stadtplanung und Umwelt
16.08.2022 20:00;581;240;341;Sonnig;22;23;0;Stadt Konstanz, Amt für Stadtplanung und Umwelt
16.08.2022 21:00;410;184;226;Sonnig;20;20;0;Stadt Konstanz, Amt für Stadtplanung und Umwelt
16.08.2022 22:00;292;101;191;Sonnig;19;19;0;Stadt Konstanz, Amt für Stadtplanung und Umwelt
16.08.2022 23:00;147;46;101;Sonnig;18;18;0;Stadt Konstanz, Amt für Stadtplanung und Umwelt
17.08.2022 00:00;80;34;46;Sonnig;17;17;0;Stadt Konstanz, Amt für Stadtplanung und Umwelt
17.08.2022 01:00;37;11;26;Sonnig;16;16;0;Stadt Konstanz, Amt für Stadtplanung und Umwelt
17.08.2022 02:00;22;12;10;Sonnig;15;15;0;Stadt Konstanz, Amt für Stadtplanung und Umwelt
17.08.2022 03:00;14;13;1;Sonnig;15;15;0;Stadt Konstanz, Amt für Stadtplanung und Umwelt
17.08.2022 04:00;33;19;14;Sonnig;15;15;0;Stadt Konstanz, Amt für Stadtplanung und Umwelt
17.08.2022 05:00;53;30;23;Sonnig;15;14;0;Stadt Konstanz, Amt für Stadtplanung und Umwelt
17.08.2022 06:00;175;99;76;Sonnig;14;14;0;Stadt Konstanz, Amt für Stadtplanung und Umwelt
17.08.2022 07:00;405;221;184;Sonnig;17;16;0;Stadt Konstanz, Amt für Stadtplanung und Umwelt
17.08.2022 08:00;493;278;215;Sonnig;19;19;0;Stadt Konstanz, Amt für Stadtplanung und Umwelt
17.08.2022 09:00;516;314;202;Sonnig;21;21;0;Stadt Konstanz, Amt für Stadtplanung und Umwelt
17.08.2022 10:00;645;318;327;Sonnig;22;25;0;Stadt Konstanz, Amt für Stadtplanung und Umwelt
17.08.2022 11:00;621;321;300;Sonnig;24;25;0;Stadt Konstanz, Amt für Stadtplanung und Umwelt
17.08.2022 12:00;733;343;390;Sonnig;25;26;0;Stadt Konstanz, Amt für Stadtplanung und Umwelt
17.08.2022 13:00;621;292;329;Sonnig;26;26;0;Stadt Konstanz, Amt für Stadtplanung und Umwelt
17.08.2022 14:00;638;331;307;Stellenweise Gewitter und Niederschlaege;26;27;0;Stadt Konstanz, Amt für Stadtplanung und Umwelt
17.08.2022 15:00;741;389;352;Stellenweise Gewitter und Niederschlaege;27;27;0;Stadt Konstanz, Amt für Stadtplanung und Umwelt
17.08.2022 16:00;830;400;430;Stellenweise Gewitter und Niederschlaege;26;27;0;Stadt Konstanz, Amt für Stadtplanung und Umwelt
17.08.2022 17:00;913;409;504;Stellenweiser Regenfall;25;26;0;Stadt Konstanz, Amt für Stadtplanung und Umwelt
17.08.2022 18:00;716;276;440;Stellenweiser Regenfall;24;26;0;Stadt Konstanz, Amt für Stadtplanung und Umwelt
17.08.2022 19:00;569;262;307;Stellenweiser Regenfall;21;21;0;Stadt Konstanz, Amt für Stadtplanung und Umwelt
17.08.2022 20:00;439;197;242;Leichter Regenschauer;18;18;0.4;Stadt Konstanz, Amt für Stadtplanung und Umwelt
17.08.2022 21:00;259;120;139;Leichter Regenschauer;16;16;0.5;Stadt Konstanz, Amt für Stadtplanung und Umwelt
17.08.2022 22:00;265;86;179;Leichter Regenschauer;15;15;0.3;Stadt Konstanz, Amt für Stadtplanung und Umwelt
17.08.2022 23:00;119;52;67;Leichter Regenschauer;15;15;0.3;Stadt Konstanz, Amt für Stadtplanung und Umwelt
18.08.2022 00:00;51;18;33;Leichter Regenschauer;14;14;0.5;Stadt Konstanz, Amt für Stadtplanung und Umwelt
18.08.2022 01:00;40;15;25;Leichter Regenschauer;15;15;0.3;Stadt Konstanz, Amt für Stadtplanung und Umwelt
18.08.2022 02:00;31;17;14;Leicht bewoelkt;15;15;0;Stadt Konstanz, Amt für Stadtplanung und Umwelt
18.08.2022 03:00;7;0;7;Leicht bewoelkt;16;16;0;Stadt Konstanz, Amt für Stadtplanung und Umwelt
18.08.2022 04:00;16;10;6;Leicht bewoelkt;16;16;0;Stadt Konstanz, Amt für Stadtplanung und Umwelt
18.08.2022 05:00;45;27;18;Leichter Nebel;16;16;0;Stadt Konstanz, Amt für Stadtplanung und Umwelt
18.08.2022 06:00;153;92;61;Leichter Nebel;15;15;0;Stadt Konstanz, Amt für Stadtplanung und Umwelt
18.08.2022 07:00;289;151;138;Leichter Nebel;17;17;0;Stadt Konstanz, Amt für Stadtplanung und Umwelt
18.08.2022 08:00;433;259;174;Bewoelkt;18;18;0;Stadt Konstanz, Amt für Stadtplanung und Umwelt
18.08.2022 09:00;503;309;194;Bewoelkt;19;19;0;Stadt Konstanz, Amt für Stadtplanung und Umwelt
18.08.2022 10:00;464;282;182;Bewoelkt;21;21;0;Stadt Konstanz, Amt für Stadtplanung und Umwelt
18.08.2022 11:00;551;293;258;Stellenweise Gewitter und Niederschlaege;23;24;0;Stadt Konstanz, Amt für Stadtplanung und Umwelt
18.08.2022 12:00;559;262;297;Stellenweise Gewitter und Niederschlaege;25;26;0;Stadt Konstanz, Amt für Stadtplanung und Umwelt
18.08.2022 13:00;574;277;297;Stellenweise Gewitter und Niederschlaege;25;26;0;Stadt Konstanz, Amt für Stadtplanung und Umwelt
18.08.2022 14:00;645;323;322;Leicht bewoelkt;25;26;0;Stadt Konstanz, Amt für Stadtplanung und Umwelt
18.08.2022 15:00;621;286;335;Leicht bewoelkt;26;27;0;Stadt Konstanz, Amt für Stadtplanung und Umwelt
18.08.2022 16:00;734;336;398;Leicht bewoelkt;25;26;0;Stadt Konstanz, Amt für Stadtplanung und Umwelt
18.08.2022 17:00;774;363;411;Stellenweiser Regenfall;23;25;0;Stadt Konstanz, Amt für Stadtplanung und Umwelt
18.08.2022 18:00;504;201;303;Stellenweiser Regenfall;22;25;0;Stadt Konstanz, Amt für Stadtplanung und Umwelt
18.08.2022 19:00;261;103;158;Stellenweiser Regenfall;20;20;0;Stadt Konstanz, Amt für Stadtplanung und Umwelt
18.08.2022 20:00;190;82;108;Stellenweiser Regenfall;18;18;0.2;Stadt Konstanz, Amt für Stadtplanung und Umwelt
18.08.2022 21:00;155;65;90;Stellenweiser Regenfall;16;16;0.2;Stadt Konstanz, Amt für Stadtplanung und Umwelt
18.08.2022 22:00;99;48;51;Stellenweiser Regenfall;16;16;0.1;Stadt Konstanz, Amt für Stadtplanung und Umwelt
18.08.2022 23:00;66;28;38;Leichter Regenschauer;16;16;0.1;Stadt Konstanz, Amt für Stadtplanung und Umwelt
19.08.2022 00:00;29;10;19;Leichter Regenschauer;15;15;0.2;Stadt Konstanz, Amt für Stadtplanung und Umwelt
19.08.2022 01:00;19;10;9;Leichter Regenschauer;15;15;0.1;Stadt Konstanz, Amt für Stadtplanung und Umwelt
19.08.2022 02:00;19;10;9;Stellenweiser Regenfall;15;15;0;Stadt Konstanz, Amt für Stadtplanung und Umwelt
19.08.2022 03:00;7;1;6;Stellenweiser Regenfall;15;16;0;Stadt Konstanz, Amt für Stadtplanung und Umwelt
19.08.2022 04:00;18;11;7;Stellenweiser Regenfall;15;15;0;Stadt Konstanz, Amt für Stadtplanung und Umwelt
19.08.2022 05:00;37;21;16;Stellenweiser Regenfall;15;15;0;Stadt Konstanz, Amt für Stadtplanung und Umwelt
19.08.2022 06:00;112;69;43;Stellenweiser Regenfall;15;15;0;Stadt Konstanz, Amt für Stadtplanung und Umwelt
19.08.2022 07:00;164;78;86;Stellenweiser Regenfall;16;16;0;Stadt Konstanz, Amt für Stadtplanung und Umwelt
19.08.2022 08:00;170;95;75;Bedeckt;17;17;0;Stadt Konstanz, Amt für Stadtplanung und Umwelt
19.08.2022 09:00;193;127;66;Bedeckt;18;18;0;Stadt Konstanz, Amt für Stadtplanung und Umwelt
19.08.2022 10:00;170;87;83;Bedeckt;19;19;0;Stadt Konstanz, Amt für Stadtplanung und Umwelt
19.08.2022 11:00;151;76;75;Leichter Regenschauer;19;19;0.1;Stadt Konstanz, Amt für Stadtplanung und Umwelt
19.08.2022 12:00;157;70;87;Leichter Regenschauer;20;20;0.1;Stadt Konstanz, Amt für Stadtplanung und Umwelt
19.08.2022 13:00;174;69;105;Leichter Regenschauer;20;20;0;Stadt Konstanz, Amt für Stadtplanung und Umwelt
19.08.2022 14:00;136;64;72;Leichter Regenschauer;20;20;0.3;Stadt Konstanz, Amt für Stadtplanung und Umwelt
19.08.2022 15:00;152;71;81;Leichter Regenschauer;20;20;0.4;Stadt Konstanz, Amt für Stadtplanung und Umwelt
19.08.2022 16:00;204;101;103;Leichter Regenschauer;19;19;0.2;Stadt Konstanz, Amt für Stadtplanung und Umwelt
19.08.2022 17:00;199;89;110;Leichter Regenschauer;19;19;0.4;Stadt Konstanz, Amt für Stadtplanung und Umwelt
19.08.2022 18:00;205;92;113;Leichter Regenschauer;18;18;0.5;Stadt Konstanz, Amt für Stadtplanung und Umwelt
19.08.2022 19:00;191;83;108;Leichter Regenschauer;17;17;0.3;Stadt Konstanz, Amt für Stadtplanung und Umwelt
19.08.2022 20:00;167;73;94;Leicht bewoelkt;16;16;0;Stadt Konstanz, Amt für Stadtplanung und Umwelt
19.08.2022 21:00;169;93;76;Leicht bewoelkt;16;16;0;Stadt Konstanz, Amt für Stadtplanung und Umwelt
19.08.2022 22:00;103;48;55;Leicht bewoelkt;15;15;0;Stadt Konstanz, Amt für Stadtplanung und Umwelt
19.08.2022 23:00;106;51;55;Stellenweiser Regenfall;14;14;0;Stadt Konstanz, Amt für Stadtplanung und Umwelt
20.08.2022 00:00;75;24;51;Stellenweiser Regenfall;14;13;0.1;Stadt Konstanz, Amt für Stadtplanung und Umwelt
20.08.2022 01:00;44;16;28;Stellenweiser Regenfall;13;13;0;Stadt Konstanz, Amt für Stadtplanung und Umwelt
20.08.2022 02:00;41;16;25;Leichter Regenschauer;13;14;0.1;Stadt Konstanz, Amt für Stadtplanung und Umwelt
20.08.2022 03:00;20;7;13;Leichter Regenschauer;13;14;0.1;Stadt Konstanz, Amt für Stadtplanung und Umwelt
20.08.2022 04:00;23;11;12;Leichter Regenschauer;13;14;0.1;Stadt Konstanz, Amt für Stadtplanung und Umwelt
20.08.2022 05:00;29;16;13;Stellenweiser Regenfall;13;14;0.1;Stadt Konstanz, Amt für Stadtplanung und Umwelt
20.08.2022 06:00;39;22;17;Stellenweiser Regenfall;13;14;0.1;Stadt Konstanz, Amt für Stadtplanung und Umwelt
20.08.2022 07:00;72;30;42;Stellenweiser Regenfall;15;15;0.1;Stadt Konstanz, Amt für Stadtplanung und Umwelt
20.08.2022 08:00;161;80;81;Stellenweiser Regenfall;16;16;0.1;Stadt Konstanz, Amt für Stadtplanung und Umwelt
20.08.2022 09:00;364;185;179;Stellenweiser Regenfall;18;18;0.1;Stadt Konstanz, Amt für Stadtplanung und Umwelt
20.08.2022 10:00;474;272;202;Stellenweiser Regenfall;19;19;0;Stadt Konstanz, Amt für Stadtplanung und Umwelt
20.08.2022 11:00;451;236;215;Stellenweiser Regenfall;20;20;0.1;Stadt Konstanz, Amt für Stadtplanung und Umwelt
20.08.2022 12:00;454;232;222;Stellenweiser Regenfall;22;22;0.2;Stadt Konstanz, Amt für Stadtplanung und Umwelt
20.08.2022 13:00;417;211;206;Stellenweiser Regenfall;21;21;0.1;Stadt Konstanz, Amt für Stadtplanung und Umwelt
20.08.2022 14:00;450;208;242;Leichter Regenschauer;21;21;0.3;Stadt Konstanz, Amt für Stadtplanung und Umwelt
20.08.2022 15:00;412;212;200;Leichter Regenschauer;21;21;0.4;Stadt Konstanz, Amt für Stadtplanung und Umwelt
20.08.2022 16:00;335;120;215;Leichter Regenschauer;20;20;0.2;Stadt Konstanz, Amt für Stadtplanung und Umwelt
20.08.2022 17:00;309;145;164;Leichter Regenschauer;19;19;0.3;Stadt Konstanz, Amt für Stadtplanung und Umwelt
20.08.2022 18:00;356;163;193;Leichter Regenschauer;18;18;0.4;Stadt Konstanz, Amt für Stadtplanung und Umwelt
20.08.2022 19:00;313;161;152;Leichter Regenschauer;17;17;0.2;Stadt Konstanz, Amt für Stadtplanung und Umwelt
20.08.2022 20:00;257;129;128;Stellenweiser Regenfall;16;16;0.1;Stadt Konstanz, Amt für Stadtplanung und Umwelt
20.08.2022 21:00;195;95;100;Stellenweiser Regenfall;14;14;0.1;Stadt Konstanz, Amt für Stadtplanung und Umwelt
20.08.2022 22:00;161;67;94;Stellenweiser Regenfall;14;14;0;Stadt Konstanz, Amt für Stadtplanung und Umwelt
20.08.2022 23:00;159;80;79;Leicht bewoelkt;13;14;0;Stadt Konstanz, Amt für Stadtplanung und Umwelt
21.08.2022 00:00;113;49;64;Leicht bewoelkt;13;13;0;Stadt Konstanz, Amt für Stadtplanung und Umwelt
21.08.2022 01:00;92;37;55;Leicht bewoelkt;12;13;0;Stadt Konstanz, Amt für Stadtplanung und Umwelt
21.08.2022 02:00;72;18;54;Sonnig;12;12;0;Stadt Konstanz, Amt für Stadtplanung und Umwelt
21.08.2022 03:00;51;20;31;Sonnig;12;12;0;Stadt Konstanz, Amt für Stadtplanung und Umwelt
21.08.2022 04:00;29;10;19;Sonnig;11;11;0;Stadt Konstanz, Amt für Stadtplanung und Umwelt
21.08.2022 05:00;15;11;4;Sonnig;11;11;0;Stadt Konstanz, Amt für Stadtplanung und Umwelt
21.08.2022 06:00;40;26;14;Sonnig;11;11;0;Stadt Konstanz, Amt für Stadtplanung und Umwelt
21.08.2022 07:00;24;6;18;Sonnig;13;13;0;Stadt Konstanz, Amt für Stadtplanung und Umwelt
21.08.2022 08:00;93;43;50;Sonnig;16;16;0;Stadt Konstanz, Amt für Stadtplanung und Umwelt
21.08.2022 09:00;252;134;118;Sonnig;18;18;0;Stadt Konstanz, Amt für Stadtplanung und Umwelt
21.08.2022 10:00;319;153;166;Sonnig;20;20;0;Stadt Konstanz, Amt für Stadtplanung und Umwelt
21.08.2022 11:00;456;229;227;Sonnig;22;22;0;Stadt Konstanz, Amt für Stadtplanung und Umwelt
21.08.2022 12:00;557;279;278;Sonnig;24;25;0;Stadt Konstanz, Amt für Stadtplanung und Umwelt
21.08.2022 13:00;525;271;254;Sonnig;24;25;0;Stadt Konstanz, Amt für Stadtplanung und Umwelt
21.08.2022 14:00;557;284;273;Sonnig;25;26;0;Stadt Konstanz, Amt für Stadtplanung und Umwelt
21.08.2022 15:00;569;284;285;Sonnig;25;26;0;Stadt Konstanz, Amt für Stadtplanung und Umwelt
21.08.2022 16:00;527;266;261;Sonnig;24;25;0;Stadt Konstanz, Amt für Stadtplanung und Umwelt
21.08.2022 17:00;524;244;280;Sonnig;23;25;0;Stadt Konstanz, Amt für Stadtplanung und Umwelt
21.08.2022 18:00;521;282;239;Sonnig;23;25;0;Stadt Konstanz, Amt für Stadtplanung und Umwelt
21.08.2022 19:00;428;197;231;Sonnig;20;20;0;Stadt Konstanz, Amt für Stadtplanung und Umwelt
21.08.2022 20:00;324;172;152;Sonnig;17;17;0;Stadt Konstanz, Amt für Stadtplanung und Umwelt
21.08.2022 21:00;223;92;131;Sonnig;14;14;0;Stadt Konstanz, Amt für Stadtplanung und Umwelt
21.08.2022 22:00;142;53;89;Sonnig;14;14;0;Stadt Konstanz, Amt für Stadtplanung und Umwelt
21.08.2022 23:00;84;30;54;Sonnig;13;13;0;Stadt Konstanz, Amt für Stadtplanung und Umwelt
22.08.2022 00:00;32;10;22;Sonnig;12;13;0;Stadt Konstanz, Amt für Stadtplanung und Umwelt
22.08.2022 01:00;35;16;19;Sonnig;12;12;0;Stadt Konstanz, Amt für Stadtplanung und Umwelt
22.08.2022 02:00;5;2;3;Sonnig;12;12;0;Stadt Konstanz, Amt für Stadtplanung und Umwelt
22.08.2022 03:00;7;4;3;Sonnig;11;11;0;Stadt Konstanz, Amt für Stadtplanung und Umwelt
22.08.2022 04:00;14;9;5;Sonnig;11;11;0;Stadt Konstanz, Amt für Stadtplanung und Umwelt
22.08.2022 05:00;54;31;23;Sonnig;11;11;0;Stadt Konstanz, Amt für Stadtplanung und Umwelt
22.08.2022 06:00;167;96;71;Sonnig;11;11;0;Stadt Konstanz, Amt für Stadtplanung und Umwelt
22.08.2022 07:00;348;194;154;Sonnig;14;14;0;Stadt Konstanz, Amt für Stadtplanung und Umwelt
22.08.2022 08:00;438;266;172;Sonnig;16;16;0;Stadt Konstanz, Amt für Stadtplanung und Umwelt
22.08.2022 09:00;526;284;242;Sonnig;19;19;0;Stadt Konstanz, Amt für Stadtplanung und Umwelt
22.08.2022 10:00;589;308;281;Sonnig;20;20;0;Stadt Konstanz, Amt für Stadtplanung und Umwelt
22.08.2022 11:00;591;298;293;Sonnig;22;22;0;Stadt Konstanz, Amt für Stadtplanung und Umwelt
22.08.2022 12:00;594;281;313;Sonnig;23;25;0;Stadt Konstanz, Amt für Stadtplanung und Umwelt
22.08.2022 13:00;633;312;321;Sonnig;24;25;0;Stadt Konstanz, Amt für Stadtplanung und Umwelt
22.08.2022 14:00;694;378;316;Sonnig;24;25;0;Stadt Konstanz, Amt für Stadtplanung und Umwelt
22.08.2022 15:00;771;352;419;Sonnig;25;25;0;Stadt Konstanz, Amt für Stadtplanung und Umwelt
22.08.2022 16:00;853;425;428;Sonnig;24;25;0;Stadt Konstanz, Amt für Stadtplanung und Umwelt
22.08.2022 17:00;912;402;510;Sonnig;23;25;0;Stadt Konstanz, Amt für Stadtplanung und Umwelt
22.08.2022 18:00;873;428;445;Sonnig;22;22;0;Stadt Konstanz, Amt für Stadtplanung und Umwelt
22.08.2022 19:00;665;335;330;Sonnig;19;19;0;Stadt Konstanz, Amt für Stadtplanung und Umwelt
22.08.2022 20:00;503;217;286;Sonnig;17;17;0;Stadt Konstanz, Amt für Stadtplanung und Umwelt
22.08.2022 21:00;322;122;200;Sonnig;15;15;0;Stadt Konstanz, Amt für Stadtplanung und Umwelt
22.08.2022 22:00;246;90;156;Sonnig;14;14;0;Stadt Konstanz, Amt für Stadtplanung und Umwelt
22.08.2022 23:00;86;32;54;Sonnig;13;13;0;Stadt Konstanz, Amt für Stadtplanung und Umwelt
23.08.2022 00:00;45;16;29;Sonnig;13;13;0;Stadt Konstanz, Amt für Stadtplanung und Umwelt
23.08.2022 01:00;32;11;21;Sonnig;12;12;0;Stadt Konstanz, Amt für Stadtplanung und Umwelt
23.08.2022 02:00;11;6;5;Sonnig;12;12;0;Stadt Konstanz, Amt für Stadtplanung und Umwelt
23.08.2022 03:00;17;11;6;Sonnig;11;11;0;Stadt Konstanz, Amt für Stadtplanung und Umwelt
23.08.2022 04:00;15;9;6;Sonnig;11;11;0;Stadt Konstanz, Amt für Stadtplanung und Umwelt
23.08.2022 05:00;54;28;26;Sonnig;11;11;0;Stadt Konstanz, Amt für Stadtplanung und Umwelt
23.08.2022 06:00;168;98;70;Sonnig;11;11;0;Stadt Konstanz, Amt für Stadtplanung und Umwelt
23.08.2022 07:00;408;225;183;Sonnig;14;14;0;Stadt Konstanz, Amt für Stadtplanung und Umwelt
23.08.2022 08:00;537;318;219;Sonnig;17;17;0;Stadt Konstanz, Amt für Stadtplanung und Umwelt
23.08.2022 09:00;598;344;254;Sonnig;19;19;0;Stadt Konstanz, Amt für Stadtplanung und Umwelt
23.08.2022 10:00;602;324;278;Sonnig;21;21;0;Stadt Konstanz, Amt für Stadtplanung und Umwelt
23.08.2022 11:00;642;353;289;Sonnig;23;23;0;Stadt Konstanz, Amt für Stadtplanung und Umwelt
23.08.2022 12:00;662;298;364;Sonnig;24;25;0;Stadt Konstanz, Amt für Stadtplanung und Umwelt
23.08.2022 13:00;630;317;313;Sonnig;26;26;0;Stadt Konstanz, Amt für Stadtplanung und Umwelt
23.08.2022 14:00;678;330;348;Sonnig;27;27;0;Stadt Konstanz, Amt für Stadtplanung und Umwelt
23.08.2022 15:00;766;356;410;Sonnig;28;28;0;Stadt Konstanz, Amt für Stadtplanung und Umwelt
23.08.2022 16:00;779;374;405;Sonnig;27;27;0;Stadt Konstanz, Amt für Stadtplanung und Umwelt
23.08.2022 17:00;923;447;476;Sonnig;25;26;0;Stadt Konstanz, Amt für Stadtplanung und Umwelt
23.08.2022 18:00;801;372;429;Sonnig;24;25;0;Stadt Konstanz, Amt für Stadtplanung und Umwelt
23.08.2022 19:00;652;301;351;Sonnig;21;21;0;Stadt Konstanz, Amt für Stadtplanung und Umwelt
23.08.2022 20:00;492;216;276;Sonnig;18;18;0;Stadt Konstanz, Amt für Stadtplanung und Umwelt
23.08.2022 21:00;361;167;194;Sonnig;15;15;0;Stadt Konstanz, Amt für Stadtplanung und Umwelt
23.08.2022 22:00;245;92;153;Sonnig;14;14;0;Stadt Konstanz, Amt für Stadtplanung und Umwelt
23.08.2022 23:00;136;48;88;Sonnig;13;13;0;Stadt Konstanz, Amt für Stadtplanung und Umwelt
24.08.2022 00:00;73;28;45;Sonnig;12;12;0;Stadt Konstanz, Amt für Stadtplanung und Umwelt
24.08.2022 01:00;52;24;28;Sonnig;11;12;0;Stadt Konstanz, Amt für Stadtplanung und Umwelt
24.08.2022 02:00;25;7;18;Sonnig;11;11;0;Stadt Konstanz, Amt für Stadtplanung und Umwelt
24.08.2022 03:00;10;1;9;Sonnig;11;11;0;Stadt Konstanz, Amt für Stadtplanung und Umwelt
24.08.2022 04:00;17;9;8;Sonnig;10;11;0;Stadt Konstanz, Amt für Stadtplanung und Umwelt
24.08.2022 05:00;55;32;23;Sonnig;10;11;0;Stadt Konstanz, Amt für Stadtplanung und Umwelt
24.08.2022 06:00;199;116;83;Sonnig;10;10;0;Stadt Konstanz, Amt für Stadtplanung und Umwelt
24.08.2022 07:00;402;233;169;Sonnig;13;13;0;Stadt Konstanz, Amt für Stadtplanung und Umwelt
24.08.2022 08:00;481;296;185;Sonnig;16;16;0;Stadt Konstanz, Amt für Stadtplanung und Umwelt
24.08.2022 09:00;532;308;224;Sonnig;19;19;0;Stadt Konstanz, Amt für Stadtplanung und Umwelt
24.08.2022 10:00;559;287;272;Sonnig;20;20;0;Stadt Konstanz, Amt für Stadtplanung und Umwelt
24.08.2022 11:00;629;327;302;Sonnig;22;22;0;Stadt Konstanz, Amt für Stadtplanung und Umwelt
24.08.2022 12:00;693;320;373;Sonnig;23;25;0;Stadt Konstanz, Amt für Stadtplanung und Umwelt
24.08.2022 13:00;660;317;343;Sonnig;24;25;0;Stadt Konstanz, Amt für Stadtplanung und Umwelt
24.08.2022 14:00;744;347;397;Sonnig;25;26;0;Stadt Konstanz, Amt für Stadtplanung und Umwelt
24.08.2022 15:00;714;347;367;Sonnig;26;27;0;Stadt Konstanz, Amt für Stadtplanung und Umwelt
24.08.2022 16:00;771;381;390;Sonnig;25;26;0;Stadt Konstanz, Amt für Stadtplanung und Umwelt
24.08.2022 17:00;776;379;397;Sonnig;24;26;0;Stadt Konstanz, Amt für Stadtplanung und Umwelt
24.08.2022 18:00;855;421;434;Sonnig;23;25;0;Stadt Konstanz, Amt für Stadtplanung und Umwelt
24.08.2022 19:00;633;282;351;Sonnig;21;21;0;Stadt Konstanz, Amt für Stadtplanung und Umwelt
24.08.2022 20:00;449;186;263;Sonnig;18;18;0;Stadt Konstanz, Amt für Stadtplanung und Umwelt
24.08.2022 21:00;363;129;234;Sonnig;16;16;0;Stadt Konstanz, Amt für Stadtplanung und Umwelt
24.08.2022 22:00;261;109;152;Sonnig;15;15;0;Stadt Konstanz, Amt für Stadtplanung und Umwelt
24.08.2022 23:00;167;53;114;Sonnig;14;14;0;Stadt Konstanz, Amt für Stadtplanung und Umwelt
25.08.2022 00:00;80;23;57;Sonnig;13;14;0;Stadt Konstanz, Amt für Stadtplanung und Umwelt
25.08.2022 01:00;37;15;22;Sonnig;13;13;0;Stadt Konstanz, Amt für Stadtplanung und Umwelt
25.08.2022 02:00;12;5;7;Sonnig;13;13;0;Stadt Konstanz, Amt für Stadtplanung und Umwelt
25.08.2022 03:00;12;3;9;Sonnig;12;12;0;Stadt Konstanz, Amt für Stadtplanung und Umwelt
25.08.2022 04:00;12;7;5;Sonnig;12;12;0;Stadt Konstanz, Amt für Stadtplanung und Umwelt
25.08.2022 05:00;62;36;26;Sonnig;12;12;0;Stadt Konstanz, Amt für Stadtplanung und Umwelt
25.08.2022 06:00;168;99;69;Sonnig;12;12;0;Stadt Konstanz, Amt für Stadtplanung und Umwelt
25.08.2022 07:00;352;194;158;Sonnig;14;14;0;Stadt Konstanz, Amt für Stadtplanung und Umwelt
25.08.2022 08:00;476;275;201;Sonnig;17;17;0;Stadt Konstanz, Amt für Stadtplanung und Umwelt
25.08.2022 09:00;525;309;216;Sonnig;20;20;0;Stadt Konstanz, Amt für Stadtplanung und Umwelt
25.08.2022 10:00;617;312;305;Sonnig;21;21;0;Stadt Konstanz, Amt für Stadtplanung und Umwelt
25.08.2022 11:00;580;300;280;Sonnig;23;24;0;Stadt Konstanz, Amt für Stadtplanung und Umwelt
25.08.2022 12:00;644;309;335;Sonnig;25;26;0;Stadt Konstanz, Amt für Stadtplanung und Umwelt
25.08.2022 13:00;667;332;335;Sonnig;26;27;0;Stadt Konstanz, Amt für Stadtplanung und Umwelt
25.08.2022 14:00;708;343;365;Sonnig;28;28;0;Stadt Konstanz, Amt für Stadtplanung und Umwelt
25.08.2022 15:00;748;382;366;Sonnig;29;30;0;Stadt Konstanz, Amt für Stadtplanung und Umwelt
25.08.2022 16:00;795;380;415;Sonnig;27;28;0;Stadt Konstanz, Amt für Stadtplanung und Umwelt
25.08.2022 17:00;859;399;460;Sonnig;25;27;0;Stadt Konstanz, Amt für Stadtplanung und Umwelt
25.08.2022 18:00;840;383;457;Sonnig;24;25;0;Stadt Konstanz, Amt für Stadtplanung und Umwelt
25.08.2022 19:00;628;280;348;Sonnig;21;21;0;Stadt Konstanz, Amt für Stadtplanung und Umwelt
25.08.2022 20:00;494;219;275;Sonnig;19;19;0;Stadt Konstanz, Amt für Stadtplanung und Umwelt
25.08.2022 21:00;365;156;209;Sonnig;16;16;0;Stadt Konstanz, Amt für Stadtplanung und Umwelt
25.08.2022 22:00;268;95;173;Sonnig;16;16;0;Stadt Konstanz, Amt für Stadtplanung und Umwelt
25.08.2022 23:00;158;56;102;Sonnig;16;16;0;Stadt Konstanz, Amt für Stadtplanung und Umwelt
26.08.2022 00:00;84;28;56;Sonnig;15;15;0;Stadt Konstanz, Amt für Stadtplanung und Umwelt
26.08.2022 01:00;58;26;32;Sonnig;15;15;0;Stadt Konstanz, Amt für Stadtplanung und Umwelt
26.08.2022 02:00;18;9;9;Sonnig;15;15;0;Stadt Konstanz, Amt für Stadtplanung und Umwelt
26.08.2022 03:00;11;3;8;Sonnig;14;14;0;Stadt Konstanz, Amt für Stadtplanung und Umwelt
26.08.2022 04:00;20;12;8;Sonnig;14;14;0;Stadt Konstanz, Amt für Stadtplanung und Umwelt
26.08.2022 05:00;48;24;24;Sonnig;14;14;0;Stadt Konstanz, Amt für Stadtplanung und Umwelt
26.08.2022 06:00;145;82;63;Sonnig;14;14;0;Stadt Konstanz, Amt für Stadtplanung und Umwelt
26.08.2022 07:00;316;179;137;Sonnig;16;16;0;Stadt Konstanz, Amt für Stadtplanung und Umwelt
26.08.2022 08:00;417;258;159;Sonnig;19;19;0;Stadt Konstanz, Amt für Stadtplanung und Umwelt
26.08.2022 09:00;497;307;190;Sonnig;21;21;0;Stadt Konstanz, Amt für Stadtplanung und Umwelt
26.08.2022 10:00;565;291;274;Sonnig;24;26;0;Stadt Konstanz, Amt für Stadtplanung und Umwelt
26.08.2022 11:00;612;336;276;Sonnig;26;28;0;Stadt Konstanz, Amt für Stadtplanung und Umwelt
26.08.2022 12:00;718;311;407;Sonnig;29;30;0;Stadt Konstanz, Amt für Stadtplanung und Umwelt
26.08.2022 13:00;721;306;415;Sonnig;29;30;0;Stadt Konstanz, Amt für Stadtplanung und Umwelt
26.08.2022 14:00;649;327;322;Sonnig;30;31;0;Stadt Konstanz, Amt für Stadtplanung und Umwelt
26.08.2022 15:00;681;325;356;Sonnig;30;31;0;Stadt Konstanz, Amt für Stadtplanung und Umwelt
26.08.2022 16:00;661;328;333;Sonnig;28;29;0;Stadt Konstanz, Amt für Stadtplanung und Umwelt
26.08.2022 17:00;644;354;290;Sonnig;26;27;0;Stadt Konstanz, Amt für Stadtplanung und Umwelt
26.08.2022 18:00;669;284;385;Sonnig;24;25;0;Stadt Konstanz, Amt für Stadtplanung und Umwelt
26.08.2022 19:00;551;244;307;Sonnig;21;21;0;Stadt Konstanz, Amt für Stadtplanung und Umwelt
26.08.2022 20:00;329;141;188;Stellenweiser Regenfall;19;19;0.1;Stadt Konstanz, Amt für Stadtplanung und Umwelt
26.08.2022 21:00;173;69;104;Stellenweiser Regenfall;17;17;0.2;Stadt Konstanz, Amt für Stadtplanung und Umwelt
26.08.2022 22:00;109;37;72;Stellenweiser Regenfall;16;16;0.1;Stadt Konstanz, Amt für Stadtplanung und Umwelt
26.08.2022 23:00;93;31;62;Leichter Regenschauer;16;16;0.2;Stadt Konstanz, Amt für Stadtplanung und Umwelt
27.08.2022 00:00;45;11;34;Leichter Regenschauer;16;16;0.5;Stadt Konstanz, Amt für Stadtplanung und Umwelt
27.08.2022 01:00;25;12;13;Leichter Regenschauer;15;15;0.2;Stadt Konstanz, Amt für Stadtplanung und Umwelt
27.08.2022 02:00;28;10;18;Leichter Regenschauer;15;15;0.2;Stadt Konstanz, Amt für Stadtplanung und Umwelt
27.08.2022 03:00;26;12;14;Leichter Regenschauer;15;15;0.2;Stadt Konstanz, Amt für Stadtplanung und Umwelt
27.08.2022 04:00;14;12;2;Leichter Regenschauer;15;15;0.1;Stadt Konstanz, Amt für Stadtplanung und Umwelt
27.08.2022 05:00;39;12;27;Stellenweiser Regenfall;15;15;0.1;Stadt Konstanz, Amt für Stadtplanung und Umwelt
27.08.2022 06:00;36;23;13;Stellenweiser Regenfall;15;15;0.1;Stadt Konstanz, Amt für Stadtplanung und Umwelt
27.08.2022 07:00;50;23;27;Stellenweiser Regenfall;17;17;0;Stadt Konstanz, Amt für Stadtplanung und Umwelt
27.08.2022 08:00;124;67;57;Leicht bewoelkt;18;18;0;Stadt Konstanz, Amt für Stadtplanung und Umwelt
27.08.2022 09:00;251;156;95;Leicht bewoelkt;20;20;0;Stadt Konstanz, Amt für Stadtplanung und Umwelt
27.08.2022 10:00;312;195;117;Leicht bewoelkt;21;21;0;Stadt Konstanz, Amt für Stadtplanung und Umwelt
27.08.2022 11:00;372;204;168;Stellenweiser Regenfall;22;23;0.1;Stadt Konstanz, Amt für Stadtplanung und Umwelt
27.08.2022 12:00;394;216;178;Stellenweiser Regenfall;23;25;0.1;Stadt Konstanz, Amt für Stadtplanung und Umwelt
27.08.2022 13:00;417;210;207;Stellenweiser Regenfall;24;26;0.1;Stadt Konstanz, Amt für Stadtplanung und Umwelt
27.08.2022 14:00;448;203;245;Sonnig;25;26;0;Stadt Konstanz, Amt für Stadtplanung und Umwelt
27.08.2022 15:00;429;193;236;Sonnig;25;26;0;Stadt Konstanz, Amt für Stadtplanung und Umwelt
27.08.2022 16:00;453;197;256;Sonnig;23;24;0;Stadt Konstanz, Amt für Stadtplanung und Umwelt
27.08.2022 17:00;399;179;220;Stellenweiser Regenfall;21;21;0.1;Stadt Konstanz, Amt für Stadtplanung und Umwelt
27.08.2022 18:00;316;127;189;Stellenweiser Regenfall;20;20;0.2;Stadt Konstanz, Amt für Stadtplanung und Umwelt
27.08.2022 19:00;297;150;147;Stellenweiser Regenfall;18;18;0.1;Stadt Konstanz, Amt für Stadtplanung und Umwelt
27.08.2022 20:00;236;132;104;Stellenweiser Regenfall;17;17;0.1;Stadt Konstanz, Amt für Stadtplanung und Umwelt
27.08.2022 21:00;200;103;97;Stellenweiser Regenfall;16;16;0.1;Stadt Konstanz, Amt für Stadtplanung und Umwelt
27.08.2022 22:00;143;48;95;Stellenweiser Regenfall;15;15;0.1;Stadt Konstanz, Amt für Stadtplanung und Umwelt
27.08.2022 23:00;122;43;79;Stellenweiser Regenfall;15;15;0;Stadt Konstanz, Amt für Stadtplanung und Umwelt
28.08.2022 00:00;99;19;80;Stellenweiser Regenfall;14;14;0;Stadt Konstanz, Amt für Stadtplanung und Umwelt
28.08.2022 01:00;62;22;40;Stellenweiser Regenfall;14;14;0;Stadt Konstanz, Amt für Stadtplanung und Umwelt
28.08.2022 02:00;49;10;39;Leichter Nebel;14;14;0;Stadt Konstanz, Amt für Stadtplanung und Umwelt
28.08.2022 03:00;53;32;21;Leichter Nebel;14;14;0;Stadt Konstanz, Amt für Stadtplanung und Umwelt
28.08.2022 04:00;29;11;18;Leichter Nebel;13;13;0;Stadt Konstanz, Amt für Stadtplanung und Umwelt
28.08.2022 05:00;23;14;9;Leichter Nebel;13;13;0;Stadt Konstanz, Amt für Stadtplanung und Umwelt
28.08.2022 06:00;25;16;9;Leichter Nebel;13;13;0;Stadt Konstanz, Amt für Stadtplanung und Umwelt
28.08.2022 07:00;38;23;15;Leichter Nebel;15;15;0;Stadt Konstanz, Amt für Stadtplanung und Umwelt
28.08.2022 08:00;80;33;47;Bewoelkt;17;17;0;Stadt Konstanz, Amt für Stadtplanung und Umwelt
28.08.2022 09:00;211;108;103;Bewoelkt;19;19;0;Stadt Konstanz, Amt für Stadtplanung und Umwelt
28.08.2022 10:00;257;132;125;Bewoelkt;20;20;0;Stadt Konstanz, Amt für Stadtplanung und Umwelt
28.08.2022 11:00;326;141;185;Stellenweiser Regenfall;21;21;0;Stadt Konstanz, Amt für Stadtplanung und Umwelt
28.08.2022 12:00;344;179;165;Stellenweiser Regenfall;22;25;0;Stadt Konstanz, Amt für Stadtplanung und Umwelt
28.08.2022 13:00;451;209;242;Stellenweiser Regenfall;23;25;0;Stadt Konstanz, Amt für Stadtplanung und Umwelt
28.08.2022 14:00;462;241;221;Leicht bewoelkt;23;25;0;Stadt Konstanz, Amt für Stadtplanung und Umwelt
28.08.2022 15:00;468;236;232;Leicht bewoelkt;24;25;0;Stadt Konstanz, Amt für Stadtplanung und Umwelt
28.08.2022 16:00;493;242;251;Leicht bewoelkt;23;24;0;Stadt Konstanz, Amt für Stadtplanung und Umwelt
28.08.2022 17:00;499;208;291;Stellenweiser Regenfall;22;22;0;Stadt Konstanz, Amt für Stadtplanung und Umwelt
28.08.2022 18:00;416;202;214;Stellenweiser Regenfall;21;21;0;Stadt Konstanz, Amt für Stadtplanung und Umwelt
28.08.2022 19:00;397;192;205;Stellenweiser Regenfall;19;19;0;Stadt Konstanz, Amt für Stadtplanung und Umwelt
28.08.2022 20:00;309;123;186;Leicht bewoelkt;17;17;0;Stadt Konstanz, Amt für Stadtplanung und Umwelt
28.08.2022 21:00;218;80;138;Leicht bewoelkt;15;15;0;Stadt Konstanz, Amt für Stadtplanung und Umwelt
28.08.2022 22:00;125;56;69;Leicht bewoelkt;15;15;0;Stadt Konstanz, Amt für Stadtplanung und Umwelt
28.08.2022 23:00;75;29;46;Sonnig;14;14;0;Stadt Konstanz, Amt für Stadtplanung und Umwelt
29.08.2022 00:00;30;11;19;Sonnig;14;14;0;Stadt Konstanz, Amt für Stadtplanung und Umwelt
29.08.2022 01:00;15;10;5;Sonnig;14;14;0;Stadt Konstanz, Amt für Stadtplanung und Umwelt
29.08.2022 02:00;10;5;5;Sonnig;13;13;0;Stadt Konstanz, Amt für Stadtplanung und Umwelt
29.08.2022 03:00;5;3;2;Sonnig;13;13;0;Stadt Konstanz, Amt für Stadtplanung und Umwelt
29.08.2022 04:00;8;6;2;Sonnig;13;13;0;Stadt Konstanz, Amt für Stadtplanung und Umwelt
29.08.2022 05:00;48;32;16;Sonnig;14;14;0;Stadt Konstanz, Amt für Stadtplanung und Umwelt
29.08.2022 06:00;149;88;61;Sonnig;14;14;0;Stadt Konstanz, Amt für Stadtplanung und Umwelt
29.08.2022 07:00;407;237;170;Sonnig;16;16;0;Stadt Konstanz, Amt für Stadtplanung und Umwelt
29.08.2022 08:00;529;286;243;Sonnig;18;18;0;Stadt Konstanz, Amt für Stadtplanung und Umwelt
29.08.2022 09:00;483;281;202;Sonnig;19;19;0;Stadt Konstanz, Amt für Stadtplanung und Umwelt
29.08.2022 10:00;533;299;234;Sonnig;22;22;0;Stadt Konstanz, Amt für Stadtplanung und Umwelt
29.08.2022 11:00;567;290;277;Sonnig;24;26;0;Stadt Konstanz, Amt für Stadtplanung und Umwelt
29.08.2022 12:00;663;305;358;Sonnig;26;28;0;Stadt Konstanz, Amt für Stadtplanung und Umwelt
29.08.2022 13:00;609;306;303;Sonnig;27;28;0;Stadt Konstanz, Amt für Stadtplanung und Umwelt
29.08.2022 14:00;658;333;325;Sonnig;27;29;0;Stadt Konstanz, Amt für Stadtplanung und Umwelt
29.08.2022 15:00;677;317;360;Sonnig;28;29;0;Stadt Konstanz, Amt für Stadtplanung und Umwelt
29.08.2022 16:00;750;342;408;Sonnig;26;27;0;Stadt Konstanz, Amt für Stadtplanung und Umwelt
29.08.2022 17:00;898;418;480;Sonnig;24;25;0;Stadt Konstanz, Amt für Stadtplanung und Umwelt
29.08.2022 18:00;768;366;402;Sonnig;22;23;0;Stadt Konstanz, Amt für Stadtplanung und Umwelt
29.08.2022 19:00;577;292;285;Sonnig;21;21;0;Stadt Konstanz, Amt für Stadtplanung und Umwelt
29.08.2022 20:00;461;175;286;Sonnig;19;19;0;Stadt Konstanz, Amt für Stadtplanung und Umwelt
29.08.2022 21:00;296;122;174;Sonnig;17;17;0;Stadt Konstanz, Amt für Stadtplanung und Umwelt
29.08.2022 22:00;204;71;133;Sonnig;16;16;0;Stadt Konstanz, Amt für Stadtplanung und Umwelt
29.08.2022 23:00;110;32;78;Sonnig;16;16;0;Stadt Konstanz, Amt für Stadtplanung und Umwelt
30.08.2022 00:00;68;24;44;Sonnig;15;15;0;Stadt Konstanz, Amt für Stadtplanung und Umwelt
30.08.2022 01:00;22;10;12;Sonnig;15;15;0;Stadt Konstanz, Amt für Stadtplanung und Umwelt
30.08.2022 02:00;17;8;9;Sonnig;14;14;0;Stadt Konstanz, Amt für Stadtplanung und Umwelt
30.08.2022 03:00;6;5;1;Sonnig;14;14;0;Stadt Konstanz, Amt für Stadtplanung und Umwelt
30.08.2022 04:00;5;2;3;Sonnig;15;15;0;Stadt Konstanz, Amt für Stadtplanung und Umwelt
30.08.2022 05:00;46;30;16;Leicht bewoelkt;15;15;0;Stadt Konstanz, Amt für Stadtplanung und Umwelt
30.08.2022 06:00;178;116;62;Leicht bewoelkt;15;16;0;Stadt Konstanz, Amt für Stadtplanung und Umwelt
30.08.2022 07:00;409;231;178;Leicht bewoelkt;17;17;0;Stadt Konstanz, Amt für Stadtplanung und Umwelt
30.08.2022 08:00;572;332;240;Leicht bewoelkt;19;19;0;Stadt Konstanz, Amt für Stadtplanung und Umwelt
30.08.2022 09:00;646;372;274;Leicht bewoelkt;20;20;0;Stadt Konstanz, Amt für Stadtplanung und Umwelt
30.08.2022 10:00;583;306;277;Leicht bewoelkt;21;21;0;Stadt Konstanz, Amt für Stadtplanung und Umwelt
30.08.2022 11:00;599;305;294;Leicht bewoelkt;22;24;0;Stadt Konstanz, Amt für Stadtplanung und Umwelt
30.08.2022 12:00;672;290;382;Leicht bewoelkt;23;25;0;Stadt Konstanz, Amt für Stadtplanung und Umwelt
30.08.2022 13:00;689;326;363;Leicht bewoelkt;22;24;0;Stadt Konstanz, Amt für Stadtplanung und Umwelt
30.08.2022 14:00;655;333;322;Leicht bewoelkt;22;22;0.1;Stadt Konstanz, Amt für Stadtplanung und Umwelt
30.08.2022 15:00;702;328;374;Leicht bewoelkt;21;21;0.1;Stadt Konstanz, Amt für Stadtplanung und Umwelt
30.08.2022 16:00;852;418;434;Leicht bewoelkt;20;20;0;Stadt Konstanz, Amt für Stadtplanung und Umwelt
30.08.2022 17:00;862;419;443;Leichter Regenschauer;19;19;0;Stadt Konstanz, Amt für Stadtplanung und Umwelt
30.08.2022 18:00;793;339;454;Leichter Regenschauer;18;18;0;Stadt Konstanz, Amt für Stadtplanung und Umwelt
30.08.2022 19:00;624;286;338;Leichter Regenschauer;18;18;0;Stadt Konstanz, Amt für Stadtplanung und Umwelt
30.08.2022 20:00;435;183;252;Leicht bewoelkt;17;17;0;Stadt Konstanz, Amt für Stadtplanung und Umwelt
30.08.2022 21:00;270;102;168;Leicht bewoelkt;17;17;0;Stadt Konstanz, Amt für Stadtplanung und Umwelt
30.08.2022 22:00;181;51;130;Leicht bewoelkt;17;17;0;Stadt Konstanz, Amt für Stadtplanung und Umwelt
30.08.2022 23:00;88;30;58;Leicht bewoelkt;16;16;0;Stadt Konstanz, Amt für Stadtplanung und Umwelt
31.08.2022 00:00;54;12;42;Leicht bewoelkt;16;16;0;Stadt Konstanz, Amt für Stadtplanung und Umwelt
31.08.2022 01:00;35;14;21;Leicht bewoelkt;15;15;0;Stadt Konstanz, Amt für Stadtplanung und Umwelt
31.08.2022 02:00;19;7;12;Stellenweiser Regenfall;15;15;0.1;Stadt Konstanz, Amt für Stadtplanung und Umwelt
31.08.2022 03:00;7;5;2;Stellenweiser Regenfall;14;15;0.2;Stadt Konstanz, Amt für Stadtplanung und Umwelt
31.08.2022 04:00;9;7;2;Stellenweiser Regenfall;14;15;0.1;Stadt Konstanz, Amt für Stadtplanung und Umwelt
31.08.2022 05:00;44;28;16;Leichter Regenschauer;15;15;0.2;Stadt Konstanz, Amt für Stadtplanung und Umwelt
31.08.2022 06:00;90;51;39;Leichter Regenschauer;15;15;0.2;Stadt Konstanz, Amt für Stadtplanung und Umwelt
31.08.2022 07:00;217;104;113;Leichter Regenschauer;16;16;0.1;Stadt Konstanz, Amt für Stadtplanung und Umwelt
31.08.2022 08:00;316;168;148;Stellenweiser Regenfall;17;17;0;Stadt Konstanz, Amt für Stadtplanung und Umwelt
31.08.2022 09:00;298;182;116;Stellenweiser Regenfall;18;18;0;Stadt Konstanz, Amt für Stadtplanung und Umwelt
31.08.2022 10:00;186;104;82;Stellenweiser Regenfall;18;18;0;Stadt Konstanz, Amt für Stadtplanung und Umwelt
31.08.2022 11:00;259;129;130;Leichter Regenschauer;19;19;0.1;Stadt Konstanz, Amt für Stadtplanung und Umwelt
31.08.2022 12:00;335;167;168;Leichter Regenschauer;20;20;0.1;Stadt Konstanz, Amt für Stadtplanung und Umwelt
31.08.2022 13:00;375;214;161;Leichter Regenschauer;20;20;0.1;Stadt Konstanz, Amt für Stadtplanung und Umwelt
31.08.2022 14:00;411;203;208;Leichter Regenschauer;20;20;0.1;Stadt Konstanz, Amt für Stadtplanung und Umwelt
31.08.2022 15:00;452;253;199;Leichter Regenschauer;20;20;0.1;Stadt Konstanz, Amt für Stadtplanung und Umwelt
31.08.2022 16:00;573;287;286;Leichter Regenschauer;19;19;0;Stadt Konstanz, Amt für Stadtplanung und Umwelt
31.08.2022 17:00;611;271;340;Leichter Regenschauer;18;18;0.2;Stadt Konstanz, Amt für Stadtplanung und Umwelt
31.08.2022 18:00;617;280;337;Leichter Regenschauer;17;17;0.3;Stadt Konstanz, Amt für Stadtplanung und Umwelt
31.08.2022 19:00;478;213;265;Leichter Regenschauer;16;16;0.1;Stadt Konstanz, Amt für Stadtplanung und Umwelt
31.08.2022 20:00;311;132;179;Leichter Nebel;15;15;0;Stadt Konstanz, Amt für Stadtplanung und Umwelt
31.08.2022 21:00;206;80;126;Leichter Nebel;14;14;0;Stadt Konstanz, Amt für Stadtplanung und Umwelt
31.08.2022 22:00;156;67;89;Leichter Nebel;15;14;0;Stadt Konstanz, Amt für Stadtplanung und Umwelt
31.08.2022 23:00;94;49;45;Leichter Nebel;15;15;0;Stadt Konstanz, Amt für Stadtplanung und Umwelt
01.09.2022 00:00;61;22;39;Leichter Nebel;15;15;0.1;Stadt Konstanz, Amt für Stadtplanung und Umwelt
01.09.2022 01:00;43;15;28;Leichter Nebel;15;15;0;Stadt Konstanz, Amt für Stadtplanung und Umwelt
01.09.2022 02:00;15;4;11;Leichter Nebel;15;14;0;Stadt Konstanz, Amt für Stadtplanung und Umwelt
01.09.2022 03:00;7;2;5;Leichter Nebel;14;14;0;Stadt Konstanz, Amt für Stadtplanung und Umwelt
01.09.2022 04:00;11;7;4;Leichter Nebel;14;14;0;Stadt Konstanz, Amt für Stadtplanung und Umwelt
01.09.2022 05:00;60;40;20;Leicht bewoelkt;14;13;0;Stadt Konstanz, Amt für Stadtplanung und Umwelt
01.09.2022 06:00;180;108;72;Leicht bewoelkt;13;13;0;Stadt Konstanz, Amt für Stadtplanung und Umwelt
01.09.2022 07:00;394;204;190;Leicht bewoelkt;14;14;0;Stadt Konstanz, Amt für Stadtplanung und Umwelt
01.09.2022 08:00;598;347;251;Bewoelkt;16;15;0;Stadt Konstanz, Amt für Stadtplanung und Umwelt
01.09.2022 09:00;472;293;179;Bewoelkt;17;17;0;Stadt Konstanz, Amt für Stadtplanung und Umwelt
01.09.2022 10:00;544;332;212;Bewoelkt;18;18;0;Stadt Konstanz, Amt für Stadtplanung und Umwelt
01.09.2022 11:00;559;298;261;Leicht bewoelkt;19;19;0;Stadt Konstanz, Amt für Stadtplanung und Umwelt
01.09.2022 12:00;621;286;335;Leicht bewoelkt;20;20;0;Stadt Konstanz, Amt für Stadtplanung und Umwelt
01.09.2022 13:00;628;314;314;Leicht bewoelkt;21;21;0;Stadt Konstanz, Amt für Stadtplanung und Umwelt
01.09.2022 14:00;643;340;303;Sonnig;21;21;0;Stadt Konstanz, Amt für Stadtplanung und Umwelt
01.09.2022 15:00;744;378;366;Sonnig;22;22;0;Stadt Konstanz, Amt für Stadtplanung und Umwelt
01.09.2022 16:00;839;429;410;Sonnig;21;21;0;Stadt Konstanz, Amt für Stadtplanung und Umwelt
01.09.2022 17:00;889;381;508;Sonnig;20;20;0;Stadt Konstanz, Amt für Stadtplanung und Umwelt
01.09.2022 18:00;842;347;495;Sonnig;19;19;0;Stadt Konstanz, Amt für Stadtplanung und Umwelt
01.09.2022 19:00;567;252;315;Sonnig;18;18;0;Stadt Konstanz, Amt für Stadtplanung und Umwelt
01.09.2022 20:00;395;169;226;Sonnig;16;16;0;Stadt Konstanz, Amt für Stadtplanung und Umwelt
01.09.2022 21:00;281;131;150;Sonnig;15;14;0;Stadt Konstanz, Amt für Stadtplanung und Umwelt
01.09.2022 22:00;257;99;158;Sonnig;13;13;0;Stadt Konstanz, Amt für Stadtplanung und Umwelt
01.09.2022 23:00;132;60;72;Sonnig;12;12;0;Stadt Konstanz, Amt für Stadtplanung und Umwelt
02.09.2022 00:00;66;30;36;Sonnig;10;10;0;Stadt Konstanz, Amt für Stadtplanung und Umwelt
02.09.2022 01:00;48;16;32;Sonnig;10;10;0;Stadt Konstanz, Amt für Stadtplanung und Umwelt
02.09.2022 02:00;22;7;15;Sonnig;9;9;0;Stadt Konstanz, Amt für Stadtplanung und Umwelt
02.09.2022 03:00;11;7;4;Sonnig;9;9;0;Stadt Konstanz, Amt für Stadtplanung und Umwelt
02.09.2022 04:00;7;3;4;Sonnig;8;8;0;Stadt Konstanz, Amt für Stadtplanung und Umwelt
02.09.2022 05:00;50;34;16;Leichter Nebel;8;8;0;Stadt Konstanz, Amt für Stadtplanung und Umwelt
02.09.2022 06:00;169;98;71;Leichter Nebel;8;8;0;Stadt Konstanz, Amt für Stadtplanung und Umwelt
02.09.2022 07:00;331;201;130;Leichter Nebel;11;11;0;Stadt Konstanz, Amt für Stadtplanung und Umwelt
02.09.2022 08:00;606;341;265;Sonnig;14;14;0;Stadt Konstanz, Amt für Stadtplanung und Umwelt
02.09.2022 09:00;511;316;195;Sonnig;16;16;0;Stadt Konstanz, Amt für Stadtplanung und Umwelt
02.09.2022 10:00;603;346;257;Sonnig;18;18;0;Stadt Konstanz, Amt für Stadtplanung und Umwelt
02.09.2022 11:00;643;333;310;Sonnig;20;20;0;Stadt Konstanz, Amt für Stadtplanung und Umwelt
02.09.2022 12:00;738;332;406;Sonnig;22;22;0;Stadt Konstanz, Amt für Stadtplanung und Umwelt
02.09.2022 13:00;772;356;416;Sonnig;22;25;0;Stadt Konstanz, Amt für Stadtplanung und Umwelt
02.09.2022 14:00;753;409;344;Stellenweise Gewitter und Niederschlaege;23;25;0;Stadt Konstanz, Amt für Stadtplanung und Umwelt
02.09.2022 15:00;803;408;395;Stellenweise Gewitter und Niederschlaege;23;25;0;Stadt Konstanz, Amt für Stadtplanung und Umwelt
02.09.2022 16:00;810;403;407;Stellenweise Gewitter und Niederschlaege;22;23;0;Stadt Konstanz, Amt für Stadtplanung und Umwelt
02.09.2022 17:00;895;441;454;Sonnig;21;21;0;Stadt Konstanz, Amt für Stadtplanung und Umwelt
02.09.2022 18:00;767;419;348;Sonnig;20;20;0;Stadt Konstanz, Amt für Stadtplanung und Umwelt
02.09.2022 19:00;664;380;284;Sonnig;18;18;0;Stadt Konstanz, Amt für Stadtplanung und Umwelt
02.09.2022 20:00;477;244;233;Leicht bewoelkt;17;17;0;Stadt Konstanz, Amt für Stadtplanung und Umwelt
02.09.2022 21:00;349;139;210;Leicht bewoelkt;15;15;0;Stadt Konstanz, Amt für Stadtplanung und Umwelt
02.09.2022 22:00;312;75;237;Leicht bewoelkt;14;15;0;Stadt Konstanz, Amt für Stadtplanung und Umwelt
02.09.2022 23:00;247;42;205;Leicht bewoelkt;14;14;0;Stadt Konstanz, Amt für Stadtplanung und Umwelt
03.09.2022 00:00;154;28;126;Leicht bewoelkt;14;14;0;Stadt Konstanz, Amt für Stadtplanung und Umwelt
03.09.2022 01:00;112;21;91;Leicht bewoelkt;14;14;0;Stadt Konstanz, Amt für Stadtplanung und Umwelt
03.09.2022 02:00;66;16;50;Leicht bewoelkt;13;13;0;Stadt Konstanz, Amt für Stadtplanung und Umwelt
03.09.2022 03:00;56;10;46;Leicht bewoelkt;13;13;0;Stadt Konstanz, Amt für Stadtplanung und Umwelt
03.09.2022 04:00;31;18;13;Leicht bewoelkt;13;13;0;Stadt Konstanz, Amt für Stadtplanung und Umwelt
03.09.2022 05:00;31;19;12;Sonnig;13;13;0;Stadt Konstanz, Amt für Stadtplanung und Umwelt
03.09.2022 06:00;49;30;19;Sonnig;14;14;0;Stadt Konstanz, Amt für Stadtplanung und Umwelt
03.09.2022 07:00;53;24;29;Sonnig;15;15;0;Stadt Konstanz, Amt für Stadtplanung und Umwelt
03.09.2022 08:00;120;67;53;Sonnig;17;17;0;Stadt Konstanz, Amt für Stadtplanung und Umwelt
03.09.2022 09:00;258;159;99;Sonnig;19;19;0;Stadt Konstanz, Amt für Stadtplanung und Umwelt
03.09.2022 10:00;403;243;160;Sonnig;21;21;0;Stadt Konstanz, Amt für Stadtplanung und Umwelt
03.09.2022 11:00;507;310;197;Stellenweise Gewitter und Niederschlaege;22;23;0;Stadt Konstanz, Amt für Stadtplanung und Umwelt
03.09.2022 12:00;480;240;240;Stellenweise Gewitter und Niederschlaege;24;25;0;Stadt Konstanz, Amt für Stadtplanung und Umwelt
03.09.2022 13:00;424;197;227;Stellenweise Gewitter und Niederschlaege;25;26;0;Stadt Konstanz, Amt für Stadtplanung und Umwelt
03.09.2022 14:00;495;237;258;Stellenweiser Regenfall;25;26;0;Stadt Konstanz, Amt für Stadtplanung und Umwelt
03.09.2022 15:00;607;295;312;Stellenweiser Regenfall;26;26;0;Stadt Konstanz, Amt für Stadtplanung und Umwelt
03.09.2022 16:00;594;273;321;Stellenweiser Regenfall;24;24;0;Stadt Konstanz, Amt für Stadtplanung und Umwelt
03.09.2022 17:00;599;280;319;Stellenweise Gewitter und Niederschlaege;22;22;0;Stadt Konstanz, Amt für Stadtplanung und Umwelt
03.09.2022 18:00;520;225;295;Stellenweise Gewitter und Niederschlaege;20;20;0;Stadt Konstanz, Amt für Stadtplanung und Umwelt
03.09.2022 19:00;445;157;288;Stellenweise Gewitter und Niederschlaege;18;18;0;Stadt Konstanz, Amt für Stadtplanung und Umwelt
03.09.2022 20:00;340;161;179;Stellenweiser Regenfall;16;16;0.3;Stadt Konstanz, Amt für Stadtplanung und Umwelt
03.09.2022 21:00;239;123;116;Stellenweiser Regenfall;14;14;0.4;Stadt Konstanz, Amt für Stadtplanung und Umwelt
03.09.2022 22:00;140;63;77;Stellenweiser Regenfall;13;13;0.2;Stadt Konstanz, Amt für Stadtplanung und Umwelt
03.09.2022 23:00;216;120;96;Teilweise maessiger Regenfall;13;13;0.2;Stadt Konstanz, Amt für Stadtplanung und Umwelt
04.09.2022 00:00;147;53;94;Teilweise maessiger Regenfall;12;12;0.3;Stadt Konstanz, Amt für Stadtplanung und Umwelt
04.09.2022 01:00;118;38;80;Teilweise maessiger Regenfall;12;12;0.1;Stadt Konstanz, Amt für Stadtplanung und Umwelt
04.09.2022 02:00;54;21;33;Sonnig;12;12;0;Stadt Konstanz, Amt für Stadtplanung und Umwelt
04.09.2022 03:00;39;13;26;Sonnig;11;11;0;Stadt Konstanz, Amt für Stadtplanung und Umwelt
04.09.2022 04:00;32;20;12;Sonnig;11;11;0;Stadt Konstanz, Amt für Stadtplanung und Umwelt
04.09.2022 05:00;18;10;8;Leicht bewoelkt;11;11;0;Stadt Konstanz, Amt für Stadtplanung und Umwelt
04.09.2022 06:00;31;22;9;Leicht bewoelkt;11;11;0;Stadt Konstanz, Amt für Stadtplanung und Umwelt
04.09.2022 07:00;49;23;26;Leicht bewoelkt;13;13;0;Stadt Konstanz, Amt für Stadtplanung und Umwelt
04.09.2022 08:00;93;49;44;Sonnig;16;16;0;Stadt Konstanz, Amt für Stadtplanung und Umwelt
04.09.2022 09:00;196;107;89;Sonnig;18;18;0;Stadt Konstanz, Amt für Stadtplanung und Umwelt
04.09.2022 10:00;320;182;138;Sonnig;20;20;0;Stadt Konstanz, Amt für Stadtplanung und Umwelt
04.09.2022 11:00;443;233;210;Sonnig;22;22;0;Stadt Konstanz, Amt für Stadtplanung und Umwelt
04.09.2022 12:00;545;260;285;Sonnig;24;25;0;Stadt Konstanz, Amt für Stadtplanung und Umwelt
04.09.2022 13:00;605;328;277;Sonnig;25;26;0;Stadt Konstanz, Amt für Stadtplanung und Umwelt
04.09.2022 14:00;679;347;332;Sonnig;25;26;0;Stadt Konstanz, Amt für Stadtplanung und Umwelt
04.09.2022 15:00;642;343;299;Sonnig;26;27;0;Stadt Konstanz, Amt für Stadtplanung und Umwelt
04.09.2022 16:00;645;325;320;Sonnig;25;26;0;Stadt Konstanz, Amt für Stadtplanung und Umwelt
04.09.2022 17:00;673;321;352;Sonnig;23;25;0;Stadt Konstanz, Amt für Stadtplanung und Umwelt
04.09.2022 18:00;580;263;317;Sonnig;22;25;0;Stadt Konstanz, Amt für Stadtplanung und Umwelt
04.09.2022 19:00;507;226;281;Sonnig;20;20;0;Stadt Konstanz, Amt für Stadtplanung und Umwelt
04.09.2022 20:00;378;169;209;Sonnig;18;18;0;Stadt Konstanz, Amt für Stadtplanung und Umwelt
04.09.2022 21:00;178;73;105;Sonnig;15;15;0;Stadt Konstanz, Amt für Stadtplanung und Umwelt
04.09.2022 22:00;137;58;79;Sonnig;15;15;0;Stadt Konstanz, Amt für Stadtplanung und Umwelt
04.09.2022 23:00;80;33;47;Sonnig;14;14;0;Stadt Konstanz, Amt für Stadtplanung und Umwelt
05.09.2022 00:00;51;21;30;Sonnig;14;14;0;Stadt Konstanz, Amt für Stadtplanung und Umwelt
05.09.2022 01:00;18;6;12;Sonnig;13;14;0;Stadt Konstanz, Amt für Stadtplanung und Umwelt
05.09.2022 02:00;6;4;2;Sonnig;13;14;0;Stadt Konstanz, Amt für Stadtplanung und Umwelt
05.09.2022 03:00;11;2;9;Sonnig;13;14;0;Stadt Konstanz, Amt für Stadtplanung und Umwelt
05.09.2022 04:00;18;16;2;Sonnig;13;13;0;Stadt Konstanz, Amt für Stadtplanung und Umwelt
05.09.2022 05:00;50;34;16;Sonnig;13;13;0;Stadt Konstanz, Amt für Stadtplanung und Umwelt
05.09.2022 06:00;180;114;66;Sonnig;13;13;0;Stadt Konstanz, Amt für Stadtplanung und Umwelt
05.09.2022 07:00;469;274;195;Sonnig;15;15;0;Stadt Konstanz, Amt für Stadtplanung und Umwelt
05.09.2022 08:00;668;360;308;Sonnig;17;17;0;Stadt Konstanz, Amt für Stadtplanung und Umwelt
05.09.2022 09:00;531;327;204;Sonnig;20;20;0;Stadt Konstanz, Amt für Stadtplanung und Umwelt
05.09.2022 10:00;599;320;279;Sonnig;22;22;0;Stadt Konstanz, Amt für Stadtplanung und Umwelt
05.09.2022 11:00;667;337;330;Sonnig;23;24;0;Stadt Konstanz, Amt für Stadtplanung und Umwelt
05.09.2022 12:00;695;316;379;Sonnig;25;26;0;Stadt Konstanz, Amt für Stadtplanung und Umwelt
05.09.2022 13:00;728;357;371;Sonnig;26;27;0;Stadt Konstanz, Amt für Stadtplanung und Umwelt
05.09.2022 14:00;743;396;347;Sonnig;27;28;0;Stadt Konstanz, Amt für Stadtplanung und Umwelt
05.09.2022 15:00;770;360;410;Sonnig;28;29;0;Stadt Konstanz, Amt für Stadtplanung und Umwelt
05.09.2022 16:00;921;455;466;Sonnig;26;28;0;Stadt Konstanz, Amt für Stadtplanung und Umwelt
05.09.2022 17:00;988;449;539;Sonnig;24;26;0;Stadt Konstanz, Amt für Stadtplanung und Umwelt
05.09.2022 18:00;849;378;471;Sonnig;22;22;0;Stadt Konstanz, Amt für Stadtplanung und Umwelt
05.09.2022 19:00;672;310;362;Sonnig;20;20;0;Stadt Konstanz, Amt für Stadtplanung und Umwelt
05.09.2022 20:00;481;194;287;Sonnig;18;18;0;Stadt Konstanz, Amt für Stadtplanung und Umwelt
05.09.2022 21:00;270;114;156;Sonnig;16;16;0;Stadt Konstanz, Amt für Stadtplanung und Umwelt
05.09.2022 22:00;197;84;113;Sonnig;16;16;0;Stadt Konstanz, Amt für Stadtplanung und Umwelt
05.09.2022 23:00;90;35;55;Sonnig;15;15;0;Stadt Konstanz, Amt für Stadtplanung und Umwelt
06.09.2022 00:00;55;16;39;Sonnig;15;15;0;Stadt Konstanz, Amt für Stadtplanung und Umwelt
06.09.2022 01:00;26;13;13;Sonnig;14;14;0;Stadt Konstanz, Amt für Stadtplanung und Umwelt
06.09.2022 02:00;15;9;6;Leicht bewoelkt;14;14;0;Stadt Konstanz, Amt für Stadtplanung und Umwelt
06.09.2022 03:00;9;6;3;Leicht bewoelkt;14;14;0;Stadt Konstanz, Amt für Stadtplanung und Umwelt
06.09.2022 04:00;22;14;8;Leicht bewoelkt;14;14;0;Stadt Konstanz, Amt für Stadtplanung und Umwelt
06.09.2022 05:00;66;45;21;Leichter Regenschauer;14;14;0.1;Stadt Konstanz, Amt für Stadtplanung und Umwelt
06.09.2022 06:00;189;112;77;Leichter Regenschauer;14;14;0.1;Stadt Konstanz, Amt für Stadtplanung und Umwelt
06.09.2022 07:00;490;269;221;Leichter Regenschauer;16;16;0.1;Stadt Konstanz, Amt für Stadtplanung und Umwelt
06.09.2022 08:00;728;386;342;Stellenweiser Regenfall;18;18;0;Stadt Konstanz, Amt für Stadtplanung und Umwelt
06.09.2022 09:00;643;395;248;Stellenweiser Regenfall;20;20;0;Stadt Konstanz, Amt für Stadtplanung und Umwelt
06.09.2022 10:00;641;360;281;Stellenweiser Regenfall;23;23;0;Stadt Konstanz, Amt für Stadtplanung und Umwelt
06.09.2022 11:00;620;312;308;Sonnig;25;26;0;Stadt Konstanz, Amt für Stadtplanung und Umwelt
06.09.2022 12:00;564;270;294;Sonnig;28;29;0;Stadt Konstanz, Amt für Stadtplanung und Umwelt
06.09.2022 13:00;690;354;336;Sonnig;29;30;0;Stadt Konstanz, Amt für Stadtplanung und Umwelt
06.09.2022 14:00;681;331;350;Sonnig;29;30;0;Stadt Konstanz, Amt für Stadtplanung und Umwelt
06.09.2022 15:00;696;351;345;Sonnig;29;30;0;Stadt Konstanz, Amt für Stadtplanung und Umwelt
06.09.2022 16:00;738;332;406;Sonnig;27;28;0;Stadt Konstanz, Amt für Stadtplanung und Umwelt
06.09.2022 17:00;858;393;465;Sonnig;25;27;0;Stadt Konstanz, Amt für Stadtplanung und Umwelt
06.09.2022 18:00;686;288;398;Sonnig;22;25;0;Stadt Konstanz, Amt für Stadtplanung und Umwelt
06.09.2022 19:00;499;227;272;Sonnig;21;21;0;Stadt Konstanz, Amt für Stadtplanung und Umwelt
06.09.2022 20:00;370;147;223;Sonnig;19;19;0;Stadt Konstanz, Amt für Stadtplanung und Umwelt
06.09.2022 21:00;236;103;133;Sonnig;17;17;0;Stadt Konstanz, Amt für Stadtplanung und Umwelt
06.09.2022 22:00;204;89;115;Sonnig;16;17;0;Stadt Konstanz, Amt für Stadtplanung und Umwelt
06.09.2022 23:00;84;32;52;Sonnig;16;16;0;Stadt Konstanz, Amt für Stadtplanung und Umwelt
07.09.2022 00:00;43;16;27;Sonnig;15;16;0;Stadt Konstanz, Amt für Stadtplanung und Umwelt
07.09.2022 01:00;27;14;13;Sonnig;15;15;0;Stadt Konstanz, Amt für Stadtplanung und Umwelt
07.09.2022 02:00;12;5;7;Stellenweiser Regenfall;14;15;0;Stadt Konstanz, Amt für Stadtplanung und Umwelt
07.09.2022 03:00;8;5;3;Stellenweiser Regenfall;14;15;0;Stadt Konstanz, Amt für Stadtplanung und Umwelt
07.09.2022 04:00;17;15;2;Stellenweiser Regenfall;14;15;0;Stadt Konstanz, Amt für Stadtplanung und Umwelt
07.09.2022 05:00;65;40;25;Leichter Regenschauer;14;15;0.2;Stadt Konstanz, Amt für Stadtplanung und Umwelt
07.09.2022 06:00;191;116;75;Leichter Regenschauer;14;15;0.2;Stadt Konstanz, Amt für Stadtplanung und Umwelt
07.09.2022 07:00;439;249;190;Leichter Regenschauer;15;16;0.1;Stadt Konstanz, Amt für Stadtplanung und Umwelt
07.09.2022 08:00;730;398;332;Bedeckt;17;17;0;Stadt Konstanz, Amt für Stadtplanung und Umwelt
07.09.2022 09:00;605;376;229;Bedeckt;18;18;0;Stadt Konstanz, Amt für Stadtplanung und Umwelt
07.09.2022 10:00;591;331;260;Bedeckt;18;18;0;Stadt Konstanz, Amt für Stadtplanung und Umwelt
07.09.2022 11:00;663;353;310;Stellenweiser Regenfall;19;19;0;Stadt Konstanz, Amt für Stadtplanung und Umwelt
07.09.2022 12:00;689;313;376;Stellenweiser Regenfall;19;19;0;Stadt Konstanz, Amt für Stadtplanung und Umwelt
07.09.2022 13:00;739;363;376;Stellenweiser Regenfall;21;21;0;Stadt Konstanz, Amt für Stadtplanung und Umwelt
07.09.2022 14:00;742;359;383;Sonnig;23;23;0;Stadt Konstanz, Amt für Stadtplanung und Umwelt
07.09.2022 15:00;812;417;395;Sonnig;25;26;0;Stadt Konstanz, Amt für Stadtplanung und Umwelt
07.09.2022 16:00;972;487;485;Sonnig;23;24;0;Stadt Konstanz, Amt für Stadtplanung und Umwelt
07.09.2022 17:00;972;419;553;Sonnig;21;21;0;Stadt Konstanz, Amt für Stadtplanung und Umwelt
07.09.2022 18:00;886;358;528;Sonnig;20;20;0;Stadt Konstanz, Amt für Stadtplanung und Umwelt
07.09.2022 19:00;656;292;364;Sonnig;18;18;0;Stadt Konstanz, Amt für Stadtplanung und Umwelt
07.09.2022 20:00;470;186;284;Sonnig;17;17;0;Stadt Konstanz, Amt für Stadtplanung und Umwelt
07.09.2022 21:00;165;56;109;Sonnig;15;15;0;Stadt Konstanz, Amt für Stadtplanung und Umwelt
07.09.2022 22:00;174;70;104;Sonnig;15;15;0;Stadt Konstanz, Amt für Stadtplanung und Umwelt
07.09.2022 23:00;108;46;62;Leichter Regenschauer;15;15;0.1;Stadt Konstanz, Amt für Stadtplanung und Umwelt
08.09.2022 00:00;43;23;20;Leichter Regenschauer;15;15;0.2;Stadt Konstanz, Amt für Stadtplanung und Umwelt
08.09.2022 01:00;39;9;30;Leichter Regenschauer;16;16;0.1;Stadt Konstanz, Amt für Stadtplanung und Umwelt
08.09.2022 02:00;16;8;8;Leichter Nebel;16;16;0;Stadt Konstanz, Amt für Stadtplanung und Umwelt
08.09.2022 03:00;8;3;5;Leichter Nebel;16;16;0;Stadt Konstanz, Amt für Stadtplanung und Umwelt
08.09.2022 04:00;8;5;3;Leichter Nebel;16;16;0;Stadt Konstanz, Amt für Stadtplanung und Umwelt
08.09.2022 05:00;49;33;16;Leichter Regenschauer;16;16;0.6;Stadt Konstanz, Amt für Stadtplanung und Umwelt
08.09.2022 06:00;105;56;49;Leichter Regenschauer;16;16;0.8;Stadt Konstanz, Amt für Stadtplanung und Umwelt
08.09.2022 07:00;226;126;100;Leichter Regenschauer;16;16;0.4;Stadt Konstanz, Amt für Stadtplanung und Umwelt
08.09.2022 08:00;484;270;214;Leicht bewoelkt;16;16;0;Stadt Konstanz, Amt für Stadtplanung und Umwelt
08.09.2022 09:00;400;225;175;Leicht bewoelkt;16;16;0;Stadt Konstanz, Amt für Stadtplanung und Umwelt
08.09.2022 10:00;408;218;190;Leicht bewoelkt;18;18;0;Stadt Konstanz, Amt für Stadtplanung und Umwelt
08.09.2022 11:00;440;210;230;Stellenweiser Regenfall;19;19;0.1;Stadt Konstanz, Amt für Stadtplanung und Umwelt
08.09.2022 12:00;485;258;227;Stellenweiser Regenfall;20;20;0.2;Stadt Konstanz, Amt für Stadtplanung und Umwelt
08.09.2022 13:00;581;263;318;Stellenweiser Regenfall;21;21;0.1;Stadt Konstanz, Amt für Stadtplanung und Umwelt
08.09.2022 14:00;558;275;283;Stellenweiser Regenfall;22;22;0;Stadt Konstanz, Amt für Stadtplanung und Umwelt
08.09.2022 15:00;659;319;340;Stellenweiser Regenfall;23;25;0;Stadt Konstanz, Amt für Stadtplanung und Umwelt
08.09.2022 16:00;701;374;327;Stellenweiser Regenfall;21;21;0;Stadt Konstanz, Amt für Stadtplanung und Umwelt
08.09.2022 17:00;811;356;455;Stellenweiser Regenfall;19;19;0;Stadt Konstanz, Amt für Stadtplanung und Umwelt
08.09.2022 18:00;733;334;399;Stellenweiser Regenfall;17;17;0;Stadt Konstanz, Amt für Stadtplanung und Umwelt
08.09.2022 19:00;532;216;316;Stellenweiser Regenfall;15;16;0;Stadt Konstanz, Amt für Stadtplanung und Umwelt
08.09.2022 20:00;437;203;234;Stellenweiser Regenfall;14;14;0.1;Stadt Konstanz, Amt für Stadtplanung und Umwelt
08.09.2022 21:00;237;102;135;Stellenweiser Regenfall;12;13;0.1;Stadt Konstanz, Amt für Stadtplanung und Umwelt
08.09.2022 22:00;258;85;173;Stellenweiser Regenfall;12;12;0.1;Stadt Konstanz, Amt für Stadtplanung und Umwelt
08.09.2022 23:00;142;38;104;Sonnig;12;12;0;Stadt Konstanz, Amt für Stadtplanung und Umwelt
09.09.2022 00:00;73;21;52;Sonnig;11;11;0;Stadt Konstanz, Amt für Stadtplanung und Umwelt
09.09.2022 01:00;70;24;46;Sonnig;11;11;0;Stadt Konstanz, Amt für Stadtplanung und Umwelt
09.09.2022 02:00;15;9;6;Sonnig;11;11;0;Stadt Konstanz, Amt für Stadtplanung und Umwelt
09.09.2022 03:00;6;3;3;Sonnig;11;11;0;Stadt Konstanz, Amt für Stadtplanung und Umwelt
09.09.2022 04:00;13;8;5;Sonnig;11;11;0;Stadt Konstanz, Amt für Stadtplanung und Umwelt
09.09.2022 05:00;41;24;17;Sonnig;11;12;0;Stadt Konstanz, Amt für Stadtplanung und Umwelt
09.09.2022 06:00;141;79;62;Sonnig;12;12;0;Stadt Konstanz, Amt für Stadtplanung und Umwelt
09.09.2022 07:00;323;193;130;Sonnig;13;13;0;Stadt Konstanz, Amt für Stadtplanung und Umwelt
09.09.2022 08:00;553;287;266;Stellenweise Gewitter und Niederschlaege;14;14;0;Stadt Konstanz, Amt für Stadtplanung und Umwelt
09.09.2022 09:00;483;306;177;Stellenweise Gewitter und Niederschlaege;15;15;0;Stadt Konstanz, Amt für Stadtplanung und Umwelt
09.09.2022 10:00;572;343;229;Stellenweise Gewitter und Niederschlaege;17;17;0;Stadt Konstanz, Amt für Stadtplanung und Umwelt
09.09.2022 11:00;597;314;283;Nieselregen mit Gewitter;18;18;0.1;Stadt Konstanz, Amt für Stadtplanung und Umwelt
09.09.2022 12:00;631;277;354;Nieselregen mit Gewitter;19;19;0.1;Stadt Konstanz, Amt für Stadtplanung und Umwelt
09.09.2022 13:00;737;326;411;Nieselregen mit Gewitter;19;19;0;Stadt Konstanz, Amt für Stadtplanung und Umwelt
09.09.2022 14:00;644;370;274;Nieselregen mit Gewitter;19;19;0.4;Stadt Konstanz, Amt für Stadtplanung und Umwelt
09.09.2022 15:00;693;359;334;Nieselregen mit Gewitter;18;18;0.5;Stadt Konstanz, Amt für Stadtplanung und Umwelt
09.09.2022 16:00;759;395;364;Nieselregen mit Gewitter;17;17;0.2;Stadt Konstanz, Amt für Stadtplanung und Umwelt
09.09.2022 17:00;769;369;400;Nieselregen mit Gewitter;16;16;0.4;Stadt Konstanz, Amt für Stadtplanung und Umwelt
09.09.2022 18:00;674;280;394;Nieselregen mit Gewitter;15;15;0.5;Stadt Konstanz, Amt für Stadtplanung und Umwelt
09.09.2022 19:00;567;269;298;Nieselregen mit Gewitter;13;13;0.3;Stadt Konstanz, Amt für Stadtplanung und Umwelt
09.09.2022 20:00;373;169;204;Leichter Regenschauer;12;12;0.1;Stadt Konstanz, Amt für Stadtplanung und Umwelt
09.09.2022 21:00;230;111;119;Leichter Regenschauer;11;11;0.1;Stadt Konstanz, Amt für Stadtplanung und Umwelt
09.09.2022 22:00;181;70;111;Leichter Regenschauer;11;11;0;Stadt Konstanz, Amt für Stadtplanung und Umwelt
09.09.2022 23:00;162;56;106;Leichter Regenschauer;11;10;0.2;Stadt Konstanz, Amt für Stadtplanung und Umwelt
10.09.2022 00:00;141;48;93;Leichter Regenschauer;11;10;0.4;Stadt Konstanz, Amt für Stadtplanung und Umwelt
10.09.2022 01:00;109;43;66;Leichter Regenschauer;10;10;0.2;Stadt Konstanz, Amt für Stadtplanung und Umwelt
10.09.2022 02:00;48;17;31;Stellenweiser Regenfall;10;9;0;Stadt Konstanz, Amt für Stadtplanung und Umwelt
10.09.2022 03:00;49;20;29;Stellenweiser Regenfall;9;9;0;Stadt Konstanz, Amt für Stadtplanung und Umwelt
10.09.2022 04:00;22;16;6;Stellenweiser Regenfall;10;9;0;Stadt Konstanz, Amt für Stadtplanung und Umwelt
10.09.2022 05:00;29;14;15;Stellenweiser Regenfall;10;9;0;Stadt Konstanz, Amt für Stadtplanung und Umwelt
10.09.2022 06:00;49;33;16;Stellenweiser Regenfall;10;9;0;Stadt Konstanz, Amt für Stadtplanung und Umwelt
10.09.2022 07:00;118;39;79;Stellenweiser Regenfall;12;11;0;Stadt Konstanz, Amt für Stadtplanung und Umwelt
10.09.2022 08:00;215;74;141;Bedeckt;13;13;0;Stadt Konstanz, Amt für Stadtplanung und Umwelt
10.09.2022 09:00;336;175;161;Bedeckt;15;15;0;Stadt Konstanz, Amt für Stadtplanung und Umwelt
10.09.2022 10:00;392;234;158;Bedeckt;16;16;0;Stadt Konstanz, Amt für Stadtplanung und Umwelt
10.09.2022 11:00;448;251;197;Leichter Regenschauer;16;16;0.1;Stadt Konstanz, Amt für Stadtplanung und Umwelt
10.09.2022 12:00;486;229;257;Leichter Regenschauer;17;17;0.1;Stadt Konstanz, Amt für Stadtplanung und Umwelt
10.09.2022 13:00;600;310;290;Leichter Regenschauer;18;18;0.1;Stadt Konstanz, Amt für Stadtplanung und Umwelt
10.09.2022 14:00;667;327;340;Leicht bewoelkt;19;19;0;Stadt Konstanz, Amt für Stadtplanung und Umwelt
10.09.2022 15:00;689;257;432;Leicht bewoelkt;20;20;0;Stadt Konstanz, Amt für Stadtplanung und Umwelt
10.09.2022 16:00;668;267;401;Leicht bewoelkt;19;19;0;Stadt Konstanz, Amt für Stadtplanung und Umwelt
10.09.2022 17:00;685;214;471;Stellenweiser Regenfall;17;17;0;Stadt Konstanz, Amt für Stadtplanung und Umwelt
10.09.2022 18:00;642;234;408;Stellenweiser Regenfall;16;16;0;Stadt Konstanz, Amt für Stadtplanung und Umwelt
10.09.2022 19:00;425;209;216;Stellenweiser Regenfall;15;14;0;Stadt Konstanz, Amt für Stadtplanung und Umwelt
10.09.2022 20:00;288;125;163;Leicht bewoelkt;13;13;0;Stadt Konstanz, Amt für Stadtplanung und Umwelt
10.09.2022 21:00;264;144;120;Leicht bewoelkt;11;11;0;Stadt Konstanz, Amt für Stadtplanung und Umwelt
10.09.2022 22:00;189;99;90;Leicht bewoelkt;11;11;0;Stadt Konstanz, Amt für Stadtplanung und Umwelt
10.09.2022 23:00;255;150;105;Stellenweiser Regenfall;11;11;0.1;Stadt Konstanz, Amt für Stadtplanung und Umwelt
11.09.2022 00:00;197;72;125;Stellenweiser Regenfall;11;11;0.2;Stadt Konstanz, Amt für Stadtplanung und Umwelt
11.09.2022 01:00;103;41;62;Stellenweiser Regenfall;11;11;0.1;Stadt Konstanz, Amt für Stadtplanung und Umwelt
11.09.2022 02:00;62;21;41;Leicht bewoelkt;11;11;0;Stadt Konstanz, Amt für Stadtplanung und Umwelt
11.09.2022 03:00;52;9;43;Leicht bewoelkt;10;10;0;Stadt Konstanz, Amt für Stadtplanung und Umwelt
11.09.2022 04:00;13;5;8;Leicht bewoelkt;10;10;0;Stadt Konstanz, Amt für Stadtplanung und Umwelt
11.09.2022 05:00;36;16;20;Leicht bewoelkt;10;10;0;Stadt Konstanz, Amt für Stadtplanung und Umwelt
11.09.2022 06:00;33;25;8;Leicht bewoelkt;10;10;0;Stadt Konstanz, Amt für Stadtplanung und Umwelt
11.09.2022 07:00;40;20;20;Leicht bewoelkt;12;12;0;Stadt Konstanz, Amt für Stadtplanung und Umwelt
11.09.2022 08:00;86;47;39;Leicht bewoelkt;13;13;0;Stadt Konstanz, Amt für Stadtplanung und Umwelt
11.09.2022 09:00;218;107;111;Leicht bewoelkt;15;15;0;Stadt Konstanz, Amt für Stadtplanung und Umwelt
11.09.2022 10:00;285;144;141;Leicht bewoelkt;16;16;0;Stadt Konstanz, Amt für Stadtplanung und Umwelt
11.09.2022 11:00;420;230;190;Sonnig;18;18;0;Stadt Konstanz, Amt für Stadtplanung und Umwelt
11.09.2022 12:00;449;194;255;Sonnig;20;20;0;Stadt Konstanz, Amt für Stadtplanung und Umwelt
11.09.2022 13:00;544;255;289;Sonnig;20;20;0;Stadt Konstanz, Amt für Stadtplanung und Umwelt
11.09.2022 14:00;632;335;297;Sonnig;21;21;0;Stadt Konstanz, Amt für Stadtplanung und Umwelt
11.09.2022 15:00;580;285;295;Sonnig;21;21;0;Stadt Konstanz, Amt für Stadtplanung und Umwelt
11.09.2022 16:00;610;338;272;Sonnig;20;20;0;Stadt Konstanz, Amt für Stadtplanung und Umwelt
11.09.2022 17:00;577;287;290;Sonnig;18;18;0;Stadt Konstanz, Amt für Stadtplanung und Umwelt
11.09.2022 18:00;559;240;319;Sonnig;17;17;0;Stadt Konstanz, Amt für Stadtplanung und Umwelt
11.09.2022 19:00;456;204;252;Sonnig;15;15;0;Stadt Konstanz, Amt für Stadtplanung und Umwelt
11.09.2022 20:00;272;121;151;Sonnig;13;13;0;Stadt Konstanz, Amt für Stadtplanung und Umwelt
11.09.2022 21:00;162;63;99;Sonnig;11;11;0;Stadt Konstanz, Amt für Stadtplanung und Umwelt
11.09.2022 22:00;124;48;76;Sonnig;11;10;0;Stadt Konstanz, Amt für Stadtplanung und Umwelt
11.09.2022 23:00;55;15;40;Sonnig;10;10;0;Stadt Konstanz, Amt für Stadtplanung und Umwelt
12.09.2022 00:00;18;5;13;Sonnig;9;9;0;Stadt Konstanz, Amt für Stadtplanung und Umwelt
12.09.2022 01:00;10;4;6;Sonnig;9;9;0;Stadt Konstanz, Amt für Stadtplanung und Umwelt
12.09.2022 02:00;7;1;6;Sonnig;9;9;0;Stadt Konstanz, Amt für Stadtplanung und Umwelt
12.09.2022 03:00;2;0;2;Sonnig;9;9;0;Stadt Konstanz, Amt für Stadtplanung und Umwelt
12.09.2022 04:00;12;9;3;Sonnig;8;8;0;Stadt Konstanz, Amt für Stadtplanung und Umwelt
12.09.2022 05:00;44;29;15;Sonnig;8;8;0;Stadt Konstanz, Amt für Stadtplanung und Umwelt
12.09.2022 06:00;195;120;75;Sonnig;8;8;0;Stadt Konstanz, Amt für Stadtplanung und Umwelt
12.09.2022 07:00;532;304;228;Sonnig;10;10;0;Stadt Konstanz, Amt für Stadtplanung und Umwelt
12.09.2022 08:00;953;521;432;Sonnig;13;13;0;Stadt Konstanz, Amt für Stadtplanung und Umwelt
12.09.2022 09:00;884;633;251;Sonnig;16;16;0;Stadt Konstanz, Amt für Stadtplanung und Umwelt
12.09.2022 10:00;540;302;238;Sonnig;18;18;0;Stadt Konstanz, Amt für Stadtplanung und Umwelt
12.09.2022 11:00;685;328;357;Sonnig;20;20;0;Stadt Konstanz, Amt für Stadtplanung und Umwelt
12.09.2022 12:00;908;466;442;Sonnig;22;25;0;Stadt Konstanz, Amt für Stadtplanung und Umwelt
12.09.2022 13:00;1150;443;707;Sonnig;23;25;0;Stadt Konstanz, Amt für Stadtplanung und Umwelt
12.09.2022 14:00;803;388;415;Sonnig;24;25;0;Stadt Konstanz, Amt für Stadtplanung und Umwelt
12.09.2022 15:00;928;459;469;Sonnig;24;25;0;Stadt Konstanz, Amt für Stadtplanung und Umwelt
12.09.2022 16:00;1044;498;546;Sonnig;23;23;0;Stadt Konstanz, Amt für Stadtplanung und Umwelt
12.09.2022 17:00;1191;529;662;Sonnig;21;21;0;Stadt Konstanz, Amt für Stadtplanung und Umwelt
12.09.2022 18:00;977;393;584;Sonnig;19;19;0;Stadt Konstanz, Amt für Stadtplanung und Umwelt
12.09.2022 19:00;640;259;381;Sonnig;17;17;0;Stadt Konstanz, Amt für Stadtplanung und Umwelt
12.09.2022 20:00;472;204;268;Sonnig;15;15;0;Stadt Konstanz, Amt für Stadtplanung und Umwelt
12.09.2022 21:00;262;118;144;Sonnig;12;13;0;Stadt Konstanz, Amt für Stadtplanung und Umwelt
12.09.2022 22:00;200;97;103;Sonnig;12;12;0;Stadt Konstanz, Amt für Stadtplanung und Umwelt
12.09.2022 23:00;87;38;49;Sonnig;12;12;0;Stadt Konstanz, Amt für Stadtplanung und Umwelt
13.09.2022 00:00;33;9;24;Sonnig;12;12;0;Stadt Konstanz, Amt für Stadtplanung und Umwelt
13.09.2022 01:00;18;6;12;Sonnig;11;11;0;Stadt Konstanz, Amt für Stadtplanung und Umwelt
13.09.2022 02:00;11;4;7;Sonnig;11;11;0;Stadt Konstanz, Amt für Stadtplanung und Umwelt
13.09.2022 03:00;6;1;5;Sonnig;11;11;0;Stadt Konstanz, Amt für Stadtplanung und Umwelt
13.09.2022 04:00;7;6;1;Sonnig;11;11;0;Stadt Konstanz, Amt für Stadtplanung und Umwelt
13.09.2022 05:00;51;38;13;Sonnig;11;11;0;Stadt Konstanz, Amt für Stadtplanung und Umwelt
13.09.2022 06:00;211;127;84;Sonnig;10;10;0;Stadt Konstanz, Amt für Stadtplanung und Umwelt
13.09.2022 07:00;1083;713;370;Sonnig;13;13;0;Stadt Konstanz, Amt für Stadtplanung und Umwelt
13.09.2022 08:00;848;479;369;Leicht bewoelkt;16;16;0;Stadt Konstanz, Amt für Stadtplanung und Umwelt
13.09.2022 09:00;782;455;327;Leicht bewoelkt;19;19;0;Stadt Konstanz, Amt für Stadtplanung und Umwelt
13.09.2022 10:00;643;378;265;Leicht bewoelkt;19;19;0;Stadt Konstanz, Amt für Stadtplanung und Umwelt
13.09.2022 11:00;754;362;392;Leicht bewoelkt;19;19;0;Stadt Konstanz, Amt für Stadtplanung und Umwelt
13.09.2022 12:00;823;382;441;Leicht bewoelkt;18;18;0;Stadt Konstanz, Amt für Stadtplanung und Umwelt
13.09.2022 13:00;1203;534;669;Leicht bewoelkt;19;19;0;Stadt Konstanz, Amt für Stadtplanung und Umwelt
13.09.2022 14:00;875;414;461;Leicht bewoelkt;20;20;0;Stadt Konstanz, Amt für Stadtplanung und Umwelt
13.09.2022 15:00;1158;495;663;Leicht bewoelkt;21;21;0;Stadt Konstanz, Amt für Stadtplanung und Umwelt
13.09.2022 16:00;1047;492;555;Leicht bewoelkt;20;20;0;Stadt Konstanz, Amt für Stadtplanung und Umwelt
13.09.2022 17:00;1152;514;638;Leicht bewoelkt;19;19;0;Stadt Konstanz, Amt für Stadtplanung und Umwelt
13.09.2022 18:00;949;410;539;Leicht bewoelkt;18;18;0;Stadt Konstanz, Amt für Stadtplanung und Umwelt
13.09.2022 19:00;708;354;354;Leicht bewoelkt;17;17;0;Stadt Konstanz, Amt für Stadtplanung und Umwelt
13.09.2022 20:00;451;164;287;Leicht bewoelkt;17;17;0;Stadt Konstanz, Amt für Stadtplanung und Umwelt
13.09.2022 21:00;242;87;155;Leicht bewoelkt;16;16;0;Stadt Konstanz, Amt für Stadtplanung und Umwelt
13.09.2022 22:00;222;78;144;Leicht bewoelkt;16;16;0;Stadt Konstanz, Amt für Stadtplanung und Umwelt
13.09.2022 23:00;151;74;77;Leicht bewoelkt;15;15;0;Stadt Konstanz, Amt für Stadtplanung und Umwelt
14.09.2022 00:00;50;25;25;Leicht bewoelkt;15;15;0;Stadt Konstanz, Amt für Stadtplanung und Umwelt
14.09.2022 01:00;24;14;10;Leicht bewoelkt;15;15;0;Stadt Konstanz, Amt für Stadtplanung und Umwelt
14.09.2022 02:00;8;2;6;Leicht bewoelkt;15;15;0;Stadt Konstanz, Amt für Stadtplanung und Umwelt
14.09.2022 03:00;3;1;2;Leicht bewoelkt;15;15;0;Stadt Konstanz, Amt für Stadtplanung und Umwelt
14.09.2022 04:00;13;8;5;Leicht bewoelkt;15;15;0;Stadt Konstanz, Amt für Stadtplanung und Umwelt
14.09.2022 05:00;44;28;16;Stellenweiser Regenfall;15;15;0;Stadt Konstanz, Amt für Stadtplanung und Umwelt
14.09.2022 06:00;185;111;74;Stellenweiser Regenfall;16;16;0;Stadt Konstanz, Amt für Stadtplanung und Umwelt
14.09.2022 07:00;1001;639;362;Stellenweiser Regenfall;16;16;0;Stadt Konstanz, Amt für Stadtplanung und Umwelt
14.09.2022 08:00;856;453;403;Bedeckt;16;16;0;Stadt Konstanz, Amt für Stadtplanung und Umwelt
14.09.2022 09:00;634;337;297;Bedeckt;17;17;0;Stadt Konstanz, Amt für Stadtplanung und Umwelt
14.09.2022 10:00;415;216;199;Bedeckt;18;18;0;Stadt Konstanz, Amt für Stadtplanung und Umwelt
14.09.2022 11:00;534;268;266;Stellenweiser Regenfall;19;19;0.2;Stadt Konstanz, Amt für Stadtplanung und Umwelt
14.09.2022 12:00;664;320;344;Stellenweiser Regenfall;21;21;0.3;Stadt Konstanz, Amt für Stadtplanung und Umwelt
14.09.2022 13:00;1067;469;598;Stellenweiser Regenfall;21;21;0.1;Stadt Konstanz, Amt für Stadtplanung und Umwelt
14.09.2022 14:00;644;328;316;Leicht bewoelkt;21;21;0;Stadt Konstanz, Amt für Stadtplanung und Umwelt
14.09.2022 15:00;846;345;501;Leicht bewoelkt;21;21;0;Stadt Konstanz, Amt für Stadtplanung und Umwelt
14.09.2022 16:00;800;373;427;Leicht bewoelkt;21;21;0;Stadt Konstanz, Amt für Stadtplanung und Umwelt
14.09.2022 17:00;913;437;476;Stellenweiser Regenfall;20;20;0.1;Stadt Konstanz, Amt für Stadtplanung und Umwelt
14.09.2022 18:00;832;346;486;Stellenweiser Regenfall;20;20;0.1;Stadt Konstanz, Amt für Stadtplanung und Umwelt
14.09.2022 19:00;519;240;279;Stellenweiser Regenfall;18;18;0;Stadt Konstanz, Amt für Stadtplanung und Umwelt
14.09.2022 20:00;391;158;233;Leichter Regenschauer;17;17;0.2;Stadt Konstanz, Amt für Stadtplanung und Umwelt
14.09.2022 21:00;252;94;158;Leichter Regenschauer;15;15;0.2;Stadt Konstanz, Amt für Stadtplanung und Umwelt
14.09.2022 22:00;187;87;100;Leichter Regenschauer;15;15;0.1;Stadt Konstanz, Amt für Stadtplanung und Umwelt
14.09.2022 23:00;96;40;56;Stellenweiser Regenfall;16;16;0.1;Stadt Konstanz, Amt für Stadtplanung und Umwelt
15.09.2022 00:00;48;5;43;Stellenweiser Regenfall;16;16;0.1;Stadt Konstanz, Amt für Stadtplanung und Umwelt
15.09.2022 01:00;34;5;29;Stellenweiser Regenfall;16;16;0.1;Stadt Konstanz, Amt für Stadtplanung und Umwelt
15.09.2022 02:00;15;2;13;Stellenweiser Regenfall;16;16;0.1;Stadt Konstanz, Amt für Stadtplanung und Umwelt
15.09.2022 03:00;3;2;1;Stellenweiser Regenfall;16;16;0.2;Stadt Konstanz, Amt für Stadtplanung und Umwelt
15.09.2022 04:00;6;6;0;Stellenweiser Regenfall;15;15;0.1;Stadt Konstanz, Amt für Stadtplanung und Umwelt
15.09.2022 05:00;39;28;11;Stellenweiser Regenfall;15;15;0.1;Stadt Konstanz, Amt für Stadtplanung und Umwelt
15.09.2022 06:00;170;101;69;Stellenweiser Regenfall;15;14;0.1;Stadt Konstanz, Amt für Stadtplanung und Umwelt
15.09.2022 07:00;978;604;374;Stellenweiser Regenfall;16;16;0;Stadt Konstanz, Amt für Stadtplanung und Umwelt
15.09.2022 08:00;671;342;329;Leicht bewoelkt;17;17;0;Stadt Konstanz, Amt für Stadtplanung und Umwelt
15.09.2022 09:00;649;374;275;Leicht bewoelkt;19;19;0;Stadt Konstanz, Amt für Stadtplanung und Umwelt
15.09.2022 10:00;409;232;177;Leicht bewoelkt;20;20;0;Stadt Konstanz, Amt für Stadtplanung und Umwelt
15.09.2022 11:00;439;204;235;Stellenweiser Regenfall;21;21;0.1;Stadt Konstanz, Amt für Stadtplanung und Umwelt
15.09.2022 12:00;523;242;281;Stellenweiser Regenfall;22;25;0.1;Stadt Konstanz, Amt für Stadtplanung und Umwelt
15.09.2022 13:00;906;403;503;Stellenweiser Regenfall;22;22;0.1;Stadt Konstanz, Amt für Stadtplanung und Umwelt
15.09.2022 14:00;500;229;271;Leicht bewoelkt;21;21;0;Stadt Konstanz, Amt für Stadtplanung und Umwelt
15.09.2022 15:00;599;274;325;Leicht bewoelkt;20;20;0;Stadt Konstanz, Amt für Stadtplanung und Umwelt
15.09.2022 16:00;637;267;370;Leicht bewoelkt;19;19;0;Stadt Konstanz, Amt für Stadtplanung und Umwelt
15.09.2022 17:00;708;307;401;Leichter Regenschauer;18;18;0.4;Stadt Konstanz, Amt für Stadtplanung und Umwelt
15.09.2022 18:00;603;251;352;Leichter Regenschauer;17;17;0.5;Stadt Konstanz, Amt für Stadtplanung und Umwelt
15.09.2022 19:00;375;149;226;Leichter Regenschauer;17;17;0.2;Stadt Konstanz, Amt für Stadtplanung und Umwelt
15.09.2022 20:00;278;127;151;Leichter Regenschauer;16;16;0.4;Stadt Konstanz, Amt für Stadtplanung und Umwelt
15.09.2022 21:00;201;108;93;Leichter Regenschauer;15;15;0.5;Stadt Konstanz, Amt für Stadtplanung und Umwelt
15.09.2022 22:00;154;65;89;Leichter Regenschauer;15;15;0.2;Stadt Konstanz, Amt für Stadtplanung und Umwelt
15.09.2022 23:00;97;39;58;Leichter Regenschauer;15;15;0.6;Stadt Konstanz, Amt für Stadtplanung und Umwelt
16.09.2022 00:00;60;18;42;Leichter Regenschauer;15;15;01. Mrz;Stadt Konstanz, Amt für Stadtplanung und Umwelt
16.09.2022 01:00;26;6;20;Leichter Regenschauer;14;15;0.6;Stadt Konstanz, Amt für Stadtplanung und Umwelt
16.09.2022 02:00;12;4;8;Leichter Regenschauer;14;14;0.5;Stadt Konstanz, Amt für Stadtplanung und Umwelt
16.09.2022 03:00;9;4;5;Leichter Regenschauer;14;14;0.7;Stadt Konstanz, Amt für Stadtplanung und Umwelt
16.09.2022 04:00;7;6;1;Leichter Regenschauer;13;14;0.3;Stadt Konstanz, Amt für Stadtplanung und Umwelt
16.09.2022 05:00;44;28;16;Leichter Regenschauer;13;13;0.3;Stadt Konstanz, Amt für Stadtplanung und Umwelt
16.09.2022 06:00;138;87;51;Leichter Regenschauer;12;13;0.4;Stadt Konstanz, Amt für Stadtplanung und Umwelt
16.09.2022 07:00;872;517;355;Leichter Regenschauer;13;13;0.2;Stadt Konstanz, Amt für Stadtplanung und Umwelt
16.09.2022 08:00;674;368;306;Stellenweiser Regenfall;14;14;0;Stadt Konstanz, Amt für Stadtplanung und Umwelt
16.09.2022 09:00;570;358;212;Stellenweiser Regenfall;15;15;0;Stadt Konstanz, Amt für Stadtplanung und Umwelt
16.09.2022 10:00;418;231;187;Stellenweiser Regenfall;16;16;0;Stadt Konstanz, Amt für Stadtplanung und Umwelt
16.09.2022 11:00;557;289;268;Stellenweiser Regenfall;18;18;0;Stadt Konstanz, Amt für Stadtplanung und Umwelt
16.09.2022 12:00;801;397;404;Stellenweiser Regenfall;19;19;0;Stadt Konstanz, Amt für Stadtplanung und Umwelt
16.09.2022 13:00;861;281;580;Stellenweiser Regenfall;19;19;0;Stadt Konstanz, Amt für Stadtplanung und Umwelt
16.09.2022 14:00;520;258;262;Leichter Regenschauer;19;19;0.1;Stadt Konstanz, Amt für Stadtplanung und Umwelt
16.09.2022 15:00;623;295;328;Leichter Regenschauer;19;19;0.1;Stadt Konstanz, Amt für Stadtplanung und Umwelt
16.09.2022 16:00;613;300;313;Leichter Regenschauer;17;17;0.1;Stadt Konstanz, Amt für Stadtplanung und Umwelt
16.09.2022 17:00;615;287;328;Leichter Regenschauer;15;15;0.3;Stadt Konstanz, Amt für Stadtplanung und Umwelt
16.09.2022 18:00;547;247;300;Leichter Regenschauer;14;13;0.4;Stadt Konstanz, Amt für Stadtplanung und Umwelt
16.09.2022 19:00;474;251;223;Leichter Regenschauer;13;12;0.2;Stadt Konstanz, Amt für Stadtplanung und Umwelt
16.09.2022 20:00;277;128;149;Maessiger Regenfall;12;12;01. Jan;Stadt Konstanz, Amt für Stadtplanung und Umwelt
16.09.2022 21:00;211;100;111;Maessiger Regenfall;11;11;01. Mai;Stadt Konstanz, Amt für Stadtplanung und Umwelt
16.09.2022 22:00;204;90;114;Maessiger Regenfall;10;10;0.7;Stadt Konstanz, Amt für Stadtplanung und Umwelt
16.09.2022 23:00;140;45;95;Leichter Regenschauer;10;9;0.4;Stadt Konstanz, Amt für Stadtplanung und Umwelt
17.09.2022 00:00;140;37;103;Leichter Regenschauer;9;8;0.7;Stadt Konstanz, Amt für Stadtplanung und Umwelt
17.09.2022 01:00;95;24;71;Leichter Regenschauer;9;8;0.4;Stadt Konstanz, Amt für Stadtplanung und Umwelt
17.09.2022 02:00;56;23;33;Leichter Regenschauer;9;9;0.1;Stadt Konstanz, Amt für Stadtplanung und Umwelt
17.09.2022 03:00;33;11;22;Leichter Regenschauer;9;9;0.1;Stadt Konstanz, Amt für Stadtplanung und Umwelt
17.09.2022 04:00;25;13;12;Leichter Regenschauer;9;8;0.1;Stadt Konstanz, Amt für Stadtplanung und Umwelt
17.09.2022 05:00;35;19;16;Leichter Regenschauer;8;7;0.1;Stadt Konstanz, Amt für Stadtplanung und Umwelt
17.09.2022 06:00;36;23;13;Leichter Regenschauer;8;7;0.1;Stadt Konstanz, Amt für Stadtplanung und Umwelt
17.09.2022 07:00;65;31;34;Leichter Regenschauer;9;8;0.1;Stadt Konstanz, Amt für Stadtplanung und Umwelt
17.09.2022 08:00;135;65;70;Leichter Regenschauer;9;8;0.2;Stadt Konstanz, Amt für Stadtplanung und Umwelt
17.09.2022 09:00;263;156;107;Leichter Regenschauer;10;9;0.2;Stadt Konstanz, Amt für Stadtplanung und Umwelt
17.09.2022 10:00;394;238;156;Leichter Regenschauer;10;10;0.1;Stadt Konstanz, Amt für Stadtplanung und Umwelt
17.09.2022 11:00;506;262;244;Leichter Regenschauer;11;10;0.2;Stadt Konstanz, Amt für Stadtplanung und Umwelt
17.09.2022 12:00;513;267;246;Leichter Regenschauer;11;11;0.3;Stadt Konstanz, Amt für Stadtplanung und Umwelt
17.09.2022 13:00;366;169;197;Leichter Regenschauer;11;10;0.1;Stadt Konstanz, Amt für Stadtplanung und Umwelt
17.09.2022 14:00;484;241;243;Leichter Regenschauer;11;10;0.2;Stadt Konstanz, Amt für Stadtplanung und Umwelt
17.09.2022 15:00;430;221;209;Leichter Regenschauer;11;10;0.3;Stadt Konstanz, Amt für Stadtplanung und Umwelt
17.09.2022 16:00;406;195;211;Leichter Regenschauer;10;9;0.1;Stadt Konstanz, Amt für Stadtplanung und Umwelt
17.09.2022 17:00;402;164;238;Leichter Regenschauer;10;9;0.3;Stadt Konstanz, Amt für Stadtplanung und Umwelt
17.09.2022 18:00;372;166;206;Leichter Regenschauer;9;8;0.4;Stadt Konstanz, Amt für Stadtplanung und Umwelt
17.09.2022 19:00;321;153;168;Leichter Regenschauer;9;8;0.2;Stadt Konstanz, Amt für Stadtplanung und Umwelt
17.09.2022 20:00;238;137;101;Nieselregen;8;7;0.1;Stadt Konstanz, Amt für Stadtplanung und Umwelt
17.09.2022 21:00;185;111;74;Nieselregen;8;7;0.1;Stadt Konstanz, Amt für Stadtplanung und Umwelt
17.09.2022 22:00;127;65;62;Nieselregen;7;5;0.1;Stadt Konstanz, Amt für Stadtplanung und Umwelt
17.09.2022 23:00;110;35;75;Stellenweiser Regenfall;6;4;0.1;Stadt Konstanz, Amt für Stadtplanung und Umwelt
18.09.2022 00:00;113;27;86;Stellenweiser Regenfall;5;3;0.2;Stadt Konstanz, Amt für Stadtplanung und Umwelt
18.09.2022 01:00;108;32;76;Stellenweiser Regenfall;5;3;0.1;Stadt Konstanz, Amt für Stadtplanung und Umwelt
18.09.2022 02:00;64;26;38;Stellenweiser Regenfall;5;3;0;Stadt Konstanz, Amt für Stadtplanung und Umwelt
18.09.2022 03:00;49;17;32;Stellenweiser Regenfall;5;3;0;Stadt Konstanz, Amt für Stadtplanung und Umwelt
18.09.2022 04:00;32;15;17;Stellenweiser Regenfall;5;3;0;Stadt Konstanz, Amt für Stadtplanung und Umwelt
18.09.2022 05:00;26;8;18;Stellenweiser Regenfall;5;3;0;Stadt Konstanz, Amt für Stadtplanung und Umwelt
18.09.2022 06:00;35;20;15;Stellenweiser Regenfall;5;3;0;Stadt Konstanz, Amt für Stadtplanung und Umwelt
18.09.2022 07:00;29;17;12;Stellenweiser Regenfall;6;4;0;Stadt Konstanz, Amt für Stadtplanung und Umwelt
18.09.2022 08:00;66;36;30;Bedeckt;7;5;0;Stadt Konstanz, Amt für Stadtplanung und Umwelt
18.09.2022 09:00;187;94;93;Bedeckt;8;7;0;Stadt Konstanz, Amt für Stadtplanung und Umwelt
18.09.2022 10:00;220;120;100;Bedeckt;9;8;0;Stadt Konstanz, Amt für Stadtplanung und Umwelt
18.09.2022 11:00;272;134;138;Bedeckt;11;9;0;Stadt Konstanz, Amt für Stadtplanung und Umwelt
18.09.2022 12:00;340;149;191;Bedeckt;12;10;0;Stadt Konstanz, Amt für Stadtplanung und Umwelt
18.09.2022 13:00;391;212;179;Bedeckt;12;10;0;Stadt Konstanz, Amt für Stadtplanung und Umwelt
18.09.2022 14:00;481;245;236;Leicht bewoelkt;13;11;0;Stadt Konstanz, Amt für Stadtplanung und Umwelt
18.09.2022 15:00;459;249;210;Leicht bewoelkt;13;11;0;Stadt Konstanz, Amt für Stadtplanung und Umwelt
18.09.2022 16:00;486;226;260;Leicht bewoelkt;13;11;0;Stadt Konstanz, Amt für Stadtplanung und Umwelt
18.09.2022 17:00;459;197;262;Stellenweiser Regenfall;12;11;0;Stadt Konstanz, Amt für Stadtplanung und Umwelt
18.09.2022 18:00;415;213;202;Stellenweiser Regenfall;12;10;0;Stadt Konstanz, Amt für Stadtplanung und Umwelt
18.09.2022 19:00;299;140;159;Stellenweiser Regenfall;11;9;0;Stadt Konstanz, Amt für Stadtplanung und Umwelt
18.09.2022 20:00;198;96;102;Stellenweiser Regenfall;10;8;0;Stadt Konstanz, Amt für Stadtplanung und Umwelt
18.09.2022 21:00;120;53;67;Stellenweiser Regenfall;8;7;0;Stadt Konstanz, Amt für Stadtplanung und Umwelt
18.09.2022 22:00;105;36;69;Stellenweiser Regenfall;8;7;0;Stadt Konstanz, Amt für Stadtplanung und Umwelt
18.09.2022 23:00;51;22;29;Stellenweiser Regenfall;8;7;0.1;Stadt Konstanz, Amt für Stadtplanung und Umwelt
19.09.2022 00:00;18;9;9;Stellenweiser Regenfall;8;6;0.1;Stadt Konstanz, Amt für Stadtplanung und Umwelt
19.09.2022 01:00;14;8;6;Stellenweiser Regenfall;7;6;0.1;Stadt Konstanz, Amt für Stadtplanung und Umwelt
19.09.2022 02:00;4;2;2;Leicht bewoelkt;6;5;0;Stadt Konstanz, Amt für Stadtplanung und Umwelt
19.09.2022 03:00;3;3;0;Leicht bewoelkt;5;5;0;Stadt Konstanz, Amt für Stadtplanung und Umwelt
19.09.2022 04:00;14;11;3;Leicht bewoelkt;5;5;0;Stadt Konstanz, Amt für Stadtplanung und Umwelt
19.09.2022 05:00;39;27;12;Stellenweiser Regenfall;5;5;0;Stadt Konstanz, Amt für Stadtplanung und Umwelt
19.09.2022 06:00;153;86;67;Stellenweiser Regenfall;4;4;0;Stadt Konstanz, Amt für Stadtplanung und Umwelt
19.09.2022 07:00;1032;652;380;Stellenweiser Regenfall;6;6;0;Stadt Konstanz, Amt für Stadtplanung und Umwelt
19.09.2022 08:00;719;410;309;Leicht bewoelkt;7;7;0;Stadt Konstanz, Amt für Stadtplanung und Umwelt
19.09.2022 09:00;614;330;284;Leicht bewoelkt;8;8;0;Stadt Konstanz, Amt für Stadtplanung und Umwelt
19.09.2022 10:00;485;276;209;Leicht bewoelkt;10;10;0;Stadt Konstanz, Amt für Stadtplanung und Umwelt
19.09.2022 11:00;525;262;263;Leicht bewoelkt;12;12;0;Stadt Konstanz, Amt für Stadtplanung und Umwelt
19.09.2022 12:00;731;381;350;Leicht bewoelkt;14;14;0;Stadt Konstanz, Amt für Stadtplanung und Umwelt
19.09.2022 13:00;871;381;490;Leicht bewoelkt;14;14;0;Stadt Konstanz, Amt für Stadtplanung und Umwelt
19.09.2022 14:00;769;395;374;Leicht bewoelkt;14;14;0;Stadt Konstanz, Amt für Stadtplanung und Umwelt
19.09.2022 15:00;1066;487;579;Leicht bewoelkt;14;14;0;Stadt Konstanz, Amt für Stadtplanung und Umwelt
19.09.2022 16:00;953;443;510;Leicht bewoelkt;13;13;0;Stadt Konstanz, Amt für Stadtplanung und Umwelt
19.09.2022 17:00;1022;461;561;Stellenweiser Regenfall;12;12;0.1;Stadt Konstanz, Amt für Stadtplanung und Umwelt
19.09.2022 18:00;791;344;447;Stellenweiser Regenfall;11;11;0.1;Stadt Konstanz, Amt für Stadtplanung und Umwelt
19.09.2022 19:00;607;272;335;Stellenweiser Regenfall;9;9;0;Stadt Konstanz, Amt für Stadtplanung und Umwelt
19.09.2022 20:00;433;161;272;Stellenweiser Regenfall;8;8;0;Stadt Konstanz, Amt für Stadtplanung und Umwelt
19.09.2022 21:00;276;97;179;Stellenweiser Regenfall;6;6;0;Stadt Konstanz, Amt für Stadtplanung und Umwelt
19.09.2022 22:00;169;59;110;Stellenweiser Regenfall;6;6;0;Stadt Konstanz, Amt für Stadtplanung und Umwelt
19.09.2022 23:00;86;32;54;Leicht bewoelkt;6;6;0;Stadt Konstanz, Amt für Stadtplanung und Umwelt
20.09.2022 00:00;31;17;14;Leicht bewoelkt;6;6;0;Stadt Konstanz, Amt für Stadtplanung und Umwelt
20.09.2022 01:00;11;4;7;Leicht bewoelkt;5;5;0;Stadt Konstanz, Amt für Stadtplanung und Umwelt
20.09.2022 02:00;7;5;2;Leicht bewoelkt;5;5;0;Stadt Konstanz, Amt für Stadtplanung und Umwelt
20.09.2022 03:00;8;6;2;Leicht bewoelkt;4;4;0;Stadt Konstanz, Amt für Stadtplanung und Umwelt
20.09.2022 04:00;14;9;5;Leicht bewoelkt;4;4;0;Stadt Konstanz, Amt für Stadtplanung und Umwelt
20.09.2022 05:00;59;34;25;Leicht bewoelkt;4;4;0;Stadt Konstanz, Amt für Stadtplanung und Umwelt
20.09.2022 06:00;188;115;73;Leicht bewoelkt;3;3;0;Stadt Konstanz, Amt für Stadtplanung und Umwelt
20.09.2022 07:00;1017;637;380;Leicht bewoelkt;5;5;0;Stadt Konstanz, Amt für Stadtplanung und Umwelt
20.09.2022 08:00;833;455;378;Leicht bewoelkt;8;8;0;Stadt Konstanz, Amt für Stadtplanung und Umwelt
20.09.2022 09:00;668;389;279;Leicht bewoelkt;10;10;0;Stadt Konstanz, Amt für Stadtplanung und Umwelt
20.09.2022 10:00;540;287;253;Leicht bewoelkt;11;10;0;Stadt Konstanz, Amt für Stadtplanung und Umwelt
20.09.2022 11:00;623;329;294;Leicht bewoelkt;11;11;0;Stadt Konstanz, Amt für Stadtplanung und Umwelt
20.09.2022 12:00;722;320;402;Leicht bewoelkt;12;11;0;Stadt Konstanz, Amt für Stadtplanung und Umwelt
20.09.2022 13:00;942;402;540;Leicht bewoelkt;12;12;0;Stadt Konstanz, Amt für Stadtplanung und Umwelt
20.09.2022 14:00;750;391;359;Bewoelkt;13;12;0;Stadt Konstanz, Amt für Stadtplanung und Umwelt
20.09.2022 15:00;1070;525;545;Bewoelkt;13;12;0;Stadt Konstanz, Amt für Stadtplanung und Umwelt
20.09.2022 16:00;989;443;546;Bewoelkt;12;11;0;Stadt Konstanz, Amt für Stadtplanung und Umwelt
20.09.2022 17:00;1058;513;545;Leicht bewoelkt;11;10;0;Stadt Konstanz, Amt für Stadtplanung und Umwelt
20.09.2022 18:00;844;378;466;Leicht bewoelkt;10;9;0;Stadt Konstanz, Amt für Stadtplanung und Umwelt
20.09.2022 19:00;611;290;321;Leicht bewoelkt;9;8;0;Stadt Konstanz, Amt für Stadtplanung und Umwelt
20.09.2022 20:00;404;192;212;Leicht bewoelkt;9;8;0;Stadt Konstanz, Amt für Stadtplanung und Umwelt
20.09.2022 21:00;239;98;141;Leicht bewoelkt;8;7;0;Stadt Konstanz, Amt für Stadtplanung und Umwelt
20.09.2022 22:00;161;60;101;Leicht bewoelkt;7;6;0;Stadt Konstanz, Amt für Stadtplanung und Umwelt
20.09.2022 23:00;87;28;59;Sonnig;6;5;0;Stadt Konstanz, Amt für Stadtplanung und Umwelt
21.09.2022 00:00;40;15;25;Sonnig;5;4;0;Stadt Konstanz, Amt für Stadtplanung und Umwelt
21.09.2022 01:00;24;5;19;Sonnig;4;3;0;Stadt Konstanz, Amt für Stadtplanung und Umwelt
21.09.2022 02:00;15;9;6;Sonnig;4;3;0;Stadt Konstanz, Amt für Stadtplanung und Umwelt
21.09.2022 03:00;7;5;2;Sonnig;4;3;0;Stadt Konstanz, Amt für Stadtplanung und Umwelt
21.09.2022 04:00;13;7;6;Sonnig;3;3;0;Stadt Konstanz, Amt für Stadtplanung und Umwelt
21.09.2022 05:00;57;35;22;Sonnig;3;3;0;Stadt Konstanz, Amt für Stadtplanung und Umwelt
21.09.2022 06:00;172;94;78;Sonnig;3;3;0;Stadt Konstanz, Amt für Stadtplanung und Umwelt
21.09.2022 07:00;1056;665;391;Sonnig;5;5;0;Stadt Konstanz, Amt für Stadtplanung und Umwelt
21.09.2022 08:00;734;394;340;Sonnig;8;7;0;Stadt Konstanz, Amt für Stadtplanung und Umwelt
21.09.2022 09:00;623;360;263;Sonnig;10;9;0;Stadt Konstanz, Amt für Stadtplanung und Umwelt
21.09.2022 10:00;457;237;220;Sonnig;12;11;0;Stadt Konstanz, Amt für Stadtplanung und Umwelt
21.09.2022 11:00;618;317;301;Leicht bewoelkt;13;12;0;Stadt Konstanz, Amt für Stadtplanung und Umwelt
21.09.2022 12:00;764;364;400;Leicht bewoelkt;15;14;0;Stadt Konstanz, Amt für Stadtplanung und Umwelt
21.09.2022 13:00;1146;488;658;Leicht bewoelkt;15;15;0;Stadt Konstanz, Amt für Stadtplanung und Umwelt
21.09.2022 14:00;760;388;372;Sonnig;16;15;0;Stadt Konstanz, Amt für Stadtplanung und Umwelt
21.09.2022 15:00;953;387;566;Sonnig;16;16;0;Stadt Konstanz, Amt für Stadtplanung und Umwelt
21.09.2022 16:00;977;490;487;Sonnig;15;14;0;Stadt Konstanz, Amt für Stadtplanung und Umwelt
21.09.2022 17:00;1100;479;621;Sonnig;13;12;0;Stadt Konstanz, Amt für Stadtplanung und Umwelt
21.09.2022 18:00;923;399;524;Sonnig;12;10;0;Stadt Konstanz, Amt für Stadtplanung und Umwelt
21.09.2022 19:00;644;314;330;Sonnig;10;8;0;Stadt Konstanz, Amt für Stadtplanung und Umwelt
21.09.2022 20:00;442;184;258;Sonnig;9;6;0;Stadt Konstanz, Amt für Stadtplanung und Umwelt
21.09.2022 21:00;280;105;175;Sonnig;7;5;0;Stadt Konstanz, Amt für Stadtplanung und Umwelt
21.09.2022 22:00;184;72;112;Sonnig;6;4;0;Stadt Konstanz, Amt für Stadtplanung und Umwelt
21.09.2022 23:00;98;36;62;Sonnig;6;4;0;Stadt Konstanz, Amt für Stadtplanung und Umwelt
22.09.2022 00:00;57;17;40;Sonnig;5;4;0;Stadt Konstanz, Amt für Stadtplanung und Umwelt
22.09.2022 01:00;30;15;15;Sonnig;4;3;0;Stadt Konstanz, Amt für Stadtplanung und Umwelt
22.09.2022 02:00;8;5;3;Sonnig;3;2;0;Stadt Konstanz, Amt für Stadtplanung und Umwelt
22.09.2022 03:00;0;0;0;Sonnig;3;2;0;Stadt Konstanz, Amt für Stadtplanung und Umwelt
22.09.2022 04:00;13;10;3;Sonnig;2;1;0;Stadt Konstanz, Amt für Stadtplanung und Umwelt
22.09.2022 05:00;51;29;22;Leichter Nebel;2;1;0;Stadt Konstanz, Amt für Stadtplanung und Umwelt
22.09.2022 06:00;180;107;73;Leichter Nebel;2;0;0;Stadt Konstanz, Amt für Stadtplanung und Umwelt
22.09.2022 07:00;958;588;370;Leichter Nebel;4;3;0;Stadt Konstanz, Amt für Stadtplanung und Umwelt
22.09.2022 08:00;776;421;355;Sonnig;7;6;0;Stadt Konstanz, Amt für Stadtplanung und Umwelt
22.09.2022 09:00;673;386;287;Sonnig;9;9;0;Stadt Konstanz, Amt für Stadtplanung und Umwelt
22.09.2022 10:00;474;273;201;Sonnig;11;11;0;Stadt Konstanz, Amt für Stadtplanung und Umwelt
22.09.2022 11:00;620;328;292;Sonnig;13;13;0;Stadt Konstanz, Amt für Stadtplanung und Umwelt
22.09.2022 12:00;698;318;380;Sonnig;15;15;0;Stadt Konstanz, Amt für Stadtplanung und Umwelt
22.09.2022 13:00;1031;455;576;Sonnig;15;15;0;Stadt Konstanz, Amt für Stadtplanung und Umwelt
22.09.2022 14:00;817;418;399;Leicht bewoelkt;16;16;0;Stadt Konstanz, Amt für Stadtplanung und Umwelt
22.09.2022 15:00;1129;505;624;Leicht bewoelkt;16;16;0;Stadt Konstanz, Amt für Stadtplanung und Umwelt
22.09.2022 16:00;1055;582;473;Leicht bewoelkt;15;14;0;Stadt Konstanz, Amt für Stadtplanung und Umwelt
22.09.2022 17:00;1169;500;669;Bedeckt;13;12;0;Stadt Konstanz, Amt für Stadtplanung und Umwelt
22.09.2022 18:00;914;401;513;Bedeckt;11;10;0;Stadt Konstanz, Amt für Stadtplanung und Umwelt
22.09.2022 19:00;685;306;379;Bedeckt;10;8;0;Stadt Konstanz, Amt für Stadtplanung und Umwelt
22.09.2022 20:00;378;156;222;Sonnig;8;7;0;Stadt Konstanz, Amt für Stadtplanung und Umwelt
22.09.2022 21:00;246;116;130;Sonnig;7;5;0;Stadt Konstanz, Amt für Stadtplanung und Umwelt
22.09.2022 22:00;201;78;123;Sonnig;6;5;0;Stadt Konstanz, Amt für Stadtplanung und Umwelt
22.09.2022 23:00;130;48;82;Sonnig;5;4;0;Stadt Konstanz, Amt für Stadtplanung und Umwelt
23.09.2022 00:00;64;22;42;Sonnig;4;4;0;Stadt Konstanz, Amt für Stadtplanung und Umwelt
23.09.2022 01:00;37;11;26;Sonnig;4;3;0;Stadt Konstanz, Amt für Stadtplanung und Umwelt
23.09.2022 02:00;16;3;13;Sonnig;3;3;0;Stadt Konstanz, Amt für Stadtplanung und Umwelt
23.09.2022 03:00;7;5;2;Sonnig;3;3;0;Stadt Konstanz, Amt für Stadtplanung und Umwelt
23.09.2022 04:00;11;4;7;Sonnig;2;2;0;Stadt Konstanz, Amt für Stadtplanung und Umwelt
23.09.2022 05:00;39;25;14;Sonnig;2;2;0;Stadt Konstanz, Amt für Stadtplanung und Umwelt
23.09.2022 06:00;163;103;60;Sonnig;2;2;0;Stadt Konstanz, Amt für Stadtplanung und Umwelt
23.09.2022 07:00;899;573;326;Sonnig;5;5;0;Stadt Konstanz, Amt für Stadtplanung und Umwelt
23.09.2022 08:00;730;408;322;Sonnig;7;7;0;Stadt Konstanz, Amt für Stadtplanung und Umwelt
23.09.2022 09:00;718;425;293;Sonnig;10;10;0;Stadt Konstanz, Amt für Stadtplanung und Umwelt
23.09.2022 10:00;586;328;258;Sonnig;13;13;0;Stadt Konstanz, Amt für Stadtplanung und Umwelt
23.09.2022 11:00;819;435;384;Sonnig;15;15;0;Stadt Konstanz, Amt für Stadtplanung und Umwelt
23.09.2022 12:00;901;405;496;Sonnig;18;18;0;Stadt Konstanz, Amt für Stadtplanung und Umwelt
23.09.2022 13:00;1099;421;678;Sonnig;18;18;0;Stadt Konstanz, Amt für Stadtplanung und Umwelt
23.09.2022 14:00;861;416;445;Sonnig;19;19;0;Stadt Konstanz, Amt für Stadtplanung und Umwelt
23.09.2022 15:00;905;434;471;Sonnig;20;20;0;Stadt Konstanz, Amt für Stadtplanung und Umwelt
23.09.2022 16:00;875;420;455;Sonnig;17;17;0;Stadt Konstanz, Amt für Stadtplanung und Umwelt
23.09.2022 17:00;893;398;495;Bewoelkt;14;14;0;Stadt Konstanz, Amt für Stadtplanung und Umwelt
23.09.2022 18:00;789;369;420;Bewoelkt;11;11;0;Stadt Konstanz, Amt für Stadtplanung und Umwelt
23.09.2022 19:00;636;320;316;Bewoelkt;10;10;0;Stadt Konstanz, Amt für Stadtplanung und Umwelt
23.09.2022 20:00;421;212;209;Sonnig;9;8;0;Stadt Konstanz, Amt für Stadtplanung und Umwelt
23.09.2022 21:00;324;158;166;Sonnig;8;7;0;Stadt Konstanz, Amt für Stadtplanung und Umwelt
23.09.2022 22:00;204;68;136;Sonnig;8;8;0;Stadt Konstanz, Amt für Stadtplanung und Umwelt
23.09.2022 23:00;198;55;143;Leicht bewoelkt;9;9;0;Stadt Konstanz, Amt für Stadtplanung und Umwelt
24.09.2022 00:00;129;35;94;Leicht bewoelkt;10;11;0;Stadt Konstanz, Amt für Stadtplanung und Umwelt
24.09.2022 01:00;104;23;81;Leicht bewoelkt;10;10;0;Stadt Konstanz, Amt für Stadtplanung und Umwelt
24.09.2022 02:00;89;28;61;Leicht bewoelkt;9;9;0;Stadt Konstanz, Amt für Stadtplanung und Umwelt
24.09.2022 03:00;43;11;32;Leicht bewoelkt;9;9;0;Stadt Konstanz, Amt für Stadtplanung und Umwelt
24.09.2022 04:00;26;10;16;Leicht bewoelkt;9;9;0;Stadt Konstanz, Amt für Stadtplanung und Umwelt
24.09.2022 05:00;32;19;13;Bedeckt;9;9;0;Stadt Konstanz, Amt für Stadtplanung und Umwelt
24.09.2022 06:00;44;28;16;Bedeckt;9;9;0;Stadt Konstanz, Amt für Stadtplanung und Umwelt
24.09.2022 07:00;74;43;31;Bedeckt;10;10;0;Stadt Konstanz, Amt für Stadtplanung und Umwelt
24.09.2022 08:00;150;77;73;Leichter Regenfall;10;10;0.3;Stadt Konstanz, Amt für Stadtplanung und Umwelt
24.09.2022 09:00;231;131;100;Leichter Regenfall;11;11;0.4;Stadt Konstanz, Amt für Stadtplanung und Umwelt
24.09.2022 10:00;318;185;133;Leichter Regenfall;11;11;0.2;Stadt Konstanz, Amt für Stadtplanung und Umwelt
24.09.2022 11:00;297;166;131;Stellenweiser Nieselregen;12;12;0.2;Stadt Konstanz, Amt für Stadtplanung und Umwelt
24.09.2022 12:00;327;159;168;Stellenweiser Nieselregen;12;12;0.3;Stadt Konstanz, Amt für Stadtplanung und Umwelt
24.09.2022 13:00;314;172;142;Stellenweiser Nieselregen;13;13;0.2;Stadt Konstanz, Amt für Stadtplanung und Umwelt
24.09.2022 14:00;382;191;191;Leicht bewoelkt;13;13;0;Stadt Konstanz, Amt für Stadtplanung und Umwelt
24.09.2022 15:00;377;190;187;Leicht bewoelkt;14;14;0;Stadt Konstanz, Amt für Stadtplanung und Umwelt
24.09.2022 16:00;328;138;190;Leicht bewoelkt;13;13;0;Stadt Konstanz, Amt für Stadtplanung und Umwelt
24.09.2022 17:00;323;163;160;Bewoelkt;12;12;0;Stadt Konstanz, Amt für Stadtplanung und Umwelt
24.09.2022 18:00;372;199;173;Bewoelkt;11;11;0;Stadt Konstanz, Amt für Stadtplanung und Umwelt
24.09.2022 19:00;324;154;170;Bewoelkt;11;11;0;Stadt Konstanz, Amt für Stadtplanung und Umwelt
24.09.2022 20:00;251;133;118;Leicht bewoelkt;11;11;0;Stadt Konstanz, Amt für Stadtplanung und Umwelt
24.09.2022 21:00;182;82;100;Leicht bewoelkt;11;11;0;Stadt Konstanz, Amt für Stadtplanung und Umwelt
24.09.2022 22:00;172;70;102;Leicht bewoelkt;10;10;0;Stadt Konstanz, Amt für Stadtplanung und Umwelt
24.09.2022 23:00;112;32;80;Bedeckt;10;10;0;Stadt Konstanz, Amt für Stadtplanung und Umwelt
25.09.2022 00:00;95;24;71;Bedeckt;9;9;0;Stadt Konstanz, Amt für Stadtplanung und Umwelt
25.09.2022 01:00;91;26;65;Bedeckt;9;9;0;Stadt Konstanz, Amt für Stadtplanung und Umwelt
25.09.2022 02:00;61;24;37;Leicht bewoelkt;9;9;0;Stadt Konstanz, Amt für Stadtplanung und Umwelt
25.09.2022 03:00;44;17;27;Leicht bewoelkt;9;9;0;Stadt Konstanz, Amt für Stadtplanung und Umwelt
25.09.2022 04:00;23;14;9;Leicht bewoelkt;9;9;0;Stadt Konstanz, Amt für Stadtplanung und Umwelt
25.09.2022 05:00;26;10;16;Leicht bewoelkt;9;9;0;Stadt Konstanz, Amt für Stadtplanung und Umwelt
25.09.2022 06:00;28;23;5;Leicht bewoelkt;9;9;0;Stadt Konstanz, Amt für Stadtplanung und Umwelt
25.09.2022 07:00;46;17;29;Leicht bewoelkt;10;10;0;Stadt Konstanz, Amt für Stadtplanung und Umwelt
25.09.2022 08:00;74;32;42;Sonnig;11;12;0;Stadt Konstanz, Amt für Stadtplanung und Umwelt
25.09.2022 09:00;185;100;85;Sonnig;13;13;0;Stadt Konstanz, Amt für Stadtplanung und Umwelt
25.09.2022 10:00;227;124;103;Sonnig;14;14;0;Stadt Konstanz, Amt für Stadtplanung und Umwelt
25.09.2022 11:00;316;188;128;Leicht bewoelkt;15;15;0;Stadt Konstanz, Amt für Stadtplanung und Umwelt
25.09.2022 12:00;329;189;140;Leicht bewoelkt;17;17;0;Stadt Konstanz, Amt für Stadtplanung und Umwelt
25.09.2022 13:00;356;186;170;Leicht bewoelkt;17;17;0;Stadt Konstanz, Amt für Stadtplanung und Umwelt
25.09.2022 14:00;370;175;195;Bewoelkt;17;17;0;Stadt Konstanz, Amt für Stadtplanung und Umwelt
25.09.2022 15:00;391;183;208;Bewoelkt;17;17;0;Stadt Konstanz, Amt für Stadtplanung und Umwelt
25.09.2022 16:00;415;175;240;Bewoelkt;15;15;0;Stadt Konstanz, Amt für Stadtplanung und Umwelt
25.09.2022 17:00;411;189;222;Leichter Regenschauer;14;14;0.1;Stadt Konstanz, Amt für Stadtplanung und Umwelt
25.09.2022 18:00;248;117;131;Leichter Regenschauer;12;12;0.1;Stadt Konstanz, Amt für Stadtplanung und Umwelt
25.09.2022 19:00;171;84;87;Leichter Regenschauer;11;12;0;Stadt Konstanz, Amt für Stadtplanung und Umwelt
25.09.2022 20:00;140;54;86;Leichter Regenschauer;11;11;0.2;Stadt Konstanz, Amt für Stadtplanung und Umwelt
25.09.2022 21:00;111;42;69;Leichter Regenschauer;10;10;0.3;Stadt Konstanz, Amt für Stadtplanung und Umwelt
25.09.2022 22:00;85;35;50;Leichter Regenschauer;10;10;0.1;Stadt Konstanz, Amt für Stadtplanung und Umwelt
25.09.2022 23:00;39;22;17;Stellenweiser Regenfall;10;9;0.1;Stadt Konstanz, Amt für Stadtplanung und Umwelt
26.09.2022 00:00;28;14;14;Stellenweiser Regenfall;10;9;0.2;Stadt Konstanz, Amt für Stadtplanung und Umwelt
26.09.2022 01:00;13;9;4;Stellenweiser Regenfall;10;9;0.1;Stadt Konstanz, Amt für Stadtplanung und Umwelt
26.09.2022 02:00;6;3;3;Bewoelkt;9;9;0;Stadt Konstanz, Amt für Stadtplanung und Umwelt
26.09.2022 03:00;3;3;0;Bewoelkt;9;8;0;Stadt Konstanz, Amt für Stadtplanung und Umwelt
26.09.2022 04:00;11;7;4;Bewoelkt;9;8;0;Stadt Konstanz, Amt für Stadtplanung und Umwelt
26.09.2022 05:00;49;31;18;Stellenweise Gewitter und Niederschlaege;9;8;0;Stadt Konstanz, Amt für Stadtplanung und Umwelt
26.09.2022 06:00;145;89;56;Stellenweise Gewitter und Niederschlaege;8;8;0;Stadt Konstanz, Amt für Stadtplanung und Umwelt
26.09.2022 07:00;933;562;371;Stellenweise Gewitter und Niederschlaege;10;9;0;Stadt Konstanz, Amt für Stadtplanung und Umwelt
26.09.2022 08:00;671;395;276;Leicht bewoelkt;11;10;0;Stadt Konstanz, Amt für Stadtplanung und Umwelt
26.09.2022 09:00;627;377;250;Leicht bewoelkt;12;12;0;Stadt Konstanz, Amt für Stadtplanung und Umwelt
26.09.2022 10:00;384;217;167;Leicht bewoelkt;14;14;0;Stadt Konstanz, Amt für Stadtplanung und Umwelt
26.09.2022 11:00;473;210;263;Sonnig;16;15;0;Stadt Konstanz, Amt für Stadtplanung und Umwelt
26.09.2022 12:00;666;277;389;Sonnig;17;17;0;Stadt Konstanz, Amt für Stadtplanung und Umwelt
26.09.2022 13:00;809;385;424;Sonnig;18;18;0;Stadt Konstanz, Amt für Stadtplanung und Umwelt
26.09.2022 14:00;639;344;295;Leicht bewoelkt;18;18;0;Stadt Konstanz, Amt für Stadtplanung und Umwelt
26.09.2022 15:00;981;468;513;Leicht bewoelkt;18;18;0;Stadt Konstanz, Amt für Stadtplanung und Umwelt
26.09.2022 16:00;726;338;388;Leicht bewoelkt;16;16;0;Stadt Konstanz, Amt für Stadtplanung und Umwelt
26.09.2022 17:00;899;402;497;Leicht bewoelkt;14;13;0;Stadt Konstanz, Amt für Stadtplanung und Umwelt
26.09.2022 18:00;746;327;419;Leicht bewoelkt;11;10;0;Stadt Konstanz, Amt für Stadtplanung und Umwelt
26.09.2022 19:00;506;224;282;Leicht bewoelkt;11;10;0;Stadt Konstanz, Amt für Stadtplanung und Umwelt
26.09.2022 20:00;361;169;192;Stellenweise Gewitter und Niederschlaege;10;9;0;Stadt Konstanz, Amt für Stadtplanung und Umwelt
26.09.2022 21:00;228;107;121;Stellenweise Gewitter und Niederschlaege;9;9;0;Stadt Konstanz, Amt für Stadtplanung und Umwelt
26.09.2022 22:00;175;84;91;Stellenweise Gewitter und Niederschlaege;9;8;0;Stadt Konstanz, Amt für Stadtplanung und Umwelt
26.09.2022 23:00;82;35;47;Leichter Regenschauer;9;8;0.1;Stadt Konstanz, Amt für Stadtplanung und Umwelt
27.09.2022 00:00;34;12;22;Leichter Regenschauer;9;7;0.2;Stadt Konstanz, Amt für Stadtplanung und Umwelt
27.09.2022 01:00;23;9;14;Leichter Regenschauer;9;7;0.1;Stadt Konstanz, Amt für Stadtplanung und Umwelt
27.09.2022 02:00;12;5;7;Leichter Regenfall;9;6;0.5;Stadt Konstanz, Amt für Stadtplanung und Umwelt
27.09.2022 03:00;2;1;1;Leichter Regenfall;8;6;0.6;Stadt Konstanz, Amt für Stadtplanung und Umwelt
27.09.2022 04:00;10;5;5;Leichter Regenfall;8;6;0.3;Stadt Konstanz, Amt für Stadtplanung und Umwelt
27.09.2022 05:00;47;37;10;Leichter Regenfall;8;5;0.4;Stadt Konstanz, Amt für Stadtplanung und Umwelt
27.09.2022 06:00;161;96;65;Leichter Regenfall;8;5;0.5;Stadt Konstanz, Amt für Stadtplanung und Umwelt
27.09.2022 07:00;783;485;298;Leichter Regenfall;8;5;0.2;Stadt Konstanz, Amt für Stadtplanung und Umwelt
27.09.2022 08:00;674;362;312;Bewoelkt;8;5;0;Stadt Konstanz, Amt für Stadtplanung und Umwelt
27.09.2022 09:00;452;275;177;Bewoelkt;9;6;0;Stadt Konstanz, Amt für Stadtplanung und Umwelt
27.09.2022 10:00;271;150;121;Bewoelkt;9;6;0;Stadt Konstanz, Amt für Stadtplanung und Umwelt
27.09.2022 11:00;380;193;187;Leichter Regenschauer;10;7;0.1;Stadt Konstanz, Amt für Stadtplanung und Umwelt
27.09.2022 12:00;475;178;297;Leichter Regenschauer;10;8;0.1;Stadt Konstanz, Amt für Stadtplanung und Umwelt
27.09.2022 13:00;610;264;346;Leichter Regenschauer;10;8;0;Stadt Konstanz, Amt für Stadtplanung und Umwelt
27.09.2022 14:00;490;235;255;Leichter Regenschauer;10;8;0.1;Stadt Konstanz, Amt für Stadtplanung und Umwelt
27.09.2022 15:00;774;360;414;Leichter Regenschauer;10;7;0.2;Stadt Konstanz, Amt für Stadtplanung und Umwelt
27.09.2022 16:00;689;315;374;Leichter Regenschauer;9;7;0.1;Stadt Konstanz, Amt für Stadtplanung und Umwelt
27.09.2022 17:00;724;327;397;Stellenweiser Regenfall;9;6;0.1;Stadt Konstanz, Amt für Stadtplanung und Umwelt
27.09.2022 18:00;524;239;285;Stellenweiser Regenfall;8;6;0.1;Stadt Konstanz, Amt für Stadtplanung und Umwelt
27.09.2022 19:00;414;194;220;Stellenweiser Regenfall;8;5;0.1;Stadt Konstanz, Amt für Stadtplanung und Umwelt
27.09.2022 20:00;251;132;119;Stellenweiser Regenfall;7;5;0;Stadt Konstanz, Amt für Stadtplanung und Umwelt
27.09.2022 21:00;172;72;100;Stellenweiser Regenfall;7;5;0;Stadt Konstanz, Amt für Stadtplanung und Umwelt
27.09.2022 22:00;143;58;85;Stellenweiser Regenfall;7;5;0;Stadt Konstanz, Amt für Stadtplanung und Umwelt
27.09.2022 23:00;63;20;43;Leicht bewoelkt;7;5;0;Stadt Konstanz, Amt für Stadtplanung und Umwelt
28.09.2022 00:00;35;16;19;Leicht bewoelkt;8;5;0;Stadt Konstanz, Amt für Stadtplanung und Umwelt
28.09.2022 01:00;26;10;16;Leicht bewoelkt;8;6;0;Stadt Konstanz, Amt für Stadtplanung und Umwelt
28.09.2022 02:00;14;6;8;Bedeckt;8;6;0;Stadt Konstanz, Amt für Stadtplanung und Umwelt
28.09.2022 03:00;11;6;5;Bedeckt;8;6;0;Stadt Konstanz, Amt für Stadtplanung und Umwelt
28.09.2022 04:00;8;1;7;Bedeckt;8;6;0;Stadt Konstanz, Amt für Stadtplanung und Umwelt
28.09.2022 05:00;32;20;12;Nieselregen;8;7;0.1;Stadt Konstanz, Amt für Stadtplanung und Umwelt
28.09.2022 06:00;104;58;46;Nieselregen;8;7;0.1;Stadt Konstanz, Amt für Stadtplanung und Umwelt
28.09.2022 07:00;551;296;255;Nieselregen;8;7;0;Stadt Konstanz, Amt für Stadtplanung und Umwelt
28.09.2022 08:00;431;251;180;Leichter Regenfall;8;8;0.4;Stadt Konstanz, Amt für Stadtplanung und Umwelt
28.09.2022 09:00;365;221;144;Leichter Regenfall;8;8;0.5;Stadt Konstanz, Amt für Stadtplanung und Umwelt
28.09.2022 10:00;201;95;106;Leichter Regenfall;8;8;0.2;Stadt Konstanz, Amt für Stadtplanung und Umwelt
28.09.2022 11:00;235;119;116;Leichter Regenfall;9;8;0.7;Stadt Konstanz, Amt für Stadtplanung und Umwelt
28.09.2022 12:00;326;142;184;Leichter Regenfall;9;8;0.9;Stadt Konstanz, Amt für Stadtplanung und Umwelt
28.09.2022 13:00;597;265;332;Leichter Regenfall;9;8;0.4;Stadt Konstanz, Amt für Stadtplanung und Umwelt
28.09.2022 14:00;347;172;175;Leichter Regenfall;9;9;0.6;Stadt Konstanz, Amt für Stadtplanung und Umwelt
28.09.2022 15:00;437;198;239;Leichter Regenfall;10;10;0.8;Stadt Konstanz, Amt für Stadtplanung und Umwelt
28.09.2022 16:00;421;196;225;Leichter Regenfall;9;9;0.4;Stadt Konstanz, Amt für Stadtplanung und Umwelt
28.09.2022 17:00;427;190;237;Leichter Regenfall;9;9;0.6;Stadt Konstanz, Amt für Stadtplanung und Umwelt
28.09.2022 18:00;379;171;208;Leichter Regenfall;8;8;0.8;Stadt Konstanz, Amt für Stadtplanung und Umwelt
28.09.2022 19:00;299;145;154;Leichter Regenfall;8;8;0.4;Stadt Konstanz, Amt für Stadtplanung und Umwelt
28.09.2022 20:00;181;85;96;Leichter Regenfall;8;8;0.5;Stadt Konstanz, Amt für Stadtplanung und Umwelt
28.09.2022 21:00;112;47;65;Leichter Regenfall;8;7;0.7;Stadt Konstanz, Amt für Stadtplanung und Umwelt
28.09.2022 22:00;114;61;53;Leichter Regenfall;7;7;0.4;Stadt Konstanz, Amt für Stadtplanung und Umwelt
28.09.2022 23:00;79;30;49;Leichter Regenfall;7;7;0.4;Stadt Konstanz, Amt für Stadtplanung und Umwelt
29.09.2022 00:00;40;15;25;Leichter Regenfall;7;7;0.9;Stadt Konstanz, Amt für Stadtplanung und Umwelt
29.09.2022 01:00;33;5;28;Leichter Regenfall;7;6;0.4;Stadt Konstanz, Amt für Stadtplanung und Umwelt
29.09.2022 02:00;17;4;13;Nieselregen;7;6;0.2;Stadt Konstanz, Amt für Stadtplanung und Umwelt
29.09.2022 03:00;5;2;3;Nieselregen;7;6;0.3;Stadt Konstanz, Amt für Stadtplanung und Umwelt
29.09.2022 04:00;12;8;4;Nieselregen;7;6;0.2;Stadt Konstanz, Amt für Stadtplanung und Umwelt
29.09.2022 05:00;40;21;19;Nieselregen;6;6;0.1;Stadt Konstanz, Amt für Stadtplanung und Umwelt
29.09.2022 06:00;121;74;47;Nieselregen;6;6;0.2;Stadt Konstanz, Amt für Stadtplanung und Umwelt
29.09.2022 07:00;667;393;274;Nieselregen;7;6;0.1;Stadt Konstanz, Amt für Stadtplanung und Umwelt
29.09.2022 08:00;529;311;218;Leichter Nebel;7;7;0;Stadt Konstanz, Amt für Stadtplanung und Umwelt
29.09.2022 09:00;432;254;178;Leichter Nebel;8;8;0;Stadt Konstanz, Amt für Stadtplanung und Umwelt
29.09.2022 10:00;270;160;110;Leichter Nebel;8;8;0;Stadt Konstanz, Amt für Stadtplanung und Umwelt
29.09.2022 11:00;329;153;176;Leichter Regenschauer;8;8;0.1;Stadt Konstanz, Amt für Stadtplanung und Umwelt
29.09.2022 12:00;410;197;213;Leichter Regenschauer;9;9;0.1;Stadt Konstanz, Amt für Stadtplanung und Umwelt
29.09.2022 13:00;610;277;333;Leichter Regenschauer;9;9;0;Stadt Konstanz, Amt für Stadtplanung und Umwelt
29.09.2022 14:00;540;262;278;Bewoelkt;10;10;0;Stadt Konstanz, Amt für Stadtplanung und Umwelt
29.09.2022 15:00;727;371;356;Bewoelkt;11;10;0;Stadt Konstanz, Amt für Stadtplanung und Umwelt
29.09.2022 16:00;676;324;352;Bewoelkt;10;10;0;Stadt Konstanz, Amt für Stadtplanung und Umwelt
29.09.2022 17:00;846;414;432;Leichter Regenschauer;9;9;0.1;Stadt Konstanz, Amt für Stadtplanung und Umwelt
29.09.2022 18:00;659;315;344;Leichter Regenschauer;8;8;0.1;Stadt Konstanz, Amt für Stadtplanung und Umwelt
29.09.2022 19:00;434;205;229;Leichter Regenschauer;8;8;0.1;Stadt Konstanz, Amt für Stadtplanung und Umwelt
29.09.2022 20:00;262;106;156;Nieselregen;7;7;0.1;Stadt Konstanz, Amt für Stadtplanung und Umwelt
29.09.2022 21:00;227;108;119;Nieselregen;7;7;0.1;Stadt Konstanz, Amt für Stadtplanung und Umwelt
29.09.2022 22:00;168;64;104;Nieselregen;7;7;0.1;Stadt Konstanz, Amt für Stadtplanung und Umwelt
29.09.2022 23:00;80;32;48;Bewoelkt;6;6;0;Stadt Konstanz, Amt für Stadtplanung und Umwelt
30.09.2022 00:00;60;23;37;Bewoelkt;6;6;0;Stadt Konstanz, Amt für Stadtplanung und Umwelt
30.09.2022 01:00;29;9;20;Bewoelkt;6;6;0;Stadt Konstanz, Amt für Stadtplanung und Umwelt
30.09.2022 02:00;16;7;9;Bewoelkt;6;6;0;Stadt Konstanz, Amt für Stadtplanung und Umwelt
30.09.2022 03:00;14;3;11;Bewoelkt;6;6;0;Stadt Konstanz, Amt für Stadtplanung und Umwelt
30.09.2022 04:00;12;6;6;Bewoelkt;6;6;0;Stadt Konstanz, Amt für Stadtplanung und Umwelt
30.09.2022 05:00;41;27;14;Bedeckt;6;5;0;Stadt Konstanz, Amt für Stadtplanung und Umwelt
30.09.2022 06:00;128;80;48;Bedeckt;6;5;0;Stadt Konstanz, Amt für Stadtplanung und Umwelt
30.09.2022 07:00;744;470;274;Bedeckt;7;6;0;Stadt Konstanz, Amt für Stadtplanung und Umwelt
30.09.2022 08:00;632;354;278;Bedeckt;8;7;0;Stadt Konstanz, Amt für Stadtplanung und Umwelt
30.09.2022 09:00;582;366;216;Bedeckt;9;8;0;Stadt Konstanz, Amt für Stadtplanung und Umwelt
30.09.2022 10:00;453;256;197;Bedeckt;9;8;0;Stadt Konstanz, Amt für Stadtplanung und Umwelt
30.09.2022 11:00;642;347;295;Nieselregen;9;9;0.1;Stadt Konstanz, Amt für Stadtplanung und Umwelt
30.09.2022 12:00;727;340;387;Nieselregen;9;9;0.1;Stadt Konstanz, Amt für Stadtplanung und Umwelt
30.09.2022 13:00;854;346;508;Nieselregen;9;9;0.1;Stadt Konstanz, Amt für Stadtplanung und Umwelt
30.09.2022 14:00;610;317;293;Nieselregen;9;9;0.2;Stadt Konstanz, Amt für Stadtplanung und Umwelt
30.09.2022 15:00;730;344;386;Nieselregen;9;9;0.3;Stadt Konstanz, Amt für Stadtplanung und Umwelt
30.09.2022 16:00;671;333;338;Nieselregen;9;9;0.2;Stadt Konstanz, Amt für Stadtplanung und Umwelt
30.09.2022 17:00;749;365;384;Nieselregen;9;9;0.1;Stadt Konstanz, Amt für Stadtplanung und Umwelt
30.09.2022 18:00;558;258;300;Nieselregen;8;9;0.1;Stadt Konstanz, Amt für Stadtplanung und Umwelt
30.09.2022 19:00;515;228;287;Nieselregen;8;8;0.1;Stadt Konstanz, Amt für Stadtplanung und Umwelt
30.09.2022 20:00;334;166;168;Bewoelkt;8;8;0;Stadt Konstanz, Amt für Stadtplanung und Umwelt
30.09.2022 21:00;222;119;103;Bewoelkt;8;8;0;Stadt Konstanz, Amt für Stadtplanung und Umwelt
30.09.2022 22:00;252;95;157;Bewoelkt;7;7;0;Stadt Konstanz, Amt für Stadtplanung und Umwelt
30.09.2022 23:00;181;82;99;Bewoelkt;7;6;0;Stadt Konstanz, Amt für Stadtplanung und Umwelt
01.10.2022 00:00;151;48;103;Bewoelkt;6;5;0;Stadt Konstanz, Amt für Stadtplanung und Umwelt
01.10.2022 01:00;113;30;83;Bewoelkt;6;5;0;Stadt Konstanz, Amt für Stadtplanung und Umwelt
01.10.2022 02:00;68;21;47;Sonnig;5;5;0;Stadt Konstanz, Amt für Stadtplanung und Umwelt
01.10.2022 03:00;48;19;29;Sonnig;5;5;0;Stadt Konstanz, Amt für Stadtplanung und Umwelt
01.10.2022 04:00;22;11;11;Sonnig;5;4;0;Stadt Konstanz, Amt für Stadtplanung und Umwelt
01.10.2022 05:00;21;14;7;Sonnig;4;4;0;Stadt Konstanz, Amt für Stadtplanung und Umwelt
01.10.2022 06:00;35;23;12;Sonnig;4;3;0;Stadt Konstanz, Amt für Stadtplanung und Umwelt
01.10.2022 07:00;54;24;30;Sonnig;6;5;0;Stadt Konstanz, Amt für Stadtplanung und Umwelt
01.10.2022 08:00;191;111;80;Leicht bewoelkt;8;7;0;Stadt Konstanz, Amt für Stadtplanung und Umwelt
01.10.2022 09:00;271;150;121;Leicht bewoelkt;10;9;0;Stadt Konstanz, Amt für Stadtplanung und Umwelt
01.10.2022 10:00;259;142;117;Leicht bewoelkt;11;10;0;Stadt Konstanz, Amt für Stadtplanung und Umwelt
01.10.2022 11:00;268;145;123;Leicht bewoelkt;12;11;0;Stadt Konstanz, Amt für Stadtplanung und Umwelt
01.10.2022 12:00;284;153;131;Leicht bewoelkt;13;12;0;Stadt Konstanz, Amt für Stadtplanung und Umwelt
01.10.2022 13:00;362;193;169;Leicht bewoelkt;12;11;0;Stadt Konstanz, Amt für Stadtplanung und Umwelt
01.10.2022 14:00;397;206;191;Leichter Nebel;11;10;0;Stadt Konstanz, Amt für Stadtplanung und Umwelt
01.10.2022 15:00;323;152;171;Leichter Nebel;10;9;0;Stadt Konstanz, Amt für Stadtplanung und Umwelt
01.10.2022 16:00;316;172;144;Leichter Nebel;10;9;0;Stadt Konstanz, Amt für Stadtplanung und Umwelt
01.10.2022 17:00;298;129;169;Leichter Regenfall;10;9;0.8;Stadt Konstanz, Amt für Stadtplanung und Umwelt
01.10.2022 18:00;319;118;201;Leichter Regenfall;10;9;1;Stadt Konstanz, Amt für Stadtplanung und Umwelt
01.10.2022 19:00;227;103;124;Leichter Regenfall;11;9;0.5;Stadt Konstanz, Amt für Stadtplanung und Umwelt
01.10.2022 20:00;173;81;92;Leichter Regenfall;11;9;0.3;Stadt Konstanz, Amt für Stadtplanung und Umwelt
01.10.2022 21:00;161;73;88;Leichter Regenfall;11;9;0.4;Stadt Konstanz, Amt für Stadtplanung und Umwelt
01.10.2022 22:00;112;50;62;Leichter Regenfall;11;9;0.2;Stadt Konstanz, Amt für Stadtplanung und Umwelt
01.10.2022 23:00;102;30;72;Stellenweiser Regenfall;11;9;0;Stadt Konstanz, Amt für Stadtplanung und Umwelt
02.10.2022 00:00;80;28;52;Stellenweiser Regenfall;11;10;0.1;Stadt Konstanz, Amt für Stadtplanung und Umwelt
02.10.2022 01:00;71;29;42;Stellenweiser Regenfall;12;10;0;Stadt Konstanz, Amt für Stadtplanung und Umwelt
02.10.2022 02:00;48;17;31;Leichter Regenschauer;12;10;0.1;Stadt Konstanz, Amt für Stadtplanung und Umwelt
02.10.2022 03:00;40;22;18;Leichter Regenschauer;12;11;0.1;Stadt Konstanz, Amt für Stadtplanung und Umwelt
02.10.2022 04:00;16;9;7;Leichter Regenschauer;12;11;0.1;Stadt Konstanz, Amt für Stadtplanung und Umwelt
02.10.2022 05:00;27;14;13;Leichter Regenschauer;12;11;0.2;Stadt Konstanz, Amt für Stadtplanung und Umwelt
02.10.2022 06:00;23;17;6;Leichter Regenschauer;12;11;0.3;Stadt Konstanz, Amt für Stadtplanung und Umwelt
02.10.2022 07:00;14;6;8;Leichter Regenschauer;12;11;0.2;Stadt Konstanz, Amt für Stadtplanung und Umwelt
02.10.2022 08:00;45;24;21;Stellenweiser Nieselregen;13;12;0.1;Stadt Konstanz, Amt für Stadtplanung und Umwelt
02.10.2022 09:00;116;70;46;Stellenweiser Nieselregen;13;13;0.1;Stadt Konstanz, Amt für Stadtplanung und Umwelt
02.10.2022 10:00;180;90;90;Stellenweiser Nieselregen;15;14;0.1;Stadt Konstanz, Amt für Stadtplanung und Umwelt
02.10.2022 11:00;200;80;120;Stellenweiser Regenfall;16;16;0;Stadt Konstanz, Amt für Stadtplanung und Umwelt
02.10.2022 12:00;198;76;122;Stellenweiser Regenfall;17;17;0;Stadt Konstanz, Amt für Stadtplanung und Umwelt
02.10.2022 13:00;203;93;110;Stellenweiser Regenfall;18;18;0;Stadt Konstanz, Amt für Stadtplanung und Umwelt
02.10.2022 14:00;268;121;147;Leicht bewoelkt;19;19;0;Stadt Konstanz, Amt für Stadtplanung und Umwelt
02.10.2022 15:00;303;158;145;Leicht bewoelkt;19;19;0;Stadt Konstanz, Amt für Stadtplanung und Umwelt
02.10.2022 16:00;295;179;116;Leicht bewoelkt;18;18;0;Stadt Konstanz, Amt für Stadtplanung und Umwelt
02.10.2022 17:00;333;144;189;Stellenweiser Regenfall;16;16;0.1;Stadt Konstanz, Amt für Stadtplanung und Umwelt
02.10.2022 18:00;315;160;155;Stellenweiser Regenfall;15;14;0.1;Stadt Konstanz, Amt für Stadtplanung und Umwelt
02.10.2022 19:00;281;133;148;Stellenweiser Regenfall;14;14;0;Stadt Konstanz, Amt für Stadtplanung und Umwelt
02.10.2022 20:00;190;98;92;Leichter Nebel;14;13;0;Stadt Konstanz, Amt für Stadtplanung und Umwelt
02.10.2022 21:00;142;68;74;Leichter Nebel;13;12;0;Stadt Konstanz, Amt für Stadtplanung und Umwelt
02.10.2022 22:00;98;44;54;Leichter Nebel;12;12;0;Stadt Konstanz, Amt für Stadtplanung und Umwelt
02.10.2022 23:00;88;25;63;Leichter Regenschauer;11;11;0.3;Stadt Konstanz, Amt für Stadtplanung und Umwelt
03.10.2022 00:00;58;25;33;Leichter Regenschauer;10;10;0.6;Stadt Konstanz, Amt für Stadtplanung und Umwelt
03.10.2022 01:00;46;18;28;Leichter Regenschauer;10;10;0.3;Stadt Konstanz, Amt für Stadtplanung und Umwelt
03.10.2022 02:00;25;9;16;Nieselregen;10;10;0.2;Stadt Konstanz, Amt für Stadtplanung und Umwelt
03.10.2022 03:00;19;10;9;Nieselregen;10;10;0.3;Stadt Konstanz, Amt für Stadtplanung und Umwelt
03.10.2022 04:00;20;9;11;Nieselregen;10;10;0.2;Stadt Konstanz, Amt für Stadtplanung und Umwelt
03.10.2022 05:00;32;25;7;Nieselregen;10;10;0.2;Stadt Konstanz, Amt für Stadtplanung und Umwelt
03.10.2022 06:00;49;40;9;Nieselregen;10;10;0.3;Stadt Konstanz, Amt für Stadtplanung und Umwelt
03.10.2022 07:00;99;81;18;Nieselregen;11;11;0.1;Stadt Konstanz, Amt für Stadtplanung und Umwelt
03.10.2022 08:00;105;63;42;Leichter Regenfall;11;11;0.3;Stadt Konstanz, Amt für Stadtplanung und Umwelt
03.10.2022 09:00;152;78;74;Leichter Regenfall;11;12;0.4;Stadt Konstanz, Amt für Stadtplanung und Umwelt
03.10.2022 10:00;229;116;113;Leichter Regenfall;12;12;0.2;Stadt Konstanz, Amt für Stadtplanung und Umwelt
03.10.2022 11:00;280;156;124;Nieselregen;12;12;0.2;Stadt Konstanz, Amt für Stadtplanung und Umwelt
03.10.2022 12:00;409;195;214;Nieselregen;13;13;0.2;Stadt Konstanz, Amt für Stadtplanung und Umwelt
03.10.2022 13:00;395;191;204;Nieselregen;14;14;0.1;Stadt Konstanz, Amt für Stadtplanung und Umwelt
03.10.2022 14:00;465;226;239;Bewoelkt;15;15;0;Stadt Konstanz, Amt für Stadtplanung und Umwelt
03.10.2022 15:00;513;256;257;Bewoelkt;15;15;0;Stadt Konstanz, Amt für Stadtplanung und Umwelt
03.10.2022 16:00;514;263;251;Bewoelkt;14;14;0;Stadt Konstanz, Amt für Stadtplanung und Umwelt
03.10.2022 17:00;521;220;301;Leichter Nebel;12;12;0;Stadt Konstanz, Amt für Stadtplanung und Umwelt
03.10.2022 18:00;541;239;302;Leichter Nebel;11;11;0;Stadt Konstanz, Amt für Stadtplanung und Umwelt
03.10.2022 19:00;372;168;204;Leichter Nebel;10;11;0;Stadt Konstanz, Amt für Stadtplanung und Umwelt
03.10.2022 20:00;215;89;126;Leichter Nebel;10;10;0;Stadt Konstanz, Amt für Stadtplanung und Umwelt
03.10.2022 21:00;153;69;84;Leichter Nebel;9;10;0;Stadt Konstanz, Amt für Stadtplanung und Umwelt
03.10.2022 22:00;131;53;78;Leichter Nebel;9;9;0;Stadt Konstanz, Amt für Stadtplanung und Umwelt
03.10.2022 23:00;55;23;32;Sonnig;8;8;0;Stadt Konstanz, Amt für Stadtplanung und Umwelt
04.10.2022 00:00;29;11;18;Sonnig;7;7;0;Stadt Konstanz, Amt für Stadtplanung und Umwelt
04.10.2022 01:00;15;7;8;Sonnig;7;6;0;Stadt Konstanz, Amt für Stadtplanung und Umwelt
04.10.2022 02:00;2;1;1;Leichter Nebel;7;6;0;Stadt Konstanz, Amt für Stadtplanung und Umwelt
04.10.2022 03:00;4;3;1;Leichter Nebel;6;6;0;Stadt Konstanz, Amt für Stadtplanung und Umwelt
04.10.2022 04:00;10;7;3;Leichter Nebel;6;6;0;Stadt Konstanz, Amt für Stadtplanung und Umwelt
04.10.2022 05:00;47;34;13;Leichter Nebel;6;5;0;Stadt Konstanz, Amt für Stadtplanung und Umwelt
04.10.2022 06:00;177;101;76;Leichter Nebel;6;5;0;Stadt Konstanz, Amt für Stadtplanung und Umwelt
04.10.2022 07:00;1015;668;347;Leichter Nebel;8;7;0;Stadt Konstanz, Amt für Stadtplanung und Umwelt
04.10.2022 08:00;783;429;354;Sonnig;10;9;0;Stadt Konstanz, Amt für Stadtplanung und Umwelt
04.10.2022 09:00;792;508;284;Sonnig;12;12;0;Stadt Konstanz, Amt für Stadtplanung und Umwelt
04.10.2022 10:00;492;256;236;Sonnig;13;13;0;Stadt Konstanz, Amt für Stadtplanung und Umwelt
04.10.2022 11:00;601;343;258;Sonnig;15;15;0;Stadt Konstanz, Amt für Stadtplanung und Umwelt
04.10.2022 12:00;715;291;424;Sonnig;17;17;0;Stadt Konstanz, Amt für Stadtplanung und Umwelt
04.10.2022 13:00;935;421;514;Sonnig;17;17;0;Stadt Konstanz, Amt für Stadtplanung und Umwelt
04.10.2022 14:00;670;330;340;Sonnig;18;18;0;Stadt Konstanz, Amt für Stadtplanung und Umwelt
04.10.2022 15:00;1071;528;543;Sonnig;18;18;0;Stadt Konstanz, Amt für Stadtplanung und Umwelt
04.10.2022 16:00;977;461;516;Sonnig;17;17;0;Stadt Konstanz, Amt für Stadtplanung und Umwelt
04.10.2022 17:00;1232;586;646;Sonnig;15;15;0;Stadt Konstanz, Amt für Stadtplanung und Umwelt
04.10.2022 18:00;960;484;476;Sonnig;13;13;0;Stadt Konstanz, Amt für Stadtplanung und Umwelt
04.10.2022 19:00;653;276;377;Sonnig;12;12;0;Stadt Konstanz, Amt für Stadtplanung und Umwelt
04.10.2022 20:00;464;156;308;Sonnig;10;10;0;Stadt Konstanz, Amt für Stadtplanung und Umwelt
04.10.2022 21:00;312;120;192;Sonnig;9;9;0;Stadt Konstanz, Amt für Stadtplanung und Umwelt
04.10.2022 22:00;199;97;102;Sonnig;9;9;0;Stadt Konstanz, Amt für Stadtplanung und Umwelt
04.10.2022 23:00;142;63;79;Sonnig;8;8;0;Stadt Konstanz, Amt für Stadtplanung und Umwelt
05.10.2022 00:00;44;17;27;Sonnig;7;7;0;Stadt Konstanz, Amt für Stadtplanung und Umwelt
05.10.2022 01:00;60;17;43;Sonnig;7;7;0;Stadt Konstanz, Amt für Stadtplanung und Umwelt
05.10.2022 02:00;13;7;6;Bedeckt;7;7;0;Stadt Konstanz, Amt für Stadtplanung und Umwelt
05.10.2022 03:00;7;5;2;Bedeckt;7;7;0;Stadt Konstanz, Amt für Stadtplanung und Umwelt
05.10.2022 04:00;15;8;7;Bedeckt;7;7;0;Stadt Konstanz, Amt für Stadtplanung und Umwelt
05.10.2022 05:00;49;36;13;Leicht bewoelkt;7;7;0;Stadt Konstanz, Amt für Stadtplanung und Umwelt
05.10.2022 06:00;184;108;76;Leicht bewoelkt;6;6;0;Stadt Konstanz, Amt für Stadtplanung und Umwelt
05.10.2022 07:00;1080;741;339;Leicht bewoelkt;9;9;0;Stadt Konstanz, Amt für Stadtplanung und Umwelt
05.10.2022 08:00;827;437;390;Sonnig;11;11;0;Stadt Konstanz, Amt für Stadtplanung und Umwelt
05.10.2022 09:00;709;428;281;Sonnig;13;13;0;Stadt Konstanz, Amt für Stadtplanung und Umwelt
05.10.2022 10:00;482;254;228;Sonnig;15;15;0;Stadt Konstanz, Amt für Stadtplanung und Umwelt
05.10.2022 11:00;663;305;358;Sonnig;17;17;0;Stadt Konstanz, Amt für Stadtplanung und Umwelt
05.10.2022 12:00;756;349;407;Sonnig;19;19;0;Stadt Konstanz, Amt für Stadtplanung und Umwelt
05.10.2022 13:00;1081;545;536;Sonnig;19;19;0;Stadt Konstanz, Amt für Stadtplanung und Umwelt
05.10.2022 14:00;771;402;369;Leicht bewoelkt;20;20;0;Stadt Konstanz, Amt für Stadtplanung und Umwelt
05.10.2022 15:00;1066;498;568;Leicht bewoelkt;21;21;0;Stadt Konstanz, Amt für Stadtplanung und Umwelt
05.10.2022 16:00;1100;523;577;Leicht bewoelkt;18;18;0;Stadt Konstanz, Amt für Stadtplanung und Umwelt
05.10.2022 17:00;1211;514;697;Bedeckt;16;16;0;Stadt Konstanz, Amt für Stadtplanung und Umwelt
05.10.2022 18:00;1005;405;600;Bedeckt;14;14;0;Stadt Konstanz, Amt für Stadtplanung und Umwelt
05.10.2022 19:00;713;322;391;Bedeckt;13;13;0;Stadt Konstanz, Amt für Stadtplanung und Umwelt
05.10.2022 20:00;477;196;281;Bedeckt;13;12;0;Stadt Konstanz, Amt für Stadtplanung und Umwelt
05.10.2022 21:00;308;107;201;Bedeckt;12;12;0;Stadt Konstanz, Amt für Stadtplanung und Umwelt
05.10.2022 22:00;195;79;116;Bedeckt;12;11;0;Stadt Konstanz, Amt für Stadtplanung und Umwelt
05.10.2022 23:00;153;54;99;Leicht bewoelkt;11;11;0;Stadt Konstanz, Amt für Stadtplanung und Umwelt
06.10.2022 00:00;92;33;59;Leicht bewoelkt;11;11;0;Stadt Konstanz, Amt für Stadtplanung und Umwelt
06.10.2022 01:00;39;17;22;Leicht bewoelkt;10;10;0;Stadt Konstanz, Amt für Stadtplanung und Umwelt
06.10.2022 02:00;21;17;4;Sonnig;10;10;0;Stadt Konstanz, Amt für Stadtplanung und Umwelt
06.10.2022 03:00;3;0;3;Sonnig;10;10;0;Stadt Konstanz, Amt für Stadtplanung und Umwelt
06.10.2022 04:00;9;4;5;Sonnig;10;10;0;Stadt Konstanz, Amt für Stadtplanung und Umwelt
06.10.2022 05:00;56;37;19;Sonnig;10;10;0;Stadt Konstanz, Amt für Stadtplanung und Umwelt
06.10.2022 06:00;171;101;70;Sonnig;9;9;0;Stadt Konstanz, Amt für Stadtplanung und Umwelt
06.10.2022 07:00;1049;680;369;Sonnig;11;11;0;Stadt Konstanz, Amt für Stadtplanung und Umwelt
06.10.2022 08:00;778;429;349;Sonnig;13;13;0;Stadt Konstanz, Amt für Stadtplanung und Umwelt
06.10.2022 09:00;727;443;284;Sonnig;15;15;0;Stadt Konstanz, Amt für Stadtplanung und Umwelt
06.10.2022 10:00;538;295;243;Sonnig;16;16;0;Stadt Konstanz, Amt für Stadtplanung und Umwelt
06.10.2022 11:00;690;349;341;Sonnig;17;17;0;Stadt Konstanz, Amt für Stadtplanung und Umwelt
06.10.2022 12:00;728;316;412;Sonnig;18;18;0;Stadt Konstanz, Amt für Stadtplanung und Umwelt
06.10.2022 13:00;1055;489;566;Sonnig;18;18;0;Stadt Konstanz, Amt für Stadtplanung und Umwelt
06.10.2022 14:00;782;361;421;Sonnig;18;18;0;Stadt Konstanz, Amt für Stadtplanung und Umwelt
06.10.2022 15:00;1111;496;615;Sonnig;18;18;0;Stadt Konstanz, Amt für Stadtplanung und Umwelt
06.10.2022 16:00;1017;468;549;Sonnig;16;16;0;Stadt Konstanz, Amt für Stadtplanung und Umwelt
06.10.2022 17:00;1211;536;675;Leicht bewoelkt;14;13;0;Stadt Konstanz, Amt für Stadtplanung und Umwelt
06.10.2022 18:00;907;414;493;Leicht bewoelkt;12;11;0;Stadt Konstanz, Amt für Stadtplanung und Umwelt
06.10.2022 19:00;690;270;420;Leicht bewoelkt;12;11;0;Stadt Konstanz, Amt für Stadtplanung und Umwelt
06.10.2022 20:00;413;177;236;Leicht bewoelkt;11;10;0;Stadt Konstanz, Amt für Stadtplanung und Umwelt
06.10.2022 21:00;271;124;147;Leicht bewoelkt;10;10;0;Stadt Konstanz, Amt für Stadtplanung und Umwelt
06.10.2022 22:00;236;93;143;Leicht bewoelkt;10;9;0;Stadt Konstanz, Amt für Stadtplanung und Umwelt
06.10.2022 23:00;164;57;107;Leichter Nebel;9;9;0;Stadt Konstanz, Amt für Stadtplanung und Umwelt
07.10.2022 00:00;67;19;48;Leichter Nebel;9;9;0;Stadt Konstanz, Amt für Stadtplanung und Umwelt
07.10.2022 01:00;39;15;24;Leichter Nebel;9;8;0;Stadt Konstanz, Amt für Stadtplanung und Umwelt
07.10.2022 02:00;15;3;12;Leichter Nebel;8;8;0;Stadt Konstanz, Amt für Stadtplanung und Umwelt
07.10.2022 03:00;5;5;0;Leichter Nebel;8;8;0;Stadt Konstanz, Amt für Stadtplanung und Umwelt
07.10.2022 04:00;11;6;5;Leichter Nebel;8;8;0;Stadt Konstanz, Amt für Stadtplanung und Umwelt
07.10.2022 05:00;34;26;8;Leichter Nebel;8;8;0;Stadt Konstanz, Amt für Stadtplanung und Umwelt
07.10.2022 06:00;171;103;68;Leichter Nebel;8;8;0;Stadt Konstanz, Amt für Stadtplanung und Umwelt
07.10.2022 07:00;954;631;323;Leichter Nebel;9;9;0;Stadt Konstanz, Amt für Stadtplanung und Umwelt
07.10.2022 08:00;763;425;338;Bewoelkt;11;11;0;Stadt Konstanz, Amt für Stadtplanung und Umwelt
07.10.2022 09:00;656;383;273;Bewoelkt;12;12;0;Stadt Konstanz, Amt für Stadtplanung und Umwelt
07.10.2022 10:00;492;278;214;Bewoelkt;14;14;0;Stadt Konstanz, Amt für Stadtplanung und Umwelt
07.10.2022 11:00;693;394;299;Leicht bewoelkt;15;15;0;Stadt Konstanz, Amt für Stadtplanung und Umwelt
07.10.2022 12:00;786;397;389;Leicht bewoelkt;17;17;0;Stadt Konstanz, Amt für Stadtplanung und Umwelt
07.10.2022 13:00;1055;404;651;Leicht bewoelkt;17;17;0;Stadt Konstanz, Amt für Stadtplanung und Umwelt
07.10.2022 14:00;772;404;368;Sonnig;18;18;0;Stadt Konstanz, Amt für Stadtplanung und Umwelt
07.10.2022 15:00;828;408;420;Sonnig;19;19;0;Stadt Konstanz, Amt für Stadtplanung und Umwelt
07.10.2022 16:00;794;414;380;Sonnig;17;17;0;Stadt Konstanz, Amt für Stadtplanung und Umwelt
07.10.2022 17:00;843;399;444;Sonnig;15;15;0;Stadt Konstanz, Amt für Stadtplanung und Umwelt
07.10.2022 18:00;847;464;383;Sonnig;13;13;0;Stadt Konstanz, Amt für Stadtplanung und Umwelt
07.10.2022 19:00;670;384;286;Sonnig;12;13;0;Stadt Konstanz, Amt für Stadtplanung und Umwelt
07.10.2022 20:00;416;197;219;Sonnig;12;12;0;Stadt Konstanz, Amt für Stadtplanung und Umwelt
07.10.2022 21:00;346;143;203;Sonnig;11;11;0;Stadt Konstanz, Amt für Stadtplanung und Umwelt
07.10.2022 22:00;299;92;207;Sonnig;11;11;0;Stadt Konstanz, Amt für Stadtplanung und Umwelt
07.10.2022 23:00;235;71;164;Leicht bewoelkt;11;11;0;Stadt Konstanz, Amt für Stadtplanung und Umwelt
08.10.2022 00:00;146;31;115;Leicht bewoelkt;11;12;0;Stadt Konstanz, Amt für Stadtplanung und Umwelt
08.10.2022 01:00;142;38;104;Leicht bewoelkt;11;11;0;Stadt Konstanz, Amt für Stadtplanung und Umwelt
08.10.2022 02:00;75;24;51;Stellenweiser Regenfall;11;11;0;Stadt Konstanz, Amt für Stadtplanung und Umwelt
08.10.2022 03:00;45;16;29;Stellenweiser Regenfall;11;11;0;Stadt Konstanz, Amt für Stadtplanung und Umwelt
08.10.2022 04:00;22;13;9;Stellenweiser Regenfall;11;12;0;Stadt Konstanz, Amt für Stadtplanung und Umwelt
08.10.2022 05:00;30;15;15;Stellenweiser Regenfall;12;12;0;Stadt Konstanz, Amt für Stadtplanung und Umwelt
08.10.2022 06:00;47;33;14;Stellenweiser Regenfall;12;13;0;Stadt Konstanz, Amt für Stadtplanung und Umwelt
08.10.2022 07:00;69;31;38;Stellenweiser Regenfall;13;13;0;Stadt Konstanz, Amt für Stadtplanung und Umwelt
08.10.2022 08:00;200;101;99;Leichter Regenschauer;13;13;0.4;Stadt Konstanz, Amt für Stadtplanung und Umwelt
08.10.2022 09:00;277;155;122;Leichter Regenschauer;13;14;0.6;Stadt Konstanz, Amt für Stadtplanung und Umwelt
08.10.2022 10:00;418;262;156;Leichter Regenschauer;14;14;0.3;Stadt Konstanz, Amt für Stadtplanung und Umwelt
08.10.2022 11:00;557;304;253;Leichter Regenschauer;14;14;0.3;Stadt Konstanz, Amt für Stadtplanung und Umwelt
08.10.2022 12:00;558;300;258;Leichter Regenschauer;15;15;0.4;Stadt Konstanz, Amt für Stadtplanung und Umwelt
08.10.2022 13:00;491;231;260;Leichter Regenschauer;15;16;0.2;Stadt Konstanz, Amt für Stadtplanung und Umwelt
08.10.2022 14:00;418;181;237;Stellenweiser Regenfall;16;16;0.2;Stadt Konstanz, Amt für Stadtplanung und Umwelt
08.10.2022 15:00;430;192;238;Stellenweiser Regenfall;17;17;0.3;Stadt Konstanz, Amt für Stadtplanung und Umwelt
08.10.2022 16:00;373;181;192;Stellenweiser Regenfall;15;15;0.2;Stadt Konstanz, Amt für Stadtplanung und Umwelt
08.10.2022 17:00;488;249;239;Stellenweiser Regenfall;13;12;0.1;Stadt Konstanz, Amt für Stadtplanung und Umwelt
08.10.2022 18:00;447;202;245;Stellenweiser Regenfall;11;10;0.1;Stadt Konstanz, Amt für Stadtplanung und Umwelt
08.10.2022 19:00;319;150;169;Stellenweiser Regenfall;10;9;0.1;Stadt Konstanz, Amt für Stadtplanung und Umwelt
08.10.2022 20:00;271;135;136;Leicht bewoelkt;9;8;0;Stadt Konstanz, Amt für Stadtplanung und Umwelt
08.10.2022 21:00;210;91;119;Leicht bewoelkt;8;7;0;Stadt Konstanz, Amt für Stadtplanung und Umwelt
08.10.2022 22:00;187;90;97;Leicht bewoelkt;8;6;0;Stadt Konstanz, Amt für Stadtplanung und Umwelt
08.10.2022 23:00;174;57;117;Leicht bewoelkt;7;5;0;Stadt Konstanz, Amt für Stadtplanung und Umwelt
09.10.2022 00:00;140;55;85;Leicht bewoelkt;6;5;0;Stadt Konstanz, Amt für Stadtplanung und Umwelt
09.10.2022 01:00;105;33;72;Leicht bewoelkt;6;4;0;Stadt Konstanz, Amt für Stadtplanung und Umwelt
09.10.2022 02:00;75;30;45;Sonnig;6;4;0;Stadt Konstanz, Amt für Stadtplanung und Umwelt
09.10.2022 03:00;43;17;26;Sonnig;5;4;0;Stadt Konstanz, Amt für Stadtplanung und Umwelt
09.10.2022 04:00;18;10;8;Sonnig;5;3;0;Stadt Konstanz, Amt für Stadtplanung und Umwelt
09.10.2022 05:00;24;16;8;Leichter Nebel;5;3;0;Stadt Konstanz, Amt für Stadtplanung und Umwelt
09.10.2022 06:00;24;18;6;Leichter Nebel;4;3;0;Stadt Konstanz, Amt für Stadtplanung und Umwelt
09.10.2022 07:00;31;13;18;Leichter Nebel;6;5;0;Stadt Konstanz, Amt für Stadtplanung und Umwelt
09.10.2022 08:00;75;33;42;Leicht bewoelkt;8;7;0;Stadt Konstanz, Amt für Stadtplanung und Umwelt
09.10.2022 09:00;224;123;101;Leicht bewoelkt;10;9;0;Stadt Konstanz, Amt für Stadtplanung und Umwelt
09.10.2022 10:00;270;138;132;Leicht bewoelkt;12;11;0;Stadt Konstanz, Amt für Stadtplanung und Umwelt
09.10.2022 11:00;429;267;162;Sonnig;14;14;0;Stadt Konstanz, Amt für Stadtplanung und Umwelt
09.10.2022 12:00;506;310;196;Sonnig;16;16;0;Stadt Konstanz, Amt für Stadtplanung und Umwelt
09.10.2022 13:00;540;313;227;Sonnig;17;17;0;Stadt Konstanz, Amt für Stadtplanung und Umwelt
09.10.2022 14:00;633;338;295;Sonnig;18;18;0;Stadt Konstanz, Amt für Stadtplanung und Umwelt
09.10.2022 15:00;569;279;290;Sonnig;19;19;0;Stadt Konstanz, Amt für Stadtplanung und Umwelt
09.10.2022 16:00;550;229;321;Sonnig;17;17;0;Stadt Konstanz, Amt für Stadtplanung und Umwelt
09.10.2022 17:00;576;210;366;Sonnig;14;14;0;Stadt Konstanz, Amt für Stadtplanung und Umwelt
09.10.2022 18:00;465;193;272;Sonnig;12;12;0;Stadt Konstanz, Amt für Stadtplanung und Umwelt
09.10.2022 19:00;295;141;154;Sonnig;11;11;0;Stadt Konstanz, Amt für Stadtplanung und Umwelt
09.10.2022 20:00;170;77;93;Sonnig;9;9;0;Stadt Konstanz, Amt für Stadtplanung und Umwelt
09.10.2022 21:00;126;63;63;Sonnig;8;8;0;Stadt Konstanz, Amt für Stadtplanung und Umwelt
09.10.2022 22:00;116;54;62;Sonnig;8;8;0;Stadt Konstanz, Amt für Stadtplanung und Umwelt
09.10.2022 23:00;69;29;40;Leicht bewoelkt;9;9;0;Stadt Konstanz, Amt für Stadtplanung und Umwelt
10.10.2022 00:00;35;16;19;Leicht bewoelkt;9;9;0;Stadt Konstanz, Amt für Stadtplanung und Umwelt
10.10.2022 01:00;17;7;10;Leicht bewoelkt;9;9;0;Stadt Konstanz, Amt für Stadtplanung und Umwelt
10.10.2022 02:00;2;1;1;Bedeckt;9;9;0;Stadt Konstanz, Amt für Stadtplanung und Umwelt
10.10.2022 03:00;4;2;2;Bedeckt;8;9;0;Stadt Konstanz, Amt für Stadtplanung und Umwelt
10.10.2022 04:00;8;5;3;Bedeckt;8;8;0;Stadt Konstanz, Amt für Stadtplanung und Umwelt
10.10.2022 05:00;48;32;16;Bedeckt;8;8;0;Stadt Konstanz, Amt für Stadtplanung und Umwelt
10.10.2022 06:00;189;107;82;Bedeckt;8;8;0;Stadt Konstanz, Amt für Stadtplanung und Umwelt
10.10.2022 07:00;1066;710;356;Bedeckt;10;10;0;Stadt Konstanz, Amt für Stadtplanung und Umwelt
10.10.2022 08:00;710;374;336;Bewoelkt;11;11;0;Stadt Konstanz, Amt für Stadtplanung und Umwelt
10.10.2022 09:00;732;439;293;Bewoelkt;12;13;0;Stadt Konstanz, Amt für Stadtplanung und Umwelt
10.10.2022 10:00;395;221;174;Bewoelkt;13;14;0;Stadt Konstanz, Amt für Stadtplanung und Umwelt
10.10.2022 11:00;610;321;289;Bewoelkt;14;14;0;Stadt Konstanz, Amt für Stadtplanung und Umwelt
10.10.2022 12:00;593;269;324;Bewoelkt;15;15;0;Stadt Konstanz, Amt für Stadtplanung und Umwelt
10.10.2022 13:00;899;405;494;Bewoelkt;16;16;0;Stadt Konstanz, Amt für Stadtplanung und Umwelt
10.10.2022 14:00;691;340;351;Sonnig;17;17;0;Stadt Konstanz, Amt für Stadtplanung und Umwelt
10.10.2022 15:00;1032;502;530;Sonnig;18;18;0;Stadt Konstanz, Amt für Stadtplanung und Umwelt
10.10.2022 16:00;885;422;463;Sonnig;16;16;0;Stadt Konstanz, Amt für Stadtplanung und Umwelt
10.10.2022 17:00;1136;512;624;Sonnig;15;15;0;Stadt Konstanz, Amt für Stadtplanung und Umwelt
10.10.2022 18:00;798;342;456;Sonnig;13;13;0;Stadt Konstanz, Amt für Stadtplanung und Umwelt
10.10.2022 19:00;586;258;328;Sonnig;12;12;0;Stadt Konstanz, Amt für Stadtplanung und Umwelt
10.10.2022 20:00;397;194;203;Sonnig;11;11;0;Stadt Konstanz, Amt für Stadtplanung und Umwelt
10.10.2022 21:00;245;120;125;Sonnig;10;10;0;Stadt Konstanz, Amt für Stadtplanung und Umwelt
10.10.2022 22:00;193;73;120;Sonnig;10;10;0;Stadt Konstanz, Amt für Stadtplanung und Umwelt
10.10.2022 23:00;85;26;59;Leicht bewoelkt;10;10;0;Stadt Konstanz, Amt für Stadtplanung und Umwelt
11.10.2022 00:00;46;17;29;Leicht bewoelkt;9;9;0;Stadt Konstanz, Amt für Stadtplanung und Umwelt
11.10.2022 01:00;40;17;23;Leicht bewoelkt;9;9;0;Stadt Konstanz, Amt für Stadtplanung und Umwelt
11.10.2022 02:00;19;13;6;Leicht bewoelkt;9;9;0;Stadt Konstanz, Amt für Stadtplanung und Umwelt
11.10.2022 03:00;14;6;8;Leicht bewoelkt;9;9;0;Stadt Konstanz, Amt für Stadtplanung und Umwelt
11.10.2022 04:00;14;11;3;Leicht bewoelkt;9;9;0;Stadt Konstanz, Amt für Stadtplanung und Umwelt
11.10.2022 05:00;44;28;16;Bewoelkt;9;9;0;Stadt Konstanz, Amt für Stadtplanung und Umwelt
11.10.2022 06:00;195;112;83;Bewoelkt;9;9;0;Stadt Konstanz, Amt für Stadtplanung und Umwelt
11.10.2022 07:00;1116;726;390;Bewoelkt;10;10;0;Stadt Konstanz, Amt für Stadtplanung und Umwelt
11.10.2022 08:00;782;440;342;Leicht bewoelkt;11;11;0;Stadt Konstanz, Amt für Stadtplanung und Umwelt
11.10.2022 09:00;801;520;281;Leicht bewoelkt;13;13;0;Stadt Konstanz, Amt für Stadtplanung und Umwelt
11.10.2022 10:00;506;286;220;Leicht bewoelkt;14;14;0;Stadt Konstanz, Amt für Stadtplanung und Umwelt
11.10.2022 11:00;707;369;338;Leicht bewoelkt;15;15;0;Stadt Konstanz, Amt für Stadtplanung und Umwelt
11.10.2022 12:00;712;309;403;Leicht bewoelkt;17;17;0;Stadt Konstanz, Amt für Stadtplanung und Umwelt
11.10.2022 13:00;1035;493;542;Leicht bewoelkt;17;17;0;Stadt Konstanz, Amt für Stadtplanung und Umwelt
11.10.2022 14:00;754;386;368;Leicht bewoelkt;17;17;0;Stadt Konstanz, Amt für Stadtplanung und Umwelt
11.10.2022 15:00;1187;571;616;Leicht bewoelkt;18;18;0;Stadt Konstanz, Amt für Stadtplanung und Umwelt
11.10.2022 16:00;999;464;535;Leicht bewoelkt;16;16;0;Stadt Konstanz, Amt für Stadtplanung und Umwelt
11.10.2022 17:00;1191;536;655;Leicht bewoelkt;14;15;0;Stadt Konstanz, Amt für Stadtplanung und Umwelt
11.10.2022 18:00;893;381;512;Leicht bewoelkt;13;13;0;Stadt Konstanz, Amt für Stadtplanung und Umwelt
11.10.2022 19:00;654;281;373;Leicht bewoelkt;12;12;0;Stadt Konstanz, Amt für Stadtplanung und Umwelt
11.10.2022 20:00;401;179;222;Bewoelkt;12;12;0;Stadt Konstanz, Amt für Stadtplanung und Umwelt
11.10.2022 21:00;281;108;173;Bewoelkt;11;11;0;Stadt Konstanz, Amt für Stadtplanung und Umwelt
11.10.2022 22:00;224;82;142;Bewoelkt;10;10;0;Stadt Konstanz, Amt für Stadtplanung und Umwelt
11.10.2022 23:00;128;50;78;Leicht bewoelkt;10;9;0;Stadt Konstanz, Amt für Stadtplanung und Umwelt
12.10.2022 00:00;49;26;23;Leicht bewoelkt;9;8;0;Stadt Konstanz, Amt für Stadtplanung und Umwelt
12.10.2022 01:00;27;13;14;Leicht bewoelkt;9;8;0;Stadt Konstanz, Amt für Stadtplanung und Umwelt
12.10.2022 02:00;13;8;5;Leichter Nebel;8;8;0;Stadt Konstanz, Amt für Stadtplanung und Umwelt
12.10.2022 03:00;4;1;3;Leichter Nebel;8;8;0;Stadt Konstanz, Amt für Stadtplanung und Umwelt
12.10.2022 04:00;13;12;1;Leichter Nebel;8;8;0;Stadt Konstanz, Amt für Stadtplanung und Umwelt
12.10.2022 05:00;54;34;20;Leichter Nebel;7;7;0;Stadt Konstanz, Amt für Stadtplanung und Umwelt
12.10.2022 06:00;188;102;86;Leichter Nebel;7;7;0;Stadt Konstanz, Amt für Stadtplanung und Umwelt
12.10.2022 07:00;1189;823;366;Leichter Nebel;9;9;0;Stadt Konstanz, Amt für Stadtplanung und Umwelt
12.10.2022 08:00;811;467;344;Leicht bewoelkt;11;11;0;Stadt Konstanz, Amt für Stadtplanung und Umwelt
12.10.2022 09:00;726;427;299;Leicht bewoelkt;12;12;0;Stadt Konstanz, Amt für Stadtplanung und Umwelt
12.10.2022 10:00;457;226;231;Leicht bewoelkt;14;14;0;Stadt Konstanz, Amt für Stadtplanung und Umwelt
12.10.2022 11:00;602;276;326;Leicht bewoelkt;15;15;0;Stadt Konstanz, Amt für Stadtplanung und Umwelt
12.10.2022 12:00;727;327;400;Leicht bewoelkt;17;17;0;Stadt Konstanz, Amt für Stadtplanung und Umwelt
12.10.2022 13:00;1067;558;509;Leicht bewoelkt;17;17;0;Stadt Konstanz, Amt für Stadtplanung und Umwelt
12.10.2022 14:00;648;327;321;Sonnig;18;18;0;Stadt Konstanz, Amt für Stadtplanung und Umwelt
12.10.2022 15:00;1006;423;583;Sonnig;18;18;0;Stadt Konstanz, Amt für Stadtplanung und Umwelt
12.10.2022 16:00;940;455;485;Sonnig;16;16;0;Stadt Konstanz, Amt für Stadtplanung und Umwelt
12.10.2022 17:00;1177;517;660;Sonnig;14;14;0;Stadt Konstanz, Amt für Stadtplanung und Umwelt
12.10.2022 18:00;842;365;477;Sonnig;12;13;0;Stadt Konstanz, Amt für Stadtplanung und Umwelt
12.10.2022 19:00;596;293;303;Sonnig;11;11;0;Stadt Konstanz, Amt für Stadtplanung und Umwelt
12.10.2022 20:00;414;211;203;Sonnig;10;10;0;Stadt Konstanz, Amt für Stadtplanung und Umwelt
12.10.2022 21:00;273;108;165;Sonnig;9;9;0;Stadt Konstanz, Amt für Stadtplanung und Umwelt
12.10.2022 22:00;216;93;123;Sonnig;9;9;0;Stadt Konstanz, Amt für Stadtplanung und Umwelt
12.10.2022 23:00;144;58;86;Sonnig;8;8;0;Stadt Konstanz, Amt für Stadtplanung und Umwelt
13.10.2022 00:00;80;23;57;Sonnig;8;8;0;Stadt Konstanz, Amt für Stadtplanung und Umwelt
13.10.2022 01:00;63;11;52;Sonnig;8;8;0;Stadt Konstanz, Amt für Stadtplanung und Umwelt
13.10.2022 02:00;18;5;13;Sonnig;7;7;0;Stadt Konstanz, Amt für Stadtplanung und Umwelt
13.10.2022 03:00;5;1;4;Sonnig;7;7;0;Stadt Konstanz, Amt für Stadtplanung und Umwelt
13.10.2022 04:00;9;5;4;Sonnig;7;7;0;Stadt Konstanz, Amt für Stadtplanung und Umwelt
13.10.2022 05:00;64;49;15;Leichter Nebel;7;7;0;Stadt Konstanz, Amt für Stadtplanung und Umwelt
13.10.2022 06:00;174;91;83;Leichter Nebel;6;6;0;Stadt Konstanz, Amt für Stadtplanung und Umwelt
13.10.2022 07:00;1088;720;368;Leichter Nebel;8;8;0;Stadt Konstanz, Amt für Stadtplanung und Umwelt
13.10.2022 08:00;756;416;340;Sonnig;10;10;0;Stadt Konstanz, Amt für Stadtplanung und Umwelt
13.10.2022 09:00;760;459;301;Sonnig;12;12;0;Stadt Konstanz, Amt für Stadtplanung und Umwelt
13.10.2022 10:00;491;291;200;Sonnig;13;13;0;Stadt Konstanz, Amt für Stadtplanung und Umwelt
13.10.2022 11:00;638;334;304;Bewoelkt;15;15;0;Stadt Konstanz, Amt für Stadtplanung und Umwelt
13.10.2022 12:00;681;308;373;Bewoelkt;17;17;0;Stadt Konstanz, Amt für Stadtplanung und Umwelt
13.10.2022 13:00;1046;472;574;Bewoelkt;17;17;0;Stadt Konstanz, Amt für Stadtplanung und Umwelt
13.10.2022 14:00;667;313;354;Leicht bewoelkt;17;17;0;Stadt Konstanz, Amt für Stadtplanung und Umwelt
13.10.2022 15:00;1065;507;558;Leicht bewoelkt;17;17;0;Stadt Konstanz, Amt für Stadtplanung und Umwelt
13.10.2022 16:00;899;441;458;Leicht bewoelkt;15;15;0;Stadt Konstanz, Amt für Stadtplanung und Umwelt
13.10.2022 17:00;1073;449;624;Bedeckt;14;14;0;Stadt Konstanz, Amt für Stadtplanung und Umwelt
13.10.2022 18:00;841;364;477;Bedeckt;12;12;0;Stadt Konstanz, Amt für Stadtplanung und Umwelt
13.10.2022 19:00;607;300;307;Bedeckt;12;12;0;Stadt Konstanz, Amt für Stadtplanung und Umwelt
13.10.2022 20:00;383;183;200;Bewoelkt;11;11;0;Stadt Konstanz, Amt für Stadtplanung und Umwelt
13.10.2022 21:00;272;121;151;Bewoelkt;11;11;0;Stadt Konstanz, Amt für Stadtplanung und Umwelt
13.10.2022 22:00;191;73;118;Bewoelkt;11;10;0;Stadt Konstanz, Amt für Stadtplanung und Umwelt
13.10.2022 23:00;139;51;88;Stellenweiser Regenfall;10;10;0;Stadt Konstanz, Amt für Stadtplanung und Umwelt
14.10.2022 00:00;68;36;32;Stellenweiser Regenfall;10;9;0.1;Stadt Konstanz, Amt für Stadtplanung und Umwelt
14.10.2022 01:00;67;23;44;Stellenweiser Regenfall;9;9;0;Stadt Konstanz, Amt für Stadtplanung und Umwelt
14.10.2022 02:00;22;11;11;Leicht bewoelkt;9;9;0;Stadt Konstanz, Amt für Stadtplanung und Umwelt
14.10.2022 03:00;18;11;7;Leicht bewoelkt;9;9;0;Stadt Konstanz, Amt für Stadtplanung und Umwelt
14.10.2022 04:00;21;12;9;Leicht bewoelkt;9;9;0;Stadt Konstanz, Amt für Stadtplanung und Umwelt
14.10.2022 05:00;39;30;9;Leicht bewoelkt;9;9;0;Stadt Konstanz, Amt für Stadtplanung und Umwelt
14.10.2022 06:00;148;78;70;Leicht bewoelkt;9;9;0;Stadt Konstanz, Amt für Stadtplanung und Umwelt
14.10.2022 07:00;944;624;320;Leicht bewoelkt;10;10;0;Stadt Konstanz, Amt für Stadtplanung und Umwelt
14.10.2022 08:00;717;423;294;Leicht bewoelkt;11;11;0;Stadt Konstanz, Amt für Stadtplanung und Umwelt
14.10.2022 09:00;650;398;252;Leicht bewoelkt;12;13;0;Stadt Konstanz, Amt für Stadtplanung und Umwelt
14.10.2022 10:00;514;266;248;Leicht bewoelkt;14;14;0;Stadt Konstanz, Amt für Stadtplanung und Umwelt
14.10.2022 11:00;701;290;411;Leicht bewoelkt;15;15;0;Stadt Konstanz, Amt für Stadtplanung und Umwelt
14.10.2022 12:00;771;341;430;Leicht bewoelkt;17;17;0;Stadt Konstanz, Amt für Stadtplanung und Umwelt
14.10.2022 13:00;844;381;463;Leicht bewoelkt;17;17;0;Stadt Konstanz, Amt für Stadtplanung und Umwelt
14.10.2022 14:00;578;268;310;Leicht bewoelkt;17;17;0;Stadt Konstanz, Amt für Stadtplanung und Umwelt
14.10.2022 15:00;665;334;331;Leicht bewoelkt;18;18;0;Stadt Konstanz, Amt für Stadtplanung und Umwelt
14.10.2022 16:00;599;285;314;Leicht bewoelkt;16;16;0;Stadt Konstanz, Amt für Stadtplanung und Umwelt
14.10.2022 17:00;685;297;388;Bewoelkt;14;14;0;Stadt Konstanz, Amt für Stadtplanung und Umwelt
14.10.2022 18:00;526;233;293;Bewoelkt;12;12;0;Stadt Konstanz, Amt für Stadtplanung und Umwelt
14.10.2022 19:00;426;195;231;Bewoelkt;11;11;0;Stadt Konstanz, Amt für Stadtplanung und Umwelt
14.10.2022 20:00;315;164;151;Bewoelkt;11;11;0;Stadt Konstanz, Amt für Stadtplanung und Umwelt
14.10.2022 21:00;193;104;89;Bewoelkt;11;10;0;Stadt Konstanz, Amt für Stadtplanung und Umwelt
14.10.2022 22:00;161;79;82;Bewoelkt;11;11;0;Stadt Konstanz, Amt für Stadtplanung und Umwelt
14.10.2022 23:00;160;62;98;Leichter Regenfall;12;11;0.3;Stadt Konstanz, Amt für Stadtplanung und Umwelt
15.10.2022 00:00;109;33;76;Leichter Regenfall;12;12;0.6;Stadt Konstanz, Amt für Stadtplanung und Umwelt
15.10.2022 01:00;63;18;45;Leichter Regenfall;13;12;0.3;Stadt Konstanz, Amt für Stadtplanung und Umwelt
15.10.2022 02:00;54;24;30;Bedeckt;13;12;0;Stadt Konstanz, Amt für Stadtplanung und Umwelt
15.10.2022 03:00;36;21;15;Bedeckt;13;12;0;Stadt Konstanz, Amt für Stadtplanung und Umwelt
15.10.2022 04:00;28;7;21;Bedeckt;13;12;0;Stadt Konstanz, Amt für Stadtplanung und Umwelt
15.10.2022 05:00;23;16;7;Nieselregen;13;12;0.1;Stadt Konstanz, Amt für Stadtplanung und Umwelt
15.10.2022 06:00;34;20;14;Nieselregen;13;12;0.1;Stadt Konstanz, Amt für Stadtplanung und Umwelt
15.10.2022 07:00;63;29;34;Nieselregen;14;13;0.1;Stadt Konstanz, Amt für Stadtplanung und Umwelt
15.10.2022 08:00;150;76;74;Bewoelkt;14;14;0;Stadt Konstanz, Amt für Stadtplanung und Umwelt
15.10.2022 09:00;294;189;105;Bewoelkt;15;15;0;Stadt Konstanz, Amt für Stadtplanung und Umwelt
15.10.2022 10:00;382;188;194;Bewoelkt;17;17;0;Stadt Konstanz, Amt für Stadtplanung und Umwelt
15.10.2022 11:00;492;264;228;Leicht bewoelkt;18;18;0;Stadt Konstanz, Amt für Stadtplanung und Umwelt
15.10.2022 12:00;564;309;255;Leicht bewoelkt;20;20;0;Stadt Konstanz, Amt für Stadtplanung und Umwelt
15.10.2022 13:00;468;216;252;Leicht bewoelkt;19;19;0;Stadt Konstanz, Amt für Stadtplanung und Umwelt
15.10.2022 14:00;537;268;269;Bedeckt;19;19;0;Stadt Konstanz, Amt für Stadtplanung und Umwelt
15.10.2022 15:00;528;256;272;Bedeckt;19;19;0;Stadt Konstanz, Amt für Stadtplanung und Umwelt
15.10.2022 16:00;513;234;279;Bedeckt;18;17;0;Stadt Konstanz, Amt für Stadtplanung und Umwelt
15.10.2022 17:00;544;240;304;Bedeckt;16;16;0;Stadt Konstanz, Amt für Stadtplanung und Umwelt
15.10.2022 18:00;457;195;262;Bedeckt;15;15;0;Stadt Konstanz, Amt für Stadtplanung und Umwelt
15.10.2022 19:00;394;190;204;Bedeckt;14;14;0;Stadt Konstanz, Amt für Stadtplanung und Umwelt
15.10.2022 20:00;322;160;162;Leicht bewoelkt;13;13;0;Stadt Konstanz, Amt für Stadtplanung und Umwelt
15.10.2022 21:00;282;143;139;Leicht bewoelkt;13;13;0;Stadt Konstanz, Amt für Stadtplanung und Umwelt
15.10.2022 22:00;217;84;133;Leicht bewoelkt;12;12;0;Stadt Konstanz, Amt für Stadtplanung und Umwelt
15.10.2022 23:00;171;63;108;Sonnig;12;12;0;Stadt Konstanz, Amt für Stadtplanung und Umwelt
16.10.2022 00:00;145;50;95;Sonnig;11;11;0;Stadt Konstanz, Amt für Stadtplanung und Umwelt
16.10.2022 01:00;133;45;88;Sonnig;11;11;0;Stadt Konstanz, Amt für Stadtplanung und Umwelt
16.10.2022 02:00;77;34;43;Sonnig;10;11;0;Stadt Konstanz, Amt für Stadtplanung und Umwelt
16.10.2022 03:00;53;20;33;Sonnig;10;10;0;Stadt Konstanz, Amt für Stadtplanung und Umwelt
16.10.2022 04:00;33;8;25;Sonnig;10;10;0;Stadt Konstanz, Amt für Stadtplanung und Umwelt
16.10.2022 05:00;39;26;13;Sonnig;10;10;0;Stadt Konstanz, Amt für Stadtplanung und Umwelt
16.10.2022 06:00;32;18;14;Sonnig;9;9;0;Stadt Konstanz, Amt für Stadtplanung und Umwelt
16.10.2022 07:00;47;23;24;Sonnig;11;11;0;Stadt Konstanz, Amt für Stadtplanung und Umwelt
16.10.2022 08:00;80;40;40;Sonnig;13;13;0;Stadt Konstanz, Amt für Stadtplanung und Umwelt
16.10.2022 09:00;206;108;98;Sonnig;15;15;0;Stadt Konstanz, Amt für Stadtplanung und Umwelt
16.10.2022 10:00;263;175;88;Sonnig;17;17;0;Stadt Konstanz, Amt für Stadtplanung und Umwelt
16.10.2022 11:00;389;211;178;Sonnig;19;19;0;Stadt Konstanz, Amt für Stadtplanung und Umwelt
16.10.2022 12:00;476;221;255;Sonnig;21;21;0;Stadt Konstanz, Amt für Stadtplanung und Umwelt
16.10.2022 13:00;525;210;315;Sonnig;21;21;0;Stadt Konstanz, Amt für Stadtplanung und Umwelt
16.10.2022 14:00;585;298;287;Sonnig;21;21;0;Stadt Konstanz, Amt für Stadtplanung und Umwelt
16.10.2022 15:00;585;284;301;Sonnig;21;21;0;Stadt Konstanz, Amt für Stadtplanung und Umwelt
16.10.2022 16:00;583;297;286;Sonnig;19;19;0;Stadt Konstanz, Amt für Stadtplanung und Umwelt
16.10.2022 17:00;574;278;296;Sonnig;17;17;0;Stadt Konstanz, Amt für Stadtplanung und Umwelt
16.10.2022 18:00;455;230;225;Sonnig;14;15;0;Stadt Konstanz, Amt für Stadtplanung und Umwelt
16.10.2022 19:00;327;143;184;Sonnig;13;14;0;Stadt Konstanz, Amt für Stadtplanung und Umwelt
16.10.2022 20:00;218;101;117;Sonnig;13;13;0;Stadt Konstanz, Amt für Stadtplanung und Umwelt
16.10.2022 21:00;180;62;118;Sonnig;12;12;0;Stadt Konstanz, Amt für Stadtplanung und Umwelt
16.10.2022 22:00;125;55;70;Sonnig;11;12;0;Stadt Konstanz, Amt für Stadtplanung und Umwelt
16.10.2022 23:00;72;28;44;Sonnig;11;12;0;Stadt Konstanz, Amt für Stadtplanung und Umwelt
17.10.2022 00:00;35;15;20;Sonnig;11;11;0;Stadt Konstanz, Amt für Stadtplanung und Umwelt
17.10.2022 01:00;21;11;10;Sonnig;11;11;0;Stadt Konstanz, Amt für Stadtplanung und Umwelt
17.10.2022 02:00;6;3;3;Sonnig;10;11;0;Stadt Konstanz, Amt für Stadtplanung und Umwelt
17.10.2022 03:00;7;2;5;Sonnig;10;10;0;Stadt Konstanz, Amt für Stadtplanung und Umwelt
17.10.2022 04:00;17;9;8;Sonnig;10;10;0;Stadt Konstanz, Amt für Stadtplanung und Umwelt
17.10.2022 05:00;65;44;21;Sonnig;9;9;0;Stadt Konstanz, Amt für Stadtplanung und Umwelt
17.10.2022 06:00;148;88;60;Sonnig;9;9;0;Stadt Konstanz, Amt für Stadtplanung und Umwelt
17.10.2022 07:00;1052;690;362;Sonnig;11;11;0;Stadt Konstanz, Amt für Stadtplanung und Umwelt
17.10.2022 08:00;799;433;366;Sonnig;13;13;0;Stadt Konstanz, Amt für Stadtplanung und Umwelt
17.10.2022 09:00;762;456;306;Sonnig;15;15;0;Stadt Konstanz, Amt für Stadtplanung und Umwelt
17.10.2022 10:00;406;232;174;Sonnig;17;17;0;Stadt Konstanz, Amt für Stadtplanung und Umwelt
17.10.2022 11:00;546;273;273;Sonnig;19;19;0;Stadt Konstanz, Amt für Stadtplanung und Umwelt
17.10.2022 12:00;680;318;362;Sonnig;22;22;0;Stadt Konstanz, Amt für Stadtplanung und Umwelt
17.10.2022 13:00;988;449;539;Sonnig;22;25;0;Stadt Konstanz, Amt für Stadtplanung und Umwelt
17.10.2022 14:00;703;358;345;Sonnig;22;25;0;Stadt Konstanz, Amt für Stadtplanung und Umwelt
17.10.2022 15:00;1131;554;577;Sonnig;23;25;0;Stadt Konstanz, Amt für Stadtplanung und Umwelt
17.10.2022 16:00;1084;510;574;Sonnig;20;20;0;Stadt Konstanz, Amt für Stadtplanung und Umwelt
17.10.2022 17:00;1214;510;704;Sonnig;18;18;0;Stadt Konstanz, Amt für Stadtplanung und Umwelt
17.10.2022 18:00;961;402;559;Sonnig;16;16;0;Stadt Konstanz, Amt für Stadtplanung und Umwelt
17.10.2022 19:00;652;263;389;Sonnig;14;14;0;Stadt Konstanz, Amt für Stadtplanung und Umwelt
17.10.2022 20:00;417;178;239;Sonnig;13;13;0;Stadt Konstanz, Amt für Stadtplanung und Umwelt
17.10.2022 21:00;298;145;153;Sonnig;11;12;0;Stadt Konstanz, Amt für Stadtplanung und Umwelt
17.10.2022 22:00;244;123;121;Sonnig;11;11;0;Stadt Konstanz, Amt für Stadtplanung und Umwelt
17.10.2022 23:00;121;76;45;Sonnig;11;11;0;Stadt Konstanz, Amt für Stadtplanung und Umwelt
18.10.2022 00:00;62;19;43;Sonnig;10;10;0;Stadt Konstanz, Amt für Stadtplanung und Umwelt
18.10.2022 01:00;40;25;15;Sonnig;10;10;0;Stadt Konstanz, Amt für Stadtplanung und Umwelt
18.10.2022 02:00;21;15;6;Sonnig;10;10;0;Stadt Konstanz, Amt für Stadtplanung und Umwelt
18.10.2022 03:00;15;9;6;Sonnig;10;9;0;Stadt Konstanz, Amt für Stadtplanung und Umwelt
18.10.2022 04:00;12;7;5;Sonnig;10;9;0;Stadt Konstanz, Amt für Stadtplanung und Umwelt
18.10.2022 05:00;60;44;16;Sonnig;9;9;0;Stadt Konstanz, Amt für Stadtplanung und Umwelt
18.10.2022 06:00;178;103;75;Sonnig;9;9;0;Stadt Konstanz, Amt für Stadtplanung und Umwelt
18.10.2022 07:00;1082;728;354;Sonnig;11;11;0;Stadt Konstanz, Amt für Stadtplanung und Umwelt
18.10.2022 08:00;817;446;371;Sonnig;13;13;0;Stadt Konstanz, Amt für Stadtplanung und Umwelt
18.10.2022 09:00;852;519;333;Sonnig;14;15;0;Stadt Konstanz, Amt für Stadtplanung und Umwelt
18.10.2022 10:00;518;303;215;Sonnig;16;16;0;Stadt Konstanz, Amt für Stadtplanung und Umwelt
18.10.2022 11:00;662;349;313;Bewoelkt;18;18;0;Stadt Konstanz, Amt für Stadtplanung und Umwelt
18.10.2022 12:00;677;292;385;Bewoelkt;20;20;0;Stadt Konstanz, Amt für Stadtplanung und Umwelt
18.10.2022 13:00;1045;442;603;Bewoelkt;20;20;0;Stadt Konstanz, Amt für Stadtplanung und Umwelt
18.10.2022 14:00;865;442;423;Leicht bewoelkt;20;20;0;Stadt Konstanz, Amt für Stadtplanung und Umwelt
18.10.2022 15:00;1154;516;638;Leicht bewoelkt;20;20;0;Stadt Konstanz, Amt für Stadtplanung und Umwelt
18.10.2022 16:00;1052;521;531;Leicht bewoelkt;19;19;0;Stadt Konstanz, Amt für Stadtplanung und Umwelt
18.10.2022 17:00;1255;515;740;Sonnig;18;18;0;Stadt Konstanz, Amt für Stadtplanung und Umwelt
18.10.2022 18:00;989;429;560;Sonnig;16;16;0;Stadt Konstanz, Amt für Stadtplanung und Umwelt
18.10.2022 19:00;727;299;428;Sonnig;15;15;0;Stadt Konstanz, Amt für Stadtplanung und Umwelt
18.10.2022 20:00;474;215;259;Leichter Nebel;14;14;0;Stadt Konstanz, Amt für Stadtplanung und Umwelt
18.10.2022 21:00;321;160;161;Leichter Nebel;14;14;0;Stadt Konstanz, Amt für Stadtplanung und Umwelt
18.10.2022 22:00;221;89;132;Leichter Nebel;13;13;0;Stadt Konstanz, Amt für Stadtplanung und Umwelt
18.10.2022 23:00;121;51;70;Sonnig;12;12;0;Stadt Konstanz, Amt für Stadtplanung und Umwelt
19.10.2022 00:00;80;24;56;Sonnig;12;12;0;Stadt Konstanz, Amt für Stadtplanung und Umwelt
19.10.2022 01:00;58;14;44;Sonnig;11;11;0;Stadt Konstanz, Amt für Stadtplanung und Umwelt
19.10.2022 02:00;9;3;6;Sonnig;11;11;0;Stadt Konstanz, Amt für Stadtplanung und Umwelt
19.10.2022 03:00;8;3;5;Sonnig;10;10;0;Stadt Konstanz, Amt für Stadtplanung und Umwelt
19.10.2022 04:00;13;9;4;Sonnig;10;10;0;Stadt Konstanz, Amt für Stadtplanung und Umwelt
19.10.2022 05:00;53;36;17;Sonnig;10;10;0;Stadt Konstanz, Amt für Stadtplanung und Umwelt
19.10.2022 06:00;186;108;78;Sonnig;10;10;0;Stadt Konstanz, Amt für Stadtplanung und Umwelt
19.10.2022 07:00;1188;801;387;Sonnig;11;11;0;Stadt Konstanz, Amt für Stadtplanung und Umwelt
19.10.2022 08:00;850;504;346;Sonnig;13;13;0;Stadt Konstanz, Amt für Stadtplanung und Umwelt
19.10.2022 09:00;648;370;278;Sonnig;14;14;0;Stadt Konstanz, Amt für Stadtplanung und Umwelt
19.10.2022 10:00;452;261;191;Sonnig;16;16;0;Stadt Konstanz, Amt für Stadtplanung und Umwelt
19.10.2022 11:00;652;292;360;Sonnig;18;18;0;Stadt Konstanz, Amt für Stadtplanung und Umwelt
19.10.2022 12:00;793;375;418;Sonnig;19;19;0;Stadt Konstanz, Amt für Stadtplanung und Umwelt
19.10.2022 13:00;1210;582;628;Sonnig;20;20;0;Stadt Konstanz, Amt für Stadtplanung und Umwelt
19.10.2022 14:00;804;390;414;Sonnig;20;20;0;Stadt Konstanz, Amt für Stadtplanung und Umwelt
19.10.2022 15:00;1076;506;570;Sonnig;20;20;0;Stadt Konstanz, Amt für Stadtplanung und Umwelt
19.10.2022 16:00;1011;406;605;Sonnig;19;19;0;Stadt Konstanz, Amt für Stadtplanung und Umwelt
19.10.2022 17:00;1091;442;649;Sonnig;17;17;0;Stadt Konstanz, Amt für Stadtplanung und Umwelt
19.10.2022 18:00;1109;508;601;Sonnig;15;15;0;Stadt Konstanz, Amt für Stadtplanung und Umwelt
19.10.2022 19:00;664;308;356;Sonnig;14;14;0;Stadt Konstanz, Amt für Stadtplanung und Umwelt
19.10.2022 20:00;470;221;249;Sonnig;13;13;0;Stadt Konstanz, Amt für Stadtplanung und Umwelt
19.10.2022 21:00;356;169;187;Sonnig;12;12;0;Stadt Konstanz, Amt für Stadtplanung und Umwelt
19.10.2022 22:00;225;106;119;Sonnig;11;11;0;Stadt Konstanz, Amt für Stadtplanung und Umwelt
19.10.2022 23:00;155;56;99;Leicht bewoelkt;11;11;0;Stadt Konstanz, Amt für Stadtplanung und Umwelt
20.10.2022 00:00;87;27;60;Leicht bewoelkt;10;10;0;Stadt Konstanz, Amt für Stadtplanung und Umwelt
20.10.2022 01:00;65;23;42;Leicht bewoelkt;10;11;0;Stadt Konstanz, Amt für Stadtplanung und Umwelt
20.10.2022 02:00;25;12;13;Leicht bewoelkt;11;11;0;Stadt Konstanz, Amt für Stadtplanung und Umwelt
20.10.2022 03:00;14;8;6;Leicht bewoelkt;11;12;0;Stadt Konstanz, Amt für Stadtplanung und Umwelt
20.10.2022 04:00;10;5;5;Leicht bewoelkt;11;12;0;Stadt Konstanz, Amt für Stadtplanung und Umwelt
20.10.2022 05:00;52;33;19;Sonnig;11;11;0;Stadt Konstanz, Amt für Stadtplanung und Umwelt
20.10.2022 06:00;166;102;64;Sonnig;11;11;0;Stadt Konstanz, Amt für Stadtplanung und Umwelt
20.10.2022 07:00;1038;723;315;Sonnig;12;12;0;Stadt Konstanz, Amt für Stadtplanung und Umwelt
20.10.2022 08:00;797;456;341;Sonnig;13;14;0;Stadt Konstanz, Amt für Stadtplanung und Umwelt
20.10.2022 09:00;725;436;289;Sonnig;14;15;0;Stadt Konstanz, Amt für Stadtplanung und Umwelt
20.10.2022 10:00;445;231;214;Sonnig;16;16;0;Stadt Konstanz, Amt für Stadtplanung und Umwelt
20.10.2022 11:00;665;336;329;Sonnig;17;17;0;Stadt Konstanz, Amt für Stadtplanung und Umwelt
20.10.2022 12:00;694;313;381;Sonnig;18;18;0;Stadt Konstanz, Amt für Stadtplanung und Umwelt
20.10.2022 13:00;996;436;560;Sonnig;18;18;0;Stadt Konstanz, Amt für Stadtplanung und Umwelt
20.10.2022 14:00;741;355;386;Leicht bewoelkt;18;18;0;Stadt Konstanz, Amt für Stadtplanung und Umwelt
20.10.2022 15:00;1076;481;595;Leicht bewoelkt;19;19;0;Stadt Konstanz, Amt für Stadtplanung und Umwelt
20.10.2022 16:00;974;457;517;Leicht bewoelkt;17;17;0;Stadt Konstanz, Amt für Stadtplanung und Umwelt
20.10.2022 17:00;1051;461;590;Leicht bewoelkt;15;16;0;Stadt Konstanz, Amt für Stadtplanung und Umwelt
20.10.2022 18:00;831;354;477;Leicht bewoelkt;13;14;0;Stadt Konstanz, Amt für Stadtplanung und Umwelt
20.10.2022 19:00;654;288;366;Leicht bewoelkt;13;13;0;Stadt Konstanz, Amt für Stadtplanung und Umwelt
20.10.2022 20:00;397;192;205;Bedeckt;12;12;0;Stadt Konstanz, Amt für Stadtplanung und Umwelt
20.10.2022 21:00;282;134;148;Bedeckt;12;12;0;Stadt Konstanz, Amt für Stadtplanung und Umwelt
20.10.2022 22:00;233;103;130;Bedeckt;12;12;0;Stadt Konstanz, Amt für Stadtplanung und Umwelt
20.10.2022 23:00;120;50;70;Leicht bewoelkt;12;12;0;Stadt Konstanz, Amt für Stadtplanung und Umwelt
21.10.2022 00:00;73;14;59;Leicht bewoelkt;12;12;0;Stadt Konstanz, Amt für Stadtplanung und Umwelt
21.10.2022 01:00;75;33;42;Leicht bewoelkt;12;12;0;Stadt Konstanz, Amt für Stadtplanung und Umwelt
21.10.2022 02:00;17;13;4;Leicht bewoelkt;12;12;0;Stadt Konstanz, Amt für Stadtplanung und Umwelt
21.10.2022 03:00;12;5;7;Leicht bewoelkt;12;12;0;Stadt Konstanz, Amt für Stadtplanung und Umwelt
21.10.2022 04:00;20;13;7;Leicht bewoelkt;12;12;0;Stadt Konstanz, Amt für Stadtplanung und Umwelt
21.10.2022 05:00;41;26;15;Bewoelkt;12;12;0;Stadt Konstanz, Amt für Stadtplanung und Umwelt
21.10.2022 06:00;141;77;64;Bewoelkt;11;11;0;Stadt Konstanz, Amt für Stadtplanung und Umwelt
21.10.2022 07:00;920;595;325;Bewoelkt;12;12;0;Stadt Konstanz, Amt für Stadtplanung und Umwelt
21.10.2022 08:00;644;370;274;Bewoelkt;13;13;0;Stadt Konstanz, Amt für Stadtplanung und Umwelt
21.10.2022 09:00;546;328;218;Bewoelkt;14;14;0;Stadt Konstanz, Amt für Stadtplanung und Umwelt
21.10.2022 10:00;384;208;176;Bewoelkt;15;15;0;Stadt Konstanz, Amt für Stadtplanung und Umwelt
21.10.2022 11:00;528;277;251;Leicht bewoelkt;15;16;0;Stadt Konstanz, Amt für Stadtplanung und Umwelt
21.10.2022 12:00;667;315;352;Leicht bewoelkt;16;16;0;Stadt Konstanz, Amt für Stadtplanung und Umwelt
21.10.2022 13:00;907;358;549;Leicht bewoelkt;15;15;0;Stadt Konstanz, Amt für Stadtplanung und Umwelt
21.10.2022 14:00;574;272;302;Leichter Regenfall;15;14;0.6;Stadt Konstanz, Amt für Stadtplanung und Umwelt
21.10.2022 15:00;572;254;318;Leichter Regenfall;14;13;0.8;Stadt Konstanz, Amt für Stadtplanung und Umwelt
21.10.2022 16:00;643;303;340;Leichter Regenfall;14;13;0.4;Stadt Konstanz, Amt für Stadtplanung und Umwelt
21.10.2022 17:00;647;298;349;Leichter Regenfall;13;13;0.4;Stadt Konstanz, Amt für Stadtplanung und Umwelt
21.10.2022 18:00;566;239;327;Leichter Regenfall;13;12;0.5;Stadt Konstanz, Amt für Stadtplanung und Umwelt
21.10.2022 19:00;480;219;261;Leichter Regenfall;13;12;0.2;Stadt Konstanz, Amt für Stadtplanung und Umwelt
21.10.2022 20:00;381;187;194;Sonnig;12;12;0;Stadt Konstanz, Amt für Stadtplanung und Umwelt
21.10.2022 21:00;256;133;123;Sonnig;12;12;0;Stadt Konstanz, Amt für Stadtplanung und Umwelt
21.10.2022 22:00;204;77;127;Sonnig;12;12;0;Stadt Konstanz, Amt für Stadtplanung und Umwelt
21.10.2022 23:00;212;85;127;Bedeckt;12;12;0;Stadt Konstanz, Amt für Stadtplanung und Umwelt
22.10.2022 00:00;139;59;80;Bedeckt;12;12;0;Stadt Konstanz, Amt für Stadtplanung und Umwelt
22.10.2022 01:00;90;39;51;Bedeckt;12;12;0;Stadt Konstanz, Amt für Stadtplanung und Umwelt
22.10.2022 02:00;59;29;30;Leichter Regenschauer;12;12;0.1;Stadt Konstanz, Amt für Stadtplanung und Umwelt
22.10.2022 03:00;32;15;17;Leichter Regenschauer;12;11;0.1;Stadt Konstanz, Amt für Stadtplanung und Umwelt
22.10.2022 04:00;28;12;16;Leichter Regenschauer;11;11;0;Stadt Konstanz, Amt für Stadtplanung und Umwelt
22.10.2022 05:00;24;12;12;Leichter Regenschauer;11;10;0.1;Stadt Konstanz, Amt für Stadtplanung und Umwelt
22.10.2022 06:00;28;15;13;Leichter Regenschauer;11;10;0.2;Stadt Konstanz, Amt für Stadtplanung und Umwelt
22.10.2022 07:00;59;36;23;Leichter Regenschauer;11;10;0.1;Stadt Konstanz, Amt für Stadtplanung und Umwelt
22.10.2022 08:00;176;98;78;Maessiger Regenfall;12;11;0.9;Stadt Konstanz, Amt für Stadtplanung und Umwelt
22.10.2022 09:00;296;172;124;Maessiger Regenfall;12;11;01. Feb;Stadt Konstanz, Amt für Stadtplanung und Umwelt
22.10.2022 10:00;411;253;158;Maessiger Regenfall;12;12;0.6;Stadt Konstanz, Amt für Stadtplanung und Umwelt
22.10.2022 11:00;537;296;241;Stellenweiser leichter Regenfall;13;12;0.5;Stadt Konstanz, Amt für Stadtplanung und Umwelt
22.10.2022 12:00;576;269;307;Stellenweiser leichter Regenfall;13;13;0.7;Stadt Konstanz, Amt für Stadtplanung und Umwelt
22.10.2022 13:00;676;359;317;Stellenweiser leichter Regenfall;13;14;0.4;Stadt Konstanz, Amt für Stadtplanung und Umwelt
22.10.2022 14:00;797;393;404;Sonnig;14;15;0;Stadt Konstanz, Amt für Stadtplanung und Umwelt
22.10.2022 15:00;711;363;348;Sonnig;15;16;0;Stadt Konstanz, Amt für Stadtplanung und Umwelt
22.10.2022 16:00;682;305;377;Sonnig;14;14;0;Stadt Konstanz, Amt für Stadtplanung und Umwelt
22.10.2022 17:00;640;239;401;Sonnig;13;13;0;Stadt Konstanz, Amt für Stadtplanung und Umwelt
22.10.2022 18:00;660;290;370;Sonnig;11;11;0;Stadt Konstanz, Amt für Stadtplanung und Umwelt
22.10.2022 19:00;425;222;203;Sonnig;10;10;0;Stadt Konstanz, Amt für Stadtplanung und Umwelt
22.10.2022 20:00;357;189;168;Sonnig;9;9;0;Stadt Konstanz, Amt für Stadtplanung und Umwelt
22.10.2022 21:00;275;141;134;Sonnig;8;8;0;Stadt Konstanz, Amt für Stadtplanung und Umwelt
22.10.2022 22:00;203;83;120;Sonnig;8;8;0;Stadt Konstanz, Amt für Stadtplanung und Umwelt
22.10.2022 23:00;218;63;155;Sonnig;8;8;0;Stadt Konstanz, Amt für Stadtplanung und Umwelt
23.10.2022 00:00;212;51;161;Sonnig;8;8;0;Stadt Konstanz, Amt für Stadtplanung und Umwelt
23.10.2022 01:00;126;48;78;Sonnig;8;8;0;Stadt Konstanz, Amt für Stadtplanung und Umwelt
23.10.2022 02:00;75;39;36;Sonnig;8;7;0;Stadt Konstanz, Amt für Stadtplanung und Umwelt
23.10.2022 03:00;71;44;27;Sonnig;7;7;0;Stadt Konstanz, Amt für Stadtplanung und Umwelt
23.10.2022 04:00;44;24;20;Sonnig;7;7;0;Stadt Konstanz, Amt für Stadtplanung und Umwelt
23.10.2022 05:00;34;18;16;Sonnig;7;7;0;Stadt Konstanz, Amt für Stadtplanung und Umwelt
23.10.2022 06:00;27;14;13;Sonnig;7;7;0;Stadt Konstanz, Amt für Stadtplanung und Umwelt
23.10.2022 07:00;45;21;24;Sonnig;9;8;0;Stadt Konstanz, Amt für Stadtplanung und Umwelt
23.10.2022 08:00;85;47;38;Sonnig;10;10;0;Stadt Konstanz, Amt für Stadtplanung und Umwelt
23.10.2022 09:00;167;94;73;Sonnig;12;12;0;Stadt Konstanz, Amt für Stadtplanung und Umwelt
23.10.2022 10:00;220;107;113;Sonnig;15;15;0;Stadt Konstanz, Amt für Stadtplanung und Umwelt
23.10.2022 11:00;290;143;147;Sonnig;17;17;0;Stadt Konstanz, Amt für Stadtplanung und Umwelt
23.10.2022 12:00;369;166;203;Sonnig;20;20;0;Stadt Konstanz, Amt für Stadtplanung und Umwelt
23.10.2022 13:00;435;232;203;Sonnig;21;21;0;Stadt Konstanz, Amt für Stadtplanung und Umwelt
23.10.2022 14:00;471;261;210;Sonnig;22;22;0;Stadt Konstanz, Amt für Stadtplanung und Umwelt
23.10.2022 15:00;477;226;251;Sonnig;23;25;0;Stadt Konstanz, Amt für Stadtplanung und Umwelt
23.10.2022 16:00;425;191;234;Sonnig;20;20;0;Stadt Konstanz, Amt für Stadtplanung und Umwelt
23.10.2022 17:00;485;226;259;Sonnig;18;18;0;Stadt Konstanz, Amt für Stadtplanung und Umwelt
23.10.2022 18:00;346;160;186;Sonnig;15;15;0;Stadt Konstanz, Amt für Stadtplanung und Umwelt
23.10.2022 19:00;235;122;113;Sonnig;14;14;0;Stadt Konstanz, Amt für Stadtplanung und Umwelt
23.10.2022 20:00;189;102;87;Sonnig;13;12;0;Stadt Konstanz, Amt für Stadtplanung und Umwelt
23.10.2022 21:00;134;70;64;Sonnig;11;11;0;Stadt Konstanz, Amt für Stadtplanung und Umwelt
23.10.2022 22:00;111;50;61;Sonnig;12;11;0;Stadt Konstanz, Amt für Stadtplanung und Umwelt
23.10.2022 23:00;79;34;45;Bedeckt;12;11;0;Stadt Konstanz, Amt für Stadtplanung und Umwelt
24.10.2022 00:00;29;10;19;Bedeckt;13;11;0;Stadt Konstanz, Amt für Stadtplanung und Umwelt
24.10.2022 01:00;7;3;4;Bedeckt;13;12;0;Stadt Konstanz, Amt für Stadtplanung und Umwelt
24.10.2022 02:00;6;2;4;Stellenweiser Regenfall;12;12;0;Stadt Konstanz, Amt für Stadtplanung und Umwelt
24.10.2022 03:00;5;3;2;Stellenweiser Regenfall;12;13;0;Stadt Konstanz, Amt für Stadtplanung und Umwelt
24.10.2022 04:00;10;6;4;Stellenweiser Regenfall;12;12;0;Stadt Konstanz, Amt für Stadtplanung und Umwelt
24.10.2022 05:00;38;26;12;Nieselregen;12;12;0.1;Stadt Konstanz, Amt für Stadtplanung und Umwelt
24.10.2022 06:00;134;74;60;Nieselregen;12;11;0.1;Stadt Konstanz, Amt für Stadtplanung und Umwelt
24.10.2022 07:00;926;572;354;Nieselregen;12;11;0;Stadt Konstanz, Amt für Stadtplanung und Umwelt
24.10.2022 08:00;621;319;302;Stellenweiser leichter Regenfall;12;12;0.3;Stadt Konstanz, Amt für Stadtplanung und Umwelt
24.10.2022 09:00;614;343;271;Stellenweiser leichter Regenfall;13;12;0.4;Stadt Konstanz, Amt für Stadtplanung und Umwelt
24.10.2022 10:00;263;138;125;Stellenweiser leichter Regenfall;13;13;0.2;Stadt Konstanz, Amt für Stadtplanung und Umwelt
24.10.2022 11:00;411;209;202;Leichter Regenfall;14;13;0.3;Stadt Konstanz, Amt für Stadtplanung und Umwelt
24.10.2022 12:00;434;204;230;Leichter Regenfall;14;14;0.4;Stadt Konstanz, Amt für Stadtplanung und Umwelt
24.10.2022 13:00;710;299;411;Leichter Regenfall;14;14;0.2;Stadt Konstanz, Amt für Stadtplanung und Umwelt
24.10.2022 14:00;472;245;227;Stellenweiser Nieselregen;14;13;0.2;Stadt Konstanz, Amt für Stadtplanung und Umwelt
24.10.2022 15:00;800;363;437;Stellenweiser Nieselregen;14;13;0.3;Stadt Konstanz, Amt für Stadtplanung und Umwelt
24.10.2022 16:00;737;338;399;Stellenweiser Nieselregen;13;13;0.2;Stadt Konstanz, Amt für Stadtplanung und Umwelt
24.10.2022 17:00;870;370;500;Nieselregen;13;12;0.2;Stadt Konstanz, Amt für Stadtplanung und Umwelt
24.10.2022 18:00;669;322;347;Nieselregen;13;12;0.2;Stadt Konstanz, Amt für Stadtplanung und Umwelt
24.10.2022 19:00;520;262;258;Nieselregen;12;12;0.1;Stadt Konstanz, Amt für Stadtplanung und Umwelt
24.10.2022 20:00;342;156;186;Nieselregen;12;11;0.2;Stadt Konstanz, Amt für Stadtplanung und Umwelt
24.10.2022 21:00;259;108;151;Nieselregen;12;11;0.2;Stadt Konstanz, Amt für Stadtplanung und Umwelt
24.10.2022 22:00;204;82;122;Nieselregen;11;11;0.1;Stadt Konstanz, Amt für Stadtplanung und Umwelt
24.10.2022 23:00;92;38;54;Sonnig;11;10;0;Stadt Konstanz, Amt für Stadtplanung und Umwelt
25.10.2022 00:00;38;20;18;Sonnig;11;10;0;Stadt Konstanz, Amt für Stadtplanung und Umwelt
25.10.2022 01:00;21;16;5;Sonnig;10;10;0;Stadt Konstanz, Amt für Stadtplanung und Umwelt
25.10.2022 02:00;13;10;3;Sonnig;9;9;0;Stadt Konstanz, Amt für Stadtplanung und Umwelt
25.10.2022 03:00;8;4;4;Sonnig;9;8;0;Stadt Konstanz, Amt für Stadtplanung und Umwelt
25.10.2022 04:00;11;10;1;Sonnig;8;8;0;Stadt Konstanz, Amt für Stadtplanung und Umwelt
25.10.2022 05:00;41;28;13;Sonnig;8;8;0;Stadt Konstanz, Amt für Stadtplanung und Umwelt
25.10.2022 06:00;176;111;65;Sonnig;8;8;0;Stadt Konstanz, Amt für Stadtplanung und Umwelt
25.10.2022 07:00;1170;736;434;Sonnig;9;9;0;Stadt Konstanz, Amt für Stadtplanung und Umwelt
25.10.2022 08:00;836;464;372;Sonnig;11;11;0;Stadt Konstanz, Amt für Stadtplanung und Umwelt
25.10.2022 09:00;928;543;385;Sonnig;12;13;0;Stadt Konstanz, Amt für Stadtplanung und Umwelt
25.10.2022 10:00;497;278;219;Sonnig;14;14;0;Stadt Konstanz, Amt für Stadtplanung und Umwelt
25.10.2022 11:00;773;390;383;Sonnig;16;16;0;Stadt Konstanz, Amt für Stadtplanung und Umwelt
25.10.2022 12:00;760;315;445;Sonnig;18;18;0;Stadt Konstanz, Amt für Stadtplanung und Umwelt
25.10.2022 13:00;1021;438;583;Sonnig;18;18;0;Stadt Konstanz, Amt für Stadtplanung und Umwelt
25.10.2022 14:00;845;407;438;Sonnig;19;19;0;Stadt Konstanz, Amt für Stadtplanung und Umwelt
25.10.2022 15:00;1160;556;604;Sonnig;19;19;0;Stadt Konstanz, Amt für Stadtplanung und Umwelt
25.10.2022 16:00;1075;468;607;Sonnig;17;17;0;Stadt Konstanz, Amt für Stadtplanung und Umwelt
25.10.2022 17:00;1233;520;713;Sonnig;16;16;0;Stadt Konstanz, Amt für Stadtplanung und Umwelt
25.10.2022 18:00;1025;474;551;Sonnig;14;14;0;Stadt Konstanz, Amt für Stadtplanung und Umwelt
25.10.2022 19:00;729;328;401;Sonnig;12;12;0;Stadt Konstanz, Amt für Stadtplanung und Umwelt
25.10.2022 20:00;458;188;270;Sonnig;11;11;0;Stadt Konstanz, Amt für Stadtplanung und Umwelt
25.10.2022 21:00;352;154;198;Sonnig;9;10;0;Stadt Konstanz, Amt für Stadtplanung und Umwelt
25.10.2022 22:00;238;116;122;Sonnig;9;9;0;Stadt Konstanz, Amt für Stadtplanung und Umwelt
25.10.2022 23:00;160;61;99;Bewoelkt;9;9;0;Stadt Konstanz, Amt für Stadtplanung und Umwelt
26.10.2022 00:00;76;23;53;Bewoelkt;9;9;0;Stadt Konstanz, Amt für Stadtplanung und Umwelt
26.10.2022 01:00;45;12;33;Bewoelkt;10;10;0;Stadt Konstanz, Amt für Stadtplanung und Umwelt
26.10.2022 02:00;12;4;8;Leicht bewoelkt;10;11;0;Stadt Konstanz, Amt für Stadtplanung und Umwelt
26.10.2022 03:00;5;2;3;Leicht bewoelkt;11;11;0;Stadt Konstanz, Amt für Stadtplanung und Umwelt
26.10.2022 04:00;8;6;2;Leicht bewoelkt;11;11;0;Stadt Konstanz, Amt für Stadtplanung und Umwelt
26.10.2022 05:00;42;30;12;Leicht bewoelkt;11;11;0;Stadt Konstanz, Amt für Stadtplanung und Umwelt
26.10.2022 06:00;185;116;69;Leicht bewoelkt;11;11;0;Stadt Konstanz, Amt für Stadtplanung und Umwelt
26.10.2022 07:00;1185;769;416;Leicht bewoelkt;12;12;0;Stadt Konstanz, Amt für Stadtplanung und Umwelt
26.10.2022 08:00;788;463;325;Leicht bewoelkt;12;13;0;Stadt Konstanz, Amt für Stadtplanung und Umwelt
26.10.2022 09:00;712;393;319;Leicht bewoelkt;13;14;0;Stadt Konstanz, Amt für Stadtplanung und Umwelt
26.10.2022 10:00;419;235;184;Leicht bewoelkt;15;15;0;Stadt Konstanz, Amt für Stadtplanung und Umwelt
26.10.2022 11:00;685;320;365;Sonnig;17;17;0;Stadt Konstanz, Amt für Stadtplanung und Umwelt
26.10.2022 12:00;722;337;385;Sonnig;19;19;0;Stadt Konstanz, Amt für Stadtplanung und Umwelt
26.10.2022 13:00;1105;540;565;Sonnig;19;19;0;Stadt Konstanz, Amt für Stadtplanung und Umwelt
26.10.2022 14:00;762;375;387;Leicht bewoelkt;19;19;0;Stadt Konstanz, Amt für Stadtplanung und Umwelt
26.10.2022 15:00;1144;492;652;Leicht bewoelkt;19;19;0;Stadt Konstanz, Amt für Stadtplanung und Umwelt
26.10.2022 16:00;1026;483;543;Leicht bewoelkt;17;17;0;Stadt Konstanz, Amt für Stadtplanung und Umwelt
26.10.2022 17:00;1194;540;654;Sonnig;16;16;0;Stadt Konstanz, Amt für Stadtplanung und Umwelt
26.10.2022 18:00;988;411;577;Sonnig;14;14;0;Stadt Konstanz, Amt für Stadtplanung und Umwelt
26.10.2022 19:00;713;316;397;Sonnig;13;13;0;Stadt Konstanz, Amt für Stadtplanung und Umwelt
26.10.2022 20:00;522;254;268;Sonnig;12;12;0;Stadt Konstanz, Amt für Stadtplanung und Umwelt
26.10.2022 21:00;379;176;203;Sonnig;11;11;0;Stadt Konstanz, Amt für Stadtplanung und Umwelt
26.10.2022 22:00;260;102;158;Sonnig;11;11;0;Stadt Konstanz, Amt für Stadtplanung und Umwelt
26.10.2022 23:00;171;86;85;Leicht bewoelkt;11;11;0;Stadt Konstanz, Amt für Stadtplanung und Umwelt
27.10.2022 00:00;89;24;65;Leicht bewoelkt;11;11;0;Stadt Konstanz, Amt für Stadtplanung und Umwelt
27.10.2022 01:00;39;16;23;Leicht bewoelkt;11;11;0;Stadt Konstanz, Amt für Stadtplanung und Umwelt
27.10.2022 02:00;14;8;6;Leicht bewoelkt;11;11;0;Stadt Konstanz, Amt für Stadtplanung und Umwelt
27.10.2022 03:00;4;2;2;Leicht bewoelkt;10;11;0;Stadt Konstanz, Amt für Stadtplanung und Umwelt
27.10.2022 04:00;13;8;5;Leicht bewoelkt;10;10;0;Stadt Konstanz, Amt für Stadtplanung und Umwelt
27.10.2022 05:00;59;45;14;Sonnig;10;10;0;Stadt Konstanz, Amt für Stadtplanung und Umwelt
27.10.2022 06:00;188;118;70;Sonnig;10;10;0;Stadt Konstanz, Amt für Stadtplanung und Umwelt
27.10.2022 07:00;1154;738;416;Sonnig;11;11;0;Stadt Konstanz, Amt für Stadtplanung und Umwelt
27.10.2022 08:00;833;464;369;Sonnig;13;13;0;Stadt Konstanz, Amt für Stadtplanung und Umwelt
27.10.2022 09:00;780;434;346;Sonnig;14;14;0;Stadt Konstanz, Amt für Stadtplanung und Umwelt
27.10.2022 10:00;447;260;187;Sonnig;16;16;0;Stadt Konstanz, Amt für Stadtplanung und Umwelt
27.10.2022 11:00;617;308;309;Leicht bewoelkt;18;18;0;Stadt Konstanz, Amt für Stadtplanung und Umwelt
27.10.2022 12:00;690;295;395;Leicht bewoelkt;19;19;0;Stadt Konstanz, Amt für Stadtplanung und Umwelt
27.10.2022 13:00;1076;481;595;Leicht bewoelkt;19;19;0;Stadt Konstanz, Amt für Stadtplanung und Umwelt
27.10.2022 14:00;805;365;440;Leicht bewoelkt;20;20;0;Stadt Konstanz, Amt für Stadtplanung und Umwelt
27.10.2022 15:00;1135;522;613;Leicht bewoelkt;20;20;0;Stadt Konstanz, Amt für Stadtplanung und Umwelt
27.10.2022 16:00;1075;479;596;Leicht bewoelkt;18;18;0;Stadt Konstanz, Amt für Stadtplanung und Umwelt
27.10.2022 17:00;1207;527;680;Sonnig;16;16;0;Stadt Konstanz, Amt für Stadtplanung und Umwelt
27.10.2022 18:00;961;419;542;Sonnig;13;13;0;Stadt Konstanz, Amt für Stadtplanung und Umwelt
27.10.2022 19:00;702;299;403;Sonnig;13;13;0;Stadt Konstanz, Amt für Stadtplanung und Umwelt
27.10.2022 20:00;465;229;236;Sonnig;12;12;0;Stadt Konstanz, Amt für Stadtplanung und Umwelt
27.10.2022 21:00;343;148;195;Sonnig;12;12;0;Stadt Konstanz, Amt für Stadtplanung und Umwelt
27.10.2022 22:00;268;126;142;Sonnig;11;11;0;Stadt Konstanz, Amt für Stadtplanung und Umwelt
27.10.2022 23:00;173;69;104;Sonnig;11;11;0;Stadt Konstanz, Amt für Stadtplanung und Umwelt
28.10.2022 00:00;82;27;55;Sonnig;11;11;0;Stadt Konstanz, Amt für Stadtplanung und Umwelt
28.10.2022 01:00;46;25;21;Sonnig;11;11;0;Stadt Konstanz, Amt für Stadtplanung und Umwelt
28.10.2022 02:00;24;17;7;Sonnig;11;11;0;Stadt Konstanz, Amt für Stadtplanung und Umwelt
28.10.2022 03:00;15;9;6;Sonnig;11;11;0;Stadt Konstanz, Amt für Stadtplanung und Umwelt
28.10.2022 04:00;16;13;3;Sonnig;10;11;0;Stadt Konstanz, Amt für Stadtplanung und Umwelt
28.10.2022 05:00;42;34;8;Leicht bewoelkt;10;11;0;Stadt Konstanz, Amt für Stadtplanung und Umwelt
28.10.2022 06:00;158;95;63;Leicht bewoelkt;10;11;0;Stadt Konstanz, Amt für Stadtplanung und Umwelt
28.10.2022 07:00;946;600;346;Leicht bewoelkt;12;12;0;Stadt Konstanz, Amt für Stadtplanung und Umwelt
28.10.2022 08:00;684;410;274;Leicht bewoelkt;13;13;0;Stadt Konstanz, Amt für Stadtplanung und Umwelt
28.10.2022 09:00;699;383;316;Leicht bewoelkt;14;14;0;Stadt Konstanz, Amt für Stadtplanung und Umwelt
28.10.2022 10:00;478;272;206;Leicht bewoelkt;16;16;0;Stadt Konstanz, Amt für Stadtplanung und Umwelt
28.10.2022 11:00;664;331;333;Sonnig;18;18;0;Stadt Konstanz, Amt für Stadtplanung und Umwelt
28.10.2022 12:00;830;394;436;Sonnig;20;20;0;Stadt Konstanz, Amt für Stadtplanung und Umwelt
28.10.2022 13:00;1084;451;633;Sonnig;20;20;0;Stadt Konstanz, Amt für Stadtplanung und Umwelt
28.10.2022 14:00;821;397;424;Sonnig;21;21;0;Stadt Konstanz, Amt für Stadtplanung und Umwelt
28.10.2022 15:00;873;439;434;Sonnig;21;21;0;Stadt Konstanz, Amt für Stadtplanung und Umwelt
28.10.2022 16:00;782;352;430;Sonnig;19;19;0;Stadt Konstanz, Amt für Stadtplanung und Umwelt
28.10.2022 17:00;838;393;445;Sonnig;16;16;0;Stadt Konstanz, Amt für Stadtplanung und Umwelt
28.10.2022 18:00;699;293;406;Sonnig;14;14;0;Stadt Konstanz, Amt für Stadtplanung und Umwelt
28.10.2022 19:00;617;335;282;Sonnig;13;13;0;Stadt Konstanz, Amt für Stadtplanung und Umwelt
28.10.2022 20:00;390;195;195;Sonnig;13;13;0;Stadt Konstanz, Amt für Stadtplanung und Umwelt
28.10.2022 21:00;304;135;169;Sonnig;12;12;0;Stadt Konstanz, Amt für Stadtplanung und Umwelt
28.10.2022 22:00;263;96;167;Sonnig;12;12;0;Stadt Konstanz, Amt für Stadtplanung und Umwelt
28.10.2022 23:00;221;101;120;Sonnig;11;12;0;Stadt Konstanz, Amt für Stadtplanung und Umwelt
29.10.2022 00:00;160;61;99;Sonnig;11;12;0;Stadt Konstanz, Amt für Stadtplanung und Umwelt
29.10.2022 01:00;132;32;100;Sonnig;11;11;0;Stadt Konstanz, Amt für Stadtplanung und Umwelt
29.10.2022 02:00;65;25;40;Sonnig;11;11;0;Stadt Konstanz, Amt für Stadtplanung und Umwelt
29.10.2022 03:00;39;14;25;Sonnig;10;10;0;Stadt Konstanz, Amt für Stadtplanung und Umwelt
29.10.2022 04:00;34;17;17;Sonnig;10;10;0;Stadt Konstanz, Amt für Stadtplanung und Umwelt
29.10.2022 05:00;33;25;8;Sonnig;10;10;0;Stadt Konstanz, Amt für Stadtplanung und Umwelt
29.10.2022 06:00;55;46;9;Sonnig;10;10;0;Stadt Konstanz, Amt für Stadtplanung und Umwelt
29.10.2022 07:00;64;25;39;Sonnig;11;11;0;Stadt Konstanz, Amt für Stadtplanung und Umwelt
29.10.2022 08:00;146;83;63;Sonnig;12;13;0;Stadt Konstanz, Amt für Stadtplanung und Umwelt
29.10.2022 09:00;335;199;136;Sonnig;13;14;0;Stadt Konstanz, Amt für Stadtplanung und Umwelt
29.10.2022 10:00;426;245;181;Sonnig;16;17;0;Stadt Konstanz, Amt für Stadtplanung und Umwelt
29.10.2022 11:00;537;294;243;Sonnig;19;19;0;Stadt Konstanz, Amt für Stadtplanung und Umwelt
29.10.2022 12:00;564;316;248;Sonnig;22;22;0;Stadt Konstanz, Amt für Stadtplanung und Umwelt
29.10.2022 13:00;628;302;326;Sonnig;22;22;0;Stadt Konstanz, Amt für Stadtplanung und Umwelt
29.10.2022 14:00;706;369;337;Sonnig;22;25;0;Stadt Konstanz, Amt für Stadtplanung und Umwelt
29.10.2022 15:00;753;378;375;Sonnig;23;25;0;Stadt Konstanz, Amt für Stadtplanung und Umwelt
29.10.2022 16:00;663;309;354;Sonnig;20;20;0;Stadt Konstanz, Amt für Stadtplanung und Umwelt
29.10.2022 17:00;642;299;343;Sonnig;18;18;0;Stadt Konstanz, Amt für Stadtplanung und Umwelt
29.10.2022 18:00;557;221;336;Sonnig;16;16;0;Stadt Konstanz, Amt für Stadtplanung und Umwelt
29.10.2022 19:00;375;197;178;Sonnig;15;15;0;Stadt Konstanz, Amt für Stadtplanung und Umwelt
29.10.2022 20:00;320;164;156;Sonnig;14;14;0;Stadt Konstanz, Amt für Stadtplanung und Umwelt
29.10.2022 21:00;231;116;115;Sonnig;13;13;0;Stadt Konstanz, Amt für Stadtplanung und Umwelt
29.10.2022 22:00;222;106;116;Sonnig;12;12;0;Stadt Konstanz, Amt für Stadtplanung und Umwelt
29.10.2022 23:00;218;106;112;Sonnig;12;12;0;Stadt Konstanz, Amt für Stadtplanung und Umwelt
30.10.2022 00:00;139;47;92;Sonnig;11;11;0;Stadt Konstanz, Amt für Stadtplanung und Umwelt
30.10.2022 01:00;138;47;91;Sonnig;11;11;0;Stadt Konstanz, Amt für Stadtplanung und Umwelt
30.10.2022 02:00;172;58;114;Sonnig;11;11;0;Stadt Konstanz, Amt für Stadtplanung und Umwelt
30.10.2022 03:00;42;12;30;Sonnig;11;11;0;Stadt Konstanz, Amt für Stadtplanung und Umwelt
30.10.2022 04:00;18;10;8;Sonnig;10;10;0;Stadt Konstanz, Amt für Stadtplanung und Umwelt
30.10.2022 05:00;24;13;11;Sonnig;10;10;0;Stadt Konstanz, Amt für Stadtplanung und Umwelt
30.10.2022 06:00;32;26;6;Sonnig;10;10;0;Stadt Konstanz, Amt für Stadtplanung und Umwelt
30.10.2022 07:00;45;18;27;Sonnig;11;11;0;Stadt Konstanz, Amt für Stadtplanung und Umwelt
30.10.2022 08:00;77;41;36;Sonnig;12;12;0;Stadt Konstanz, Amt für Stadtplanung und Umwelt
30.10.2022 09:00;205;96;109;Sonnig;13;13;0;Stadt Konstanz, Amt für Stadtplanung und Umwelt
30.10.2022 10:00;222;123;99;Sonnig;15;15;0;Stadt Konstanz, Amt für Stadtplanung und Umwelt
30.10.2022 11:00;299;149;150;Sonnig;17;17;0;Stadt Konstanz, Amt für Stadtplanung und Umwelt
30.10.2022 12:00;313;155;158;Sonnig;19;19;0;Stadt Konstanz, Amt für Stadtplanung und Umwelt
30.10.2022 13:00;432;230;202;Sonnig;19;19;0;Stadt Konstanz, Amt für Stadtplanung und Umwelt
30.10.2022 14:00;519;274;245;Sonnig;19;19;0;Stadt Konstanz, Amt für Stadtplanung und Umwelt
30.10.2022 15:00;501;247;254;Sonnig;20;20;0;Stadt Konstanz, Amt für Stadtplanung und Umwelt
30.10.2022 16:00;426;183;243;Sonnig;17;17;0;Stadt Konstanz, Amt für Stadtplanung und Umwelt
30.10.2022 17:00;397;201;196;Leicht bewoelkt;15;15;0;Stadt Konstanz, Amt für Stadtplanung und Umwelt
30.10.2022 18:00;287;154;133;Leicht bewoelkt;13;13;0;Stadt Konstanz, Amt für Stadtplanung und Umwelt
30.10.2022 19:00;211;91;120;Leicht bewoelkt;12;12;0;Stadt Konstanz, Amt für Stadtplanung und Umwelt
30.10.2022 20:00;153;63;90;Leicht bewoelkt;12;12;0;Stadt Konstanz, Amt für Stadtplanung und Umwelt
30.10.2022 21:00;139;63;76;Leicht bewoelkt;11;11;0;Stadt Konstanz, Amt für Stadtplanung und Umwelt
30.10.2022 22:00;111;53;58;Leicht bewoelkt;11;11;0;Stadt Konstanz, Amt für Stadtplanung und Umwelt
30.10.2022 23:00;75;35;40;Sonnig;10;10;0;Stadt Konstanz, Amt für Stadtplanung und Umwelt
31.10.2022 00:00;35;18;17;Sonnig;10;10;0;Stadt Konstanz, Amt für Stadtplanung und Umwelt
31.10.2022 01:00;15;6;9;Sonnig;10;10;0;Stadt Konstanz, Amt für Stadtplanung und Umwelt
31.10.2022 02:00;6;4;2;Sonnig;9;9;0;Stadt Konstanz, Amt für Stadtplanung und Umwelt
31.10.2022 03:00;4;2;2;Sonnig;9;9;0;Stadt Konstanz, Amt für Stadtplanung und Umwelt
31.10.2022 04:00;12;12;0;Sonnig;9;9;0;Stadt Konstanz, Amt für Stadtplanung und Umwelt
31.10.2022 05:00;37;28;9;Sonnig;9;9;0;Stadt Konstanz, Amt für Stadtplanung und Umwelt
31.10.2022 06:00;113;71;42;Sonnig;9;9;0;Stadt Konstanz, Amt für Stadtplanung und Umwelt
31.10.2022 07:00;407;242;165;Sonnig;10;10;0;Stadt Konstanz, Amt für Stadtplanung und Umwelt
31.10.2022 08:00;432;244;188;Sonnig;11;11;0;Stadt Konstanz, Amt für Stadtplanung und Umwelt
31.10.2022 09:00;491;303;188;Sonnig;12;12;0;Stadt Konstanz, Amt für Stadtplanung und Umwelt
31.10.2022 10:00;493;268;225;Sonnig;14;14;0;Stadt Konstanz, Amt für Stadtplanung und Umwelt
31.10.2022 11:00;498;248;250;Sonnig;16;16;0;Stadt Konstanz, Amt für Stadtplanung und Umwelt
31.10.2022 12:00;524;259;265;Sonnig;17;17;0;Stadt Konstanz, Amt für Stadtplanung und Umwelt
31.10.2022 13:00;584;278;306;Sonnig;17;17;0;Stadt Konstanz, Amt für Stadtplanung und Umwelt
31.10.2022 14:00;648;360;288;Sonnig;18;18;0;Stadt Konstanz, Amt für Stadtplanung und Umwelt
31.10.2022 15:00;678;314;364;Sonnig;18;18;0;Stadt Konstanz, Amt für Stadtplanung und Umwelt
31.10.2022 16:00;692;319;373;Sonnig;16;16;0;Stadt Konstanz, Amt für Stadtplanung und Umwelt
31.10.2022 17:00;739;318;421;Sonnig;13;14;0;Stadt Konstanz, Amt für Stadtplanung und Umwelt
31.10.2022 18:00;609;277;332;Sonnig;11;12;0;Stadt Konstanz, Amt für Stadtplanung und Umwelt
31.10.2022 19:00;478;233;245;Sonnig;11;11;0;Stadt Konstanz, Amt für Stadtplanung und Umwelt
31.10.2022 20:00;426;200;226;Sonnig;10;10;0;Stadt Konstanz, Amt für Stadtplanung und Umwelt
31.10.2022 21:00;250;104;146;Sonnig;10;10;0;Stadt Konstanz, Amt für Stadtplanung und Umwelt
31.10.2022 22:00;237;124;113;Sonnig;9;9;0;Stadt Konstanz, Amt für Stadtplanung und Umwelt
31.10.2022 23:00;181;76;105;Sonnig;9;9;0;Stadt Konstanz, Amt für Stadtplanung und Umwelt
01.11.2022 00:00;124;75;49;Sonnig;9;9;0;Stadt Konstanz, Amt für Stadtplanung und Umwelt
01.11.2022 01:00;144;57;87;Sonnig;9;9;0;Stadt Konstanz, Amt für Stadtplanung und Umwelt
01.11.2022 02:00;137;52;85;Sonnig;8;8;0;Stadt Konstanz, Amt für Stadtplanung und Umwelt
01.11.2022 03:00;123;56;67;Sonnig;8;8;0;Stadt Konstanz, Amt für Stadtplanung und Umwelt
01.11.2022 04:00;47;31;16;Sonnig;8;8;0;Stadt Konstanz, Amt für Stadtplanung und Umwelt
01.11.2022 05:00;51;35;16;Bedeckt;8;8;0;Stadt Konstanz, Amt für Stadtplanung und Umwelt
01.11.2022 06:00;75;61;14;Bedeckt;8;8;0;Stadt Konstanz, Amt für Stadtplanung und Umwelt
01.11.2022 07:00;87;60;27;Bedeckt;9;9;0;Stadt Konstanz, Amt für Stadtplanung und Umwelt
01.11.2022 08:00;95;48;47;Leicht bewoelkt;11;10;0;Stadt Konstanz, Amt für Stadtplanung und Umwelt
01.11.2022 09:00;153;86;67;Leicht bewoelkt;12;12;0;Stadt Konstanz, Amt für Stadtplanung und Umwelt
01.11.2022 10:00;165;86;79;Leicht bewoelkt;13;13;0;Stadt Konstanz, Amt für Stadtplanung und Umwelt
01.11.2022 11:00;237;131;106;Leicht bewoelkt;15;15;0;Stadt Konstanz, Amt für Stadtplanung und Umwelt
01.11.2022 12:00;284;147;137;Leicht bewoelkt;17;17;0;Stadt Konstanz, Amt für Stadtplanung und Umwelt
01.11.2022 13:00;308;174;134;Leicht bewoelkt;16;16;0;Stadt Konstanz, Amt für Stadtplanung und Umwelt
01.11.2022 14:00;389;166;223;Bedeckt;16;15;0;Stadt Konstanz, Amt für Stadtplanung und Umwelt
01.11.2022 15:00;392;176;216;Bedeckt;15;14;0;Stadt Konstanz, Amt für Stadtplanung und Umwelt
01.11.2022 16:00;469;218;251;Bedeckt;14;14;0;Stadt Konstanz, Amt für Stadtplanung und Umwelt
01.11.2022 17:00;476;200;276;Sonnig;13;13;0;Stadt Konstanz, Amt für Stadtplanung und Umwelt
01.11.2022 18:00;374;176;198;Sonnig;13;13;0;Stadt Konstanz, Amt für Stadtplanung und Umwelt
01.11.2022 19:00;278;134;144;Sonnig;11;11;0;Stadt Konstanz, Amt für Stadtplanung und Umwelt
01.11.2022 20:00;215;97;118;Leicht bewoelkt;10;10;0;Stadt Konstanz, Amt für Stadtplanung und Umwelt
01.11.2022 21:00;159;75;84;Leicht bewoelkt;9;9;0;Stadt Konstanz, Amt für Stadtplanung und Umwelt
01.11.2022 22:00;147;96;51;Leicht bewoelkt;9;9;0;Stadt Konstanz, Amt für Stadtplanung und Umwelt
01.11.2022 23:00;78;38;40;Leicht bewoelkt;8;8;0;Stadt Konstanz, Amt für Stadtplanung und Umwelt
02.11.2022 00:00;27;13;14;Leicht bewoelkt;8;8;0;Stadt Konstanz, Amt für Stadtplanung und Umwelt
02.11.2022 01:00;13;5;8;Leicht bewoelkt;7;7;0;Stadt Konstanz, Amt für Stadtplanung und Umwelt
02.11.2022 02:00;3;1;2;Leichter Nebel;7;7;0;Stadt Konstanz, Amt für Stadtplanung und Umwelt
02.11.2022 03:00;2;0;2;Leichter Nebel;7;7;0;Stadt Konstanz, Amt für Stadtplanung und Umwelt
02.11.2022 04:00;7;3;4;Leichter Nebel;8;7;0;Stadt Konstanz, Amt für Stadtplanung und Umwelt
02.11.2022 05:00;47;31;16;Bedeckt;8;8;0;Stadt Konstanz, Amt für Stadtplanung und Umwelt
02.11.2022 06:00;186;119;67;Bedeckt;8;8;0;Stadt Konstanz, Amt für Stadtplanung und Umwelt
02.11.2022 07:00;638;402;236;Bedeckt;9;9;0;Stadt Konstanz, Amt für Stadtplanung und Umwelt
02.11.2022 08:00;690;408;282;Leicht bewoelkt;10;10;0;Stadt Konstanz, Amt für Stadtplanung und Umwelt
02.11.2022 09:00;656;393;263;Leicht bewoelkt;11;11;0;Stadt Konstanz, Amt für Stadtplanung und Umwelt
02.11.2022 10:00;438;243;195;Leicht bewoelkt;12;12;0;Stadt Konstanz, Amt für Stadtplanung und Umwelt
02.11.2022 11:00;605;278;327;Leicht bewoelkt;13;13;0;Stadt Konstanz, Amt für Stadtplanung und Umwelt
02.11.2022 12:00;581;271;310;Leicht bewoelkt;14;13;0;Stadt Konstanz, Amt für Stadtplanung und Umwelt
02.11.2022 13:00;675;387;288;Leicht bewoelkt;14;14;0;Stadt Konstanz, Amt für Stadtplanung und Umwelt
02.11.2022 14:00;743;403;340;Leicht bewoelkt;15;15;0;Stadt Konstanz, Amt für Stadtplanung und Umwelt
02.11.2022 15:00;774;357;417;Leicht bewoelkt;15;16;0;Stadt Konstanz, Amt für Stadtplanung und Umwelt
02.11.2022 16:00;875;402;473;Leicht bewoelkt;13;13;0;Stadt Konstanz, Amt für Stadtplanung und Umwelt
02.11.2022 17:00;969;399;570;Sonnig;11;11;0;Stadt Konstanz, Amt für Stadtplanung und Umwelt
02.11.2022 18:00;785;367;418;Sonnig;9;9;0;Stadt Konstanz, Amt für Stadtplanung und Umwelt
02.11.2022 19:00;533;262;271;Sonnig;8;8;0;Stadt Konstanz, Amt für Stadtplanung und Umwelt
02.11.2022 20:00;335;154;181;Sonnig;7;7;0;Stadt Konstanz, Amt für Stadtplanung und Umwelt
02.11.2022 21:00;307;135;172;Sonnig;6;6;0;Stadt Konstanz, Amt für Stadtplanung und Umwelt
02.11.2022 22:00;225;95;130;Sonnig;6;6;0;Stadt Konstanz, Amt für Stadtplanung und Umwelt
02.11.2022 23:00;158;64;94;Sonnig;6;5;0;Stadt Konstanz, Amt für Stadtplanung und Umwelt
03.11.2022 00:00;57;18;39;Sonnig;5;5;0;Stadt Konstanz, Amt für Stadtplanung und Umwelt
03.11.2022 01:00;16;5;11;Sonnig;5;5;0;Stadt Konstanz, Amt für Stadtplanung und Umwelt
03.11.2022 02:00;15;5;10;Sonnig;5;5;0;Stadt Konstanz, Amt für Stadtplanung und Umwelt
03.11.2022 03:00;1;1;0;Sonnig;5;5;0;Stadt Konstanz, Amt für Stadtplanung und Umwelt
03.11.2022 04:00;9;7;2;Sonnig;5;5;0;Stadt Konstanz, Amt für Stadtplanung und Umwelt
03.11.2022 05:00;46;31;15;Sonnig;5;5;0;Stadt Konstanz, Amt für Stadtplanung und Umwelt
03.11.2022 06:00;191;112;79;Sonnig;4;4;0;Stadt Konstanz, Amt für Stadtplanung und Umwelt
03.11.2022 07:00;622;366;256;Sonnig;6;6;0;Stadt Konstanz, Amt für Stadtplanung und Umwelt
03.11.2022 08:00;687;378;309;Sonnig;7;7;0;Stadt Konstanz, Amt für Stadtplanung und Umwelt
03.11.2022 09:00;643;378;265;Sonnig;9;9;0;Stadt Konstanz, Amt für Stadtplanung und Umwelt
03.11.2022 10:00;408;251;157;Sonnig;10;10;0;Stadt Konstanz, Amt für Stadtplanung und Umwelt
03.11.2022 11:00;527;263;264;Sonnig;12;12;0;Stadt Konstanz, Amt für Stadtplanung und Umwelt
03.11.2022 12:00;561;261;300;Sonnig;14;14;0;Stadt Konstanz, Amt für Stadtplanung und Umwelt
03.11.2022 13:00;669;311;358;Sonnig;14;14;0;Stadt Konstanz, Amt für Stadtplanung und Umwelt
03.11.2022 14:00;627;302;325;Sonnig;14;14;0;Stadt Konstanz, Amt für Stadtplanung und Umwelt
03.11.2022 15:00;752;349;403;Sonnig;14;14;0;Stadt Konstanz, Amt für Stadtplanung und Umwelt
03.11.2022 16:00;770;338;432;Sonnig;12;12;0;Stadt Konstanz, Amt für Stadtplanung und Umwelt
03.11.2022 17:00;890;364;526;Bewoelkt;11;10;0;Stadt Konstanz, Amt für Stadtplanung und Umwelt
03.11.2022 18:00;706;307;399;Bewoelkt;9;9;0;Stadt Konstanz, Amt für Stadtplanung und Umwelt
03.11.2022 19:00;470;196;274;Bewoelkt;9;8;0;Stadt Konstanz, Amt für Stadtplanung und Umwelt
03.11.2022 20:00;325;147;178;Sonnig;9;8;0;Stadt Konstanz, Amt für Stadtplanung und Umwelt
03.11.2022 21:00;239;106;133;Sonnig;9;8;0;Stadt Konstanz, Amt für Stadtplanung und Umwelt
03.11.2022 22:00;201;103;98;Sonnig;8;7;0;Stadt Konstanz, Amt für Stadtplanung und Umwelt
03.11.2022 23:00;106;50;56;Leicht bewoelkt;8;7;0;Stadt Konstanz, Amt für Stadtplanung und Umwelt
04.11.2022 00:00;57;22;35;Leicht bewoelkt;8;7;0;Stadt Konstanz, Amt für Stadtplanung und Umwelt
04.11.2022 01:00;37;7;30;Leicht bewoelkt;8;7;0;Stadt Konstanz, Amt für Stadtplanung und Umwelt
04.11.2022 02:00;21;10;11;Leichter Regenfall;8;6;0.3;Stadt Konstanz, Amt für Stadtplanung und Umwelt
04.11.2022 03:00;12;9;3;Leichter Regenfall;9;6;0.4;Stadt Konstanz, Amt für Stadtplanung und Umwelt
04.11.2022 04:00;9;3;6;Leichter Regenfall;8;5;0.2;Stadt Konstanz, Amt für Stadtplanung und Umwelt
04.11.2022 05:00;41;29;12;Leichter Regenfall;8;5;0.5;Stadt Konstanz, Amt für Stadtplanung und Umwelt
04.11.2022 06:00;157;95;62;Leichter Regenfall;8;4;0.7;Stadt Konstanz, Amt für Stadtplanung und Umwelt
04.11.2022 07:00;400;219;181;Leichter Regenfall;8;5;0.3;Stadt Konstanz, Amt für Stadtplanung und Umwelt
04.11.2022 08:00;619;369;250;Bedeckt;8;5;0;Stadt Konstanz, Amt für Stadtplanung und Umwelt
04.11.2022 09:00;589;353;236;Bedeckt;8;6;0;Stadt Konstanz, Amt für Stadtplanung und Umwelt
04.11.2022 10:00;464;281;183;Bedeckt;9;6;0;Stadt Konstanz, Amt für Stadtplanung und Umwelt
04.11.2022 11:00;525;285;240;Stellenweiser Regenfall;9;7;0;Stadt Konstanz, Amt für Stadtplanung und Umwelt
04.11.2022 12:00;563;227;336;Stellenweiser Regenfall;9;7;0;Stadt Konstanz, Amt für Stadtplanung und Umwelt
04.11.2022 13:00;682;350;332;Stellenweiser Regenfall;9;7;0;Stadt Konstanz, Amt für Stadtplanung und Umwelt
04.11.2022 14:00;595;276;319;Bedeckt;9;7;0;Stadt Konstanz, Amt für Stadtplanung und Umwelt
04.11.2022 15:00;651;324;327;Bedeckt;8;7;0;Stadt Konstanz, Amt für Stadtplanung und Umwelt
04.11.2022 16:00;569;283;286;Bedeckt;8;7;0;Stadt Konstanz, Amt für Stadtplanung und Umwelt
04.11.2022 17:00;697;334;363;Stellenweiser Regenfall;8;7;0;Stadt Konstanz, Amt für Stadtplanung und Umwelt
04.11.2022 18:00;551;234;317;Stellenweiser Regenfall;8;7;0;Stadt Konstanz, Amt für Stadtplanung und Umwelt
04.11.2022 19:00;433;222;211;Stellenweiser Regenfall;7;7;0;Stadt Konstanz, Amt für Stadtplanung und Umwelt
04.11.2022 20:00;255;139;116;Leichter Regenschauer;7;6;0.1;Stadt Konstanz, Amt für Stadtplanung und Umwelt
04.11.2022 21:00;224;96;128;Leichter Regenschauer;7;6;0.1;Stadt Konstanz, Amt für Stadtplanung und Umwelt
04.11.2022 22:00;206;91;115;Leichter Regenschauer;7;6;0.1;Stadt Konstanz, Amt für Stadtplanung und Umwelt
04.11.2022 23:00;170;67;103;Leichter Regenschauer;7;5;0.2;Stadt Konstanz, Amt für Stadtplanung und Umwelt
05.11.2022 00:00;122;44;78;Leichter Regenschauer;6;5;0.3;Stadt Konstanz, Amt für Stadtplanung und Umwelt
05.11.2022 01:00;105;37;68;Leichter Regenschauer;6;5;0.2;Stadt Konstanz, Amt für Stadtplanung und Umwelt
05.11.2022 02:00;62;23;39;Leichter Regenschauer;6;5;0.1;Stadt Konstanz, Amt für Stadtplanung und Umwelt
05.11.2022 03:00;64;14;50;Leichter Regenschauer;6;5;0.1;Stadt Konstanz, Amt für Stadtplanung und Umwelt
05.11.2022 04:00;23;11;12;Leichter Regenschauer;6;5;0;Stadt Konstanz, Amt für Stadtplanung und Umwelt
05.11.2022 05:00;25;13;12;Leichter Regenschauer;6;5;0.1;Stadt Konstanz, Amt für Stadtplanung und Umwelt
05.11.2022 06:00;34;23;11;Leichter Regenschauer;6;5;0.1;Stadt Konstanz, Amt für Stadtplanung und Umwelt
05.11.2022 07:00;51;28;23;Leichter Regenschauer;6;5;0;Stadt Konstanz, Amt für Stadtplanung und Umwelt
05.11.2022 08:00;131;81;50;Stellenweiser Regenfall;6;6;0;Stadt Konstanz, Amt für Stadtplanung und Umwelt
05.11.2022 09:00;263;139;124;Stellenweiser Regenfall;6;6;0;Stadt Konstanz, Amt für Stadtplanung und Umwelt
05.11.2022 10:00;321;187;134;Stellenweiser Regenfall;7;7;0;Stadt Konstanz, Amt für Stadtplanung und Umwelt
05.11.2022 11:00;415;223;192;Stellenweiser Regenfall;8;8;0;Stadt Konstanz, Amt für Stadtplanung und Umwelt
05.11.2022 12:00;470;263;207;Stellenweiser Regenfall;9;9;0;Stadt Konstanz, Amt für Stadtplanung und Umwelt
05.11.2022 13:00;416;239;177;Stellenweiser Regenfall;10;10;0;Stadt Konstanz, Amt für Stadtplanung und Umwelt
05.11.2022 14:00;500;256;244;Leicht bewoelkt;10;10;0;Stadt Konstanz, Amt für Stadtplanung und Umwelt
05.11.2022 15:00;520;266;254;Leicht bewoelkt;10;10;0;Stadt Konstanz, Amt für Stadtplanung und Umwelt
05.11.2022 16:00;479;224;255;Leicht bewoelkt;8;8;0;Stadt Konstanz, Amt für Stadtplanung und Umwelt
05.11.2022 17:00;420;212;208;Leicht bewoelkt;6;6;0;Stadt Konstanz, Amt für Stadtplanung und Umwelt
05.11.2022 18:00;441;183;258;Leicht bewoelkt;4;4;0;Stadt Konstanz, Amt für Stadtplanung und Umwelt
05.11.2022 19:00;304;176;128;Leicht bewoelkt;4;3;0;Stadt Konstanz, Amt für Stadtplanung und Umwelt
05.11.2022 20:00;264;131;133;Leicht bewoelkt;3;3;0;Stadt Konstanz, Amt für Stadtplanung und Umwelt
05.11.2022 21:00;223;87;136;Leicht bewoelkt;3;3;0;Stadt Konstanz, Amt für Stadtplanung und Umwelt
05.11.2022 22:00;211;72;139;Leicht bewoelkt;2;2;0;Stadt Konstanz, Amt für Stadtplanung und Umwelt
05.11.2022 23:00;184;75;109;Sonnig;2;2;0;Stadt Konstanz, Amt für Stadtplanung und Umwelt
06.11.2022 00:00;158;56;102;Sonnig;2;2;0;Stadt Konstanz, Amt für Stadtplanung und Umwelt
06.11.2022 01:00;97;49;48;Sonnig;2;2;0;Stadt Konstanz, Amt für Stadtplanung und Umwelt
06.11.2022 02:00;72;24;48;Leicht bewoelkt;2;2;0;Stadt Konstanz, Amt für Stadtplanung und Umwelt
06.11.2022 03:00;84;31;53;Leicht bewoelkt;2;2;0;Stadt Konstanz, Amt für Stadtplanung und Umwelt
06.11.2022 04:00;44;12;32;Leicht bewoelkt;1;1;0;Stadt Konstanz, Amt für Stadtplanung und Umwelt
06.11.2022 05:00;30;11;19;Leicht bewoelkt;1;1;0;Stadt Konstanz, Amt für Stadtplanung und Umwelt
06.11.2022 06:00;35;24;11;Leicht bewoelkt;1;0;0;Stadt Konstanz, Amt für Stadtplanung und Umwelt
06.11.2022 07:00;37;21;16;Leicht bewoelkt;2;1;0;Stadt Konstanz, Amt für Stadtplanung und Umwelt
06.11.2022 08:00;62;34;28;Leicht bewoelkt;3;3;0;Stadt Konstanz, Amt für Stadtplanung und Umwelt
06.11.2022 09:00;165;84;81;Leicht bewoelkt;4;4;0;Stadt Konstanz, Amt für Stadtplanung und Umwelt
06.11.2022 10:00;190;101;89;Leicht bewoelkt;6;6;0;Stadt Konstanz, Amt für Stadtplanung und Umwelt
06.11.2022 11:00;215;90;125;Sonnig;7;7;0;Stadt Konstanz, Amt für Stadtplanung und Umwelt
06.11.2022 12:00;294;154;140;Sonnig;9;9;0;Stadt Konstanz, Amt für Stadtplanung und Umwelt
06.11.2022 13:00;323;169;154;Sonnig;9;9;0;Stadt Konstanz, Amt für Stadtplanung und Umwelt
06.11.2022 14:00;373;190;183;Leicht bewoelkt;9;9;0;Stadt Konstanz, Amt für Stadtplanung und Umwelt
06.11.2022 15:00;411;210;201;Leicht bewoelkt;9;9;0;Stadt Konstanz, Amt für Stadtplanung und Umwelt
06.11.2022 16:00;345;140;205;Leicht bewoelkt;8;8;0;Stadt Konstanz, Amt für Stadtplanung und Umwelt
06.11.2022 17:00;394;200;194;Leicht bewoelkt;8;7;0;Stadt Konstanz, Amt für Stadtplanung und Umwelt
06.11.2022 18:00;268;122;146;Leicht bewoelkt;7;6;0;Stadt Konstanz, Amt für Stadtplanung und Umwelt
06.11.2022 19:00;224;110;114;Leicht bewoelkt;7;6;0;Stadt Konstanz, Amt für Stadtplanung und Umwelt
06.11.2022 20:00;154;64;90;Bewoelkt;7;6;0;Stadt Konstanz, Amt für Stadtplanung und Umwelt
06.11.2022 21:00;140;70;70;Bewoelkt;7;7;0;Stadt Konstanz, Amt für Stadtplanung und Umwelt
06.11.2022 22:00;93;36;57;Bewoelkt;7;6;0;Stadt Konstanz, Amt für Stadtplanung und Umwelt
06.11.2022 23:00;59;29;30;Bewoelkt;7;6;0;Stadt Konstanz, Amt für Stadtplanung und Umwelt
07.11.2022 00:00;23;12;11;Bewoelkt;7;6;0;Stadt Konstanz, Amt für Stadtplanung und Umwelt
07.11.2022 01:00;14;4;10;Bewoelkt;6;5;0;Stadt Konstanz, Amt für Stadtplanung und Umwelt
07.11.2022 02:00;5;1;4;Leicht bewoelkt;6;4;0;Stadt Konstanz, Amt für Stadtplanung und Umwelt
07.11.2022 03:00;3;1;2;Leicht bewoelkt;5;4;0;Stadt Konstanz, Amt für Stadtplanung und Umwelt
07.11.2022 04:00;14;9;5;Leicht bewoelkt;5;4;0;Stadt Konstanz, Amt für Stadtplanung und Umwelt
07.11.2022 05:00;43;32;11;Bedeckt;6;5;0;Stadt Konstanz, Amt für Stadtplanung und Umwelt
07.11.2022 06:00;201;117;84;Bedeckt;6;5;0;Stadt Konstanz, Amt für Stadtplanung und Umwelt
07.11.2022 07:00;1116;683;433;Bedeckt;7;6;0;Stadt Konstanz, Amt für Stadtplanung und Umwelt
07.11.2022 08:00;763;403;360;Bewoelkt;8;7;0;Stadt Konstanz, Amt für Stadtplanung und Umwelt
07.11.2022 09:00;658;358;300;Bewoelkt;9;8;0;Stadt Konstanz, Amt für Stadtplanung und Umwelt
07.11.2022 10:00;395;195;200;Bewoelkt;10;10;0;Stadt Konstanz, Amt für Stadtplanung und Umwelt
07.11.2022 11:00;615;327;288;Leicht bewoelkt;12;11;0;Stadt Konstanz, Amt für Stadtplanung und Umwelt
07.11.2022 12:00;626;284;342;Leicht bewoelkt;13;13;0;Stadt Konstanz, Amt für Stadtplanung und Umwelt
07.11.2022 13:00;946;407;539;Leicht bewoelkt;13;13;0;Stadt Konstanz, Amt für Stadtplanung und Umwelt
07.11.2022 14:00;639;303;336;Leicht bewoelkt;13;13;0;Stadt Konstanz, Amt für Stadtplanung und Umwelt
07.11.2022 15:00;1115;531;584;Leicht bewoelkt;14;14;0;Stadt Konstanz, Amt für Stadtplanung und Umwelt
07.11.2022 16:00;915;432;483;Leicht bewoelkt;11;11;0;Stadt Konstanz, Amt für Stadtplanung und Umwelt
07.11.2022 17:00;1079;482;597;Sonnig;9;9;0;Stadt Konstanz, Amt für Stadtplanung und Umwelt
07.11.2022 18:00;771;383;388;Sonnig;7;7;0;Stadt Konstanz, Amt für Stadtplanung und Umwelt
07.11.2022 19:00;607;274;333;Sonnig;6;6;0;Stadt Konstanz, Amt für Stadtplanung und Umwelt
07.11.2022 20:00;433;245;188;Sonnig;6;5;0;Stadt Konstanz, Amt für Stadtplanung und Umwelt
07.11.2022 21:00;280;118;162;Sonnig;5;5;0;Stadt Konstanz, Amt für Stadtplanung und Umwelt
07.11.2022 22:00;214;98;116;Sonnig;5;4;0;Stadt Konstanz, Amt für Stadtplanung und Umwelt
07.11.2022 23:00;85;32;53;Sonnig;4;4;0;Stadt Konstanz, Amt für Stadtplanung und Umwelt
08.11.2022 00:00;54;26;28;Sonnig;4;3;0;Stadt Konstanz, Amt für Stadtplanung und Umwelt
08.11.2022 01:00;34;12;22;Sonnig;4;4;0;Stadt Konstanz, Amt für Stadtplanung und Umwelt
08.11.2022 02:00;6;4;2;Bedeckt;4;4;0;Stadt Konstanz, Amt für Stadtplanung und Umwelt
08.11.2022 03:00;6;2;4;Bedeckt;4;4;0;Stadt Konstanz, Amt für Stadtplanung und Umwelt
08.11.2022 04:00;10;7;3;Bedeckt;4;4;0;Stadt Konstanz, Amt für Stadtplanung und Umwelt
08.11.2022 05:00;47;39;8;Leicht bewoelkt;4;4;0;Stadt Konstanz, Amt für Stadtplanung und Umwelt
08.11.2022 06:00;246;151;95;Leicht bewoelkt;4;4;0;Stadt Konstanz, Amt für Stadtplanung und Umwelt
08.11.2022 07:00;1086;660;426;Leicht bewoelkt;5;5;0;Stadt Konstanz, Amt für Stadtplanung und Umwelt
08.11.2022 08:00;903;498;405;Bedeckt;6;6;0;Stadt Konstanz, Amt für Stadtplanung und Umwelt
08.11.2022 09:00;777;437;340;Bedeckt;7;7;0;Stadt Konstanz, Amt für Stadtplanung und Umwelt
08.11.2022 10:00;404;207;197;Bedeckt;9;8;0;Stadt Konstanz, Amt für Stadtplanung und Umwelt
08.11.2022 11:00;589;282;307;Bedeckt;10;10;0;Stadt Konstanz, Amt für Stadtplanung und Umwelt
08.11.2022 12:00;632;289;343;Bedeckt;12;11;0;Stadt Konstanz, Amt für Stadtplanung und Umwelt
08.11.2022 13:00;933;428;505;Bedeckt;12;12;0;Stadt Konstanz, Amt für Stadtplanung und Umwelt
08.11.2022 14:00;711;345;366;Leicht bewoelkt;13;12;0;Stadt Konstanz, Amt für Stadtplanung und Umwelt
08.11.2022 15:00;1044;518;526;Leicht bewoelkt;13;13;0;Stadt Konstanz, Amt für Stadtplanung und Umwelt
08.11.2022 16:00;950;401;549;Leicht bewoelkt;11;11;0;Stadt Konstanz, Amt für Stadtplanung und Umwelt
08.11.2022 17:00;1015;444;571;Leicht bewoelkt;10;10;0;Stadt Konstanz, Amt für Stadtplanung und Umwelt
08.11.2022 18:00;865;414;451;Leicht bewoelkt;9;9;0;Stadt Konstanz, Amt für Stadtplanung und Umwelt
08.11.2022 19:00;669;348;321;Leicht bewoelkt;8;8;0;Stadt Konstanz, Amt für Stadtplanung und Umwelt
08.11.2022 20:00;404;201;203;Bewoelkt;8;8;0;Stadt Konstanz, Amt für Stadtplanung und Umwelt
08.11.2022 21:00;297;136;161;Bewoelkt;7;7;0;Stadt Konstanz, Amt für Stadtplanung und Umwelt
08.11.2022 22:00;235;92;143;Bewoelkt;7;7;0;Stadt Konstanz, Amt für Stadtplanung und Umwelt
08.11.2022 23:00;106;45;61;Sonnig;7;6;0;Stadt Konstanz, Amt für Stadtplanung und Umwelt
09.11.2022 00:00;45;17;28;Sonnig;7;6;0;Stadt Konstanz, Amt für Stadtplanung und Umwelt
09.11.2022 01:00;27;11;16;Sonnig;6;6;0;Stadt Konstanz, Amt für Stadtplanung und Umwelt
09.11.2022 02:00;8;4;4;Leicht bewoelkt;6;5;0;Stadt Konstanz, Amt für Stadtplanung und Umwelt
09.11.2022 03:00;3;0;3;Leicht bewoelkt;6;5;0;Stadt Konstanz, Amt für Stadtplanung und Umwelt
09.11.2022 04:00;12;6;6;Leicht bewoelkt;5;5;0;Stadt Konstanz, Amt für Stadtplanung und Umwelt
09.11.2022 05:00;45;31;14;Bewoelkt;5;5;0;Stadt Konstanz, Amt für Stadtplanung und Umwelt
09.11.2022 06:00;179;97;82;Bewoelkt;5;5;0;Stadt Konstanz, Amt für Stadtplanung und Umwelt
09.11.2022 07:00;1079;685;394;Bewoelkt;6;6;0;Stadt Konstanz, Amt für Stadtplanung und Umwelt
09.11.2022 08:00;723;392;331;Leicht bewoelkt;7;7;0;Stadt Konstanz, Amt für Stadtplanung und Umwelt
09.11.2022 09:00;636;344;292;Leicht bewoelkt;9;9;0;Stadt Konstanz, Amt für Stadtplanung und Umwelt
09.11.2022 10:00;361;204;157;Leicht bewoelkt;10;10;0;Stadt Konstanz, Amt für Stadtplanung und Umwelt
09.11.2022 11:00;537;248;289;Leicht bewoelkt;11;11;0;Stadt Konstanz, Amt für Stadtplanung und Umwelt
09.11.2022 12:00;601;280;321;Leicht bewoelkt;13;13;0;Stadt Konstanz, Amt für Stadtplanung und Umwelt
09.11.2022 13:00;931;493;438;Leicht bewoelkt;13;13;0;Stadt Konstanz, Amt für Stadtplanung und Umwelt
09.11.2022 14:00;578;270;308;Bewoelkt;13;14;0;Stadt Konstanz, Amt für Stadtplanung und Umwelt
09.11.2022 15:00;815;335;480;Bewoelkt;14;14;0;Stadt Konstanz, Amt für Stadtplanung und Umwelt
09.11.2022 16:00;695;352;343;Bewoelkt;12;12;0;Stadt Konstanz, Amt für Stadtplanung und Umwelt
09.11.2022 17:00;867;369;498;Bedeckt;11;11;0;Stadt Konstanz, Amt für Stadtplanung und Umwelt
09.11.2022 18:00;610;270;340;Bedeckt;10;10;0;Stadt Konstanz, Amt für Stadtplanung und Umwelt
09.11.2022 19:00;506;257;249;Bedeckt;10;10;0;Stadt Konstanz, Amt für Stadtplanung und Umwelt
09.11.2022 20:00;362;184;178;Stellenweiser Regenfall;10;10;0;Stadt Konstanz, Amt für Stadtplanung und Umwelt
09.11.2022 21:00;225;95;130;Stellenweiser Regenfall;10;10;0;Stadt Konstanz, Amt für Stadtplanung und Umwelt
09.11.2022 22:00;216;103;113;Stellenweiser Regenfall;10;10;0;Stadt Konstanz, Amt für Stadtplanung und Umwelt
09.11.2022 23:00;107;47;60;Leichter Regenfall;10;10;0.5;Stadt Konstanz, Amt für Stadtplanung und Umwelt
10.11.2022 00:00;42;19;23;Leichter Regenfall;10;9;0.9;Stadt Konstanz, Amt für Stadtplanung und Umwelt
10.11.2022 01:00;38;14;24;Leichter Regenfall;10;9;0.5;Stadt Konstanz, Amt für Stadtplanung und Umwelt
10.11.2022 02:00;11;5;6;Nieselregen;9;9;0.1;Stadt Konstanz, Amt für Stadtplanung und Umwelt
10.11.2022 03:00;5;2;3;Nieselregen;9;9;0.2;Stadt Konstanz, Amt für Stadtplanung und Umwelt
10.11.2022 04:00;17;8;9;Nieselregen;9;8;0.1;Stadt Konstanz, Amt für Stadtplanung und Umwelt
10.11.2022 05:00;42;30;12;Stellenweiser Regenfall;8;8;0.1;Stadt Konstanz, Amt für Stadtplanung und Umwelt
10.11.2022 06:00;159;94;65;Stellenweiser Regenfall;8;8;0.1;Stadt Konstanz, Amt für Stadtplanung und Umwelt
10.11.2022 07:00;1091;678;413;Stellenweiser Regenfall;8;8;0;Stadt Konstanz, Amt für Stadtplanung und Umwelt
10.11.2022 08:00;812;448;364;Sonnig;9;9;0;Stadt Konstanz, Amt für Stadtplanung und Umwelt
10.11.2022 09:00;740;411;329;Sonnig;10;10;0;Stadt Konstanz, Amt für Stadtplanung und Umwelt
10.11.2022 10:00;406;224;182;Sonnig;11;11;0;Stadt Konstanz, Amt für Stadtplanung und Umwelt
10.11.2022 11:00;559;278;281;Sonnig;12;12;0;Stadt Konstanz, Amt für Stadtplanung und Umwelt
10.11.2022 12:00;663;286;377;Sonnig;13;13;0;Stadt Konstanz, Amt für Stadtplanung und Umwelt
10.11.2022 13:00;977;456;521;Sonnig;13;13;0;Stadt Konstanz, Amt für Stadtplanung und Umwelt
10.11.2022 14:00;754;373;381;Sonnig;14;14;0;Stadt Konstanz, Amt für Stadtplanung und Umwelt
10.11.2022 15:00;1044;480;564;Sonnig;14;14;0;Stadt Konstanz, Amt für Stadtplanung und Umwelt
10.11.2022 16:00;1009;450;559;Sonnig;13;13;0;Stadt Konstanz, Amt für Stadtplanung und Umwelt
10.11.2022 17:00;1055;445;610;Sonnig;12;12;0;Stadt Konstanz, Amt für Stadtplanung und Umwelt
10.11.2022 18:00;816;416;400;Sonnig;10;11;0;Stadt Konstanz, Amt für Stadtplanung und Umwelt
10.11.2022 19:00;639;318;321;Sonnig;9;9;0;Stadt Konstanz, Amt für Stadtplanung und Umwelt
10.11.2022 20:00;386;180;206;Sonnig;8;7;0;Stadt Konstanz, Amt für Stadtplanung und Umwelt
10.11.2022 21:00;287;134;153;Sonnig;6;6;0;Stadt Konstanz, Amt für Stadtplanung und Umwelt
10.11.2022 22:00;228;118;110;Sonnig;6;5;0;Stadt Konstanz, Amt für Stadtplanung und Umwelt
10.11.2022 23:00;137;45;92;Bedeckt;5;5;0;Stadt Konstanz, Amt für Stadtplanung und Umwelt
11.11.2022 00:00;81;31;50;Bedeckt;5;4;0;Stadt Konstanz, Amt für Stadtplanung und Umwelt
11.11.2022 01:00;28;10;18;Bedeckt;5;4;0;Stadt Konstanz, Amt für Stadtplanung und Umwelt
11.11.2022 02:00;20;3;17;Leicht bewoelkt;4;4;0;Stadt Konstanz, Amt für Stadtplanung und Umwelt
11.11.2022 03:00;6;4;2;Leicht bewoelkt;4;4;0;Stadt Konstanz, Amt für Stadtplanung und Umwelt
11.11.2022 04:00;17;10;7;Leicht bewoelkt;4;4;0;Stadt Konstanz, Amt für Stadtplanung und Umwelt
11.11.2022 05:00;43;29;14;Leicht bewoelkt;4;4;0;Stadt Konstanz, Amt für Stadtplanung und Umwelt
11.11.2022 06:00;171;101;70;Leicht bewoelkt;3;3;0;Stadt Konstanz, Amt für Stadtplanung und Umwelt
11.11.2022 07:00;869;481;388;Leicht bewoelkt;4;4;0;Stadt Konstanz, Amt für Stadtplanung und Umwelt
11.11.2022 08:00;746;420;326;Sonnig;5;5;0;Stadt Konstanz, Amt für Stadtplanung und Umwelt
11.11.2022 09:00;679;382;297;Sonnig;6;6;0;Stadt Konstanz, Amt für Stadtplanung und Umwelt
11.11.2022 10:00;430;248;182;Sonnig;8;8;0;Stadt Konstanz, Amt für Stadtplanung und Umwelt
11.11.2022 11:00;693;399;294;Leicht bewoelkt;10;10;0;Stadt Konstanz, Amt für Stadtplanung und Umwelt
11.11.2022 12:00;704;325;379;Leicht bewoelkt;12;12;0;Stadt Konstanz, Amt für Stadtplanung und Umwelt
11.11.2022 13:00;845;362;483;Leicht bewoelkt;12;12;0;Stadt Konstanz, Amt für Stadtplanung und Umwelt
11.11.2022 14:00;690;332;358;Sonnig;13;13;0;Stadt Konstanz, Amt für Stadtplanung und Umwelt
11.11.2022 15:00;696;316;380;Sonnig;13;13;0;Stadt Konstanz, Amt für Stadtplanung und Umwelt
11.11.2022 16:00;715;317;398;Sonnig;11;11;0;Stadt Konstanz, Amt für Stadtplanung und Umwelt
11.11.2022 17:00;710;343;367;Sonnig;9;9;0;Stadt Konstanz, Amt für Stadtplanung und Umwelt
11.11.2022 18:00;586;271;315;Sonnig;7;7;0;Stadt Konstanz, Amt für Stadtplanung und Umwelt
11.11.2022 19:00;488;258;230;Sonnig;6;6;0;Stadt Konstanz, Amt für Stadtplanung und Umwelt
11.11.2022 20:00;362;191;171;Sonnig;5;5;0;Stadt Konstanz, Amt für Stadtplanung und Umwelt
11.11.2022 21:00;300;188;112;Sonnig;4;4;0;Stadt Konstanz, Amt für Stadtplanung und Umwelt
11.11.2022 22:00;213;98;115;Sonnig;4;4;0;Stadt Konstanz, Amt für Stadtplanung und Umwelt
11.11.2022 23:00;211;71;140;Sonnig;4;4;0;Stadt Konstanz, Amt für Stadtplanung und Umwelt
12.11.2022 00:00;154;60;94;Sonnig;4;4;0;Stadt Konstanz, Amt für Stadtplanung und Umwelt
12.11.2022 01:00;116;45;71;Sonnig;4;4;0;Stadt Konstanz, Amt für Stadtplanung und Umwelt
12.11.2022 02:00;86;36;50;Sonnig;4;4;0;Stadt Konstanz, Amt für Stadtplanung und Umwelt
12.11.2022 03:00;36;10;26;Sonnig;4;4;0;Stadt Konstanz, Amt für Stadtplanung und Umwelt
12.11.2022 04:00;36;12;24;Sonnig;3;3;0;Stadt Konstanz, Amt für Stadtplanung und Umwelt
12.11.2022 05:00;29;17;12;Sonnig;3;3;0;Stadt Konstanz, Amt für Stadtplanung und Umwelt
12.11.2022 06:00;50;23;27;Sonnig;3;3;0;Stadt Konstanz, Amt für Stadtplanung und Umwelt
12.11.2022 07:00;66;31;35;Sonnig;4;4;0;Stadt Konstanz, Amt für Stadtplanung und Umwelt
12.11.2022 08:00;200;100;100;Sonnig;5;5;0;Stadt Konstanz, Amt für Stadtplanung und Umwelt
12.11.2022 09:00;350;216;134;Sonnig;6;6;0;Stadt Konstanz, Amt für Stadtplanung und Umwelt
12.11.2022 10:00;420;235;185;Sonnig;8;8;0;Stadt Konstanz, Amt für Stadtplanung und Umwelt
12.11.2022 11:00;505;262;243;Sonnig;10;10;0;Stadt Konstanz, Amt für Stadtplanung und Umwelt
12.11.2022 12:00;520;256;264;Sonnig;12;12;0;Stadt Konstanz, Amt für Stadtplanung und Umwelt
12.11.2022 13:00;520;275;245;Sonnig;12;12;0;Stadt Konstanz, Amt für Stadtplanung und Umwelt
12.11.2022 14:00;566;279;287;Sonnig;12;12;0;Stadt Konstanz, Amt für Stadtplanung und Umwelt
12.11.2022 15:00;588;283;305;Sonnig;12;12;0;Stadt Konstanz, Amt für Stadtplanung und Umwelt
12.11.2022 16:00;473;211;262;Sonnig;10;10;0;Stadt Konstanz, Amt für Stadtplanung und Umwelt
12.11.2022 17:00;482;212;270;Sonnig;9;9;0;Stadt Konstanz, Amt für Stadtplanung und Umwelt
12.11.2022 18:00;450;180;270;Sonnig;7;7;0;Stadt Konstanz, Amt für Stadtplanung und Umwelt
12.11.2022 19:00;382;213;169;Sonnig;6;6;0;Stadt Konstanz, Amt für Stadtplanung und Umwelt
12.11.2022 20:00;288;147;141;Sonnig;6;5;0;Stadt Konstanz, Amt für Stadtplanung und Umwelt
12.11.2022 21:00;261;131;130;Sonnig;5;4;0;Stadt Konstanz, Amt für Stadtplanung und Umwelt
12.11.2022 22:00;160;48;112;Sonnig;4;4;0;Stadt Konstanz, Amt für Stadtplanung und Umwelt
12.11.2022 23:00;193;76;117;Sonnig;4;3;0;Stadt Konstanz, Amt für Stadtplanung und Umwelt
13.11.2022 00:00;142;49;93;Sonnig;3;3;0;Stadt Konstanz, Amt für Stadtplanung und Umwelt
13.11.2022 01:00;127;47;80;Sonnig;3;2;0;Stadt Konstanz, Amt für Stadtplanung und Umwelt
13.11.2022 02:00;90;23;67;Sonnig;3;2;0;Stadt Konstanz, Amt für Stadtplanung und Umwelt
13.11.2022 03:00;57;20;37;Sonnig;2;2;0;Stadt Konstanz, Amt für Stadtplanung und Umwelt
13.11.2022 04:00;33;10;23;Sonnig;2;2;0;Stadt Konstanz, Amt für Stadtplanung und Umwelt
13.11.2022 05:00;23;14;9;Sonnig;2;2;0;Stadt Konstanz, Amt für Stadtplanung und Umwelt
13.11.2022 06:00;35;23;12;Sonnig;2;2;0;Stadt Konstanz, Amt für Stadtplanung und Umwelt
13.11.2022 07:00;36;20;16;Sonnig;3;3;0;Stadt Konstanz, Amt für Stadtplanung und Umwelt
13.11.2022 08:00;58;15;43;Sonnig;4;4;0;Stadt Konstanz, Amt für Stadtplanung und Umwelt
13.11.2022 09:00;159;79;80;Sonnig;4;4;0;Stadt Konstanz, Amt für Stadtplanung und Umwelt
13.11.2022 10:00;178;110;68;Sonnig;7;7;0;Stadt Konstanz, Amt für Stadtplanung und Umwelt
13.11.2022 11:00;194;108;86;Sonnig;10;10;0;Stadt Konstanz, Amt für Stadtplanung und Umwelt
13.11.2022 12:00;254;123;131;Sonnig;13;13;0;Stadt Konstanz, Amt für Stadtplanung und Umwelt
13.11.2022 13:00;274;136;138;Sonnig;13;13;0;Stadt Konstanz, Amt für Stadtplanung und Umwelt
13.11.2022 14:00;314;159;155;Sonnig;14;14;0;Stadt Konstanz, Amt für Stadtplanung und Umwelt
13.11.2022 15:00;326;157;169;Sonnig;14;14;0;Stadt Konstanz, Amt für Stadtplanung und Umwelt
13.11.2022 16:00;375;172;203;Sonnig;12;12;0;Stadt Konstanz, Amt für Stadtplanung und Umwelt
13.11.2022 17:00;322;168;154;Sonnig;10;10;0;Stadt Konstanz, Amt für Stadtplanung und Umwelt
13.11.2022 18:00;311;167;144;Sonnig;8;8;0;Stadt Konstanz, Amt für Stadtplanung und Umwelt
13.11.2022 19:00;210;112;98;Sonnig;7;7;0;Stadt Konstanz, Amt für Stadtplanung und Umwelt
13.11.2022 20:00;155;83;72;Sonnig;6;6;0;Stadt Konstanz, Amt für Stadtplanung und Umwelt
13.11.2022 21:00;107;48;59;Sonnig;6;5;0;Stadt Konstanz, Amt für Stadtplanung und Umwelt
13.11.2022 22:00;122;51;71;Sonnig;5;5;0;Stadt Konstanz, Amt für Stadtplanung und Umwelt
13.11.2022 23:00;67;35;32;Leicht bewoelkt;5;4;0;Stadt Konstanz, Amt für Stadtplanung und Umwelt
14.11.2022 00:00;18;6;12;Leicht bewoelkt;4;3;0;Stadt Konstanz, Amt für Stadtplanung und Umwelt
14.11.2022 01:00;10;2;8;Leicht bewoelkt;4;4;0;Stadt Konstanz, Amt für Stadtplanung und Umwelt
14.11.2022 02:00;11;4;7;Bewoelkt;4;4;0;Stadt Konstanz, Amt für Stadtplanung und Umwelt
14.11.2022 03:00;5;1;4;Bewoelkt;5;5;0;Stadt Konstanz, Amt für Stadtplanung und Umwelt
14.11.2022 04:00;16;13;3;Bewoelkt;5;5;0;Stadt Konstanz, Amt für Stadtplanung und Umwelt
14.11.2022 05:00;35;21;14;Bewoelkt;5;5;0;Stadt Konstanz, Amt für Stadtplanung und Umwelt
14.11.2022 06:00;180;101;79;Bewoelkt;6;5;0;Stadt Konstanz, Amt für Stadtplanung und Umwelt
14.11.2022 07:00;1052;637;415;Bewoelkt;6;5;0;Stadt Konstanz, Amt für Stadtplanung und Umwelt
14.11.2022 08:00;682;347;335;Leichter Regenfall;6;5;0.4;Stadt Konstanz, Amt für Stadtplanung und Umwelt
14.11.2022 09:00;562;317;245;Leichter Regenfall;6;5;0.5;Stadt Konstanz, Amt für Stadtplanung und Umwelt
14.11.2022 10:00;236;129;107;Leichter Regenfall;7;5;0.3;Stadt Konstanz, Amt für Stadtplanung und Umwelt
14.11.2022 11:00;404;200;204;Leichter Regenfall;7;6;0.8;Stadt Konstanz, Amt für Stadtplanung und Umwelt
14.11.2022 12:00;462;225;237;Leichter Regenfall;8;6;01. Jan;Stadt Konstanz, Amt für Stadtplanung und Umwelt
14.11.2022 13:00;735;327;408;Leichter Regenfall;8;7;0.5;Stadt Konstanz, Amt für Stadtplanung und Umwelt
14.11.2022 14:00;516;278;238;Bedeckt;9;7;0;Stadt Konstanz, Amt für Stadtplanung und Umwelt
14.11.2022 15:00;931;413;518;Bedeckt;9;8;0;Stadt Konstanz, Amt für Stadtplanung und Umwelt
14.11.2022 16:00;812;412;400;Bedeckt;9;8;0;Stadt Konstanz, Amt für Stadtplanung und Umwelt
14.11.2022 17:00;912;416;496;Nieselregen;9;7;0.1;Stadt Konstanz, Amt für Stadtplanung und Umwelt
14.11.2022 18:00;654;287;367;Nieselregen;8;7;0.2;Stadt Konstanz, Amt für Stadtplanung und Umwelt
14.11.2022 19:00;547;264;283;Nieselregen;8;7;0.1;Stadt Konstanz, Amt für Stadtplanung und Umwelt
14.11.2022 20:00;388;187;201;Stellenweiser Nieselregen;8;8;0.1;Stadt Konstanz, Amt für Stadtplanung und Umwelt
14.11.2022 21:00;221;106;115;Stellenweiser Nieselregen;8;8;0.1;Stadt Konstanz, Amt für Stadtplanung und Umwelt
14.11.2022 22:00;198;74;124;Stellenweiser Nieselregen;7;7;0.1;Stadt Konstanz, Amt für Stadtplanung und Umwelt
14.11.2022 23:00;93;40;53;Leicht bewoelkt;6;6;0;Stadt Konstanz, Amt für Stadtplanung und Umwelt
15.11.2022 00:00;35;15;20;Leicht bewoelkt;5;5;0;Stadt Konstanz, Amt für Stadtplanung und Umwelt
15.11.2022 01:00;17;11;6;Leicht bewoelkt;5;5;0;Stadt Konstanz, Amt für Stadtplanung und Umwelt
15.11.2022 02:00;12;8;4;Leicht bewoelkt;4;4;0;Stadt Konstanz, Amt für Stadtplanung und Umwelt
15.11.2022 03:00;6;1;5;Leicht bewoelkt;4;4;0;Stadt Konstanz, Amt für Stadtplanung und Umwelt
15.11.2022 04:00;16;12;4;Leicht bewoelkt;4;4;0;Stadt Konstanz, Amt für Stadtplanung und Umwelt
15.11.2022 05:00;52;40;12;Leicht bewoelkt;5;4;0;Stadt Konstanz, Amt für Stadtplanung und Umwelt
15.11.2022 06:00;193;121;72;Leicht bewoelkt;5;4;0;Stadt Konstanz, Amt für Stadtplanung und Umwelt
15.11.2022 07:00;1101;690;411;Leicht bewoelkt;6;5;0;Stadt Konstanz, Amt für Stadtplanung und Umwelt
15.11.2022 08:00;811;430;381;Bedeckt;6;6;0;Stadt Konstanz, Amt für Stadtplanung und Umwelt
15.11.2022 09:00;790;480;310;Bedeckt;7;7;0;Stadt Konstanz, Amt für Stadtplanung und Umwelt
15.11.2022 10:00;452;239;213;Bedeckt;8;8;0;Stadt Konstanz, Amt für Stadtplanung und Umwelt
15.11.2022 11:00;589;296;293;Bedeckt;9;9;0;Stadt Konstanz, Amt für Stadtplanung und Umwelt
15.11.2022 12:00;632;276;356;Bedeckt;10;10;0;Stadt Konstanz, Amt für Stadtplanung und Umwelt
15.11.2022 13:00;882;382;500;Bedeckt;10;10;0;Stadt Konstanz, Amt für Stadtplanung und Umwelt
15.11.2022 14:00;649;314;335;Bedeckt;11;10;0;Stadt Konstanz, Amt für Stadtplanung und Umwelt
15.11.2022 15:00;1016;491;525;Bedeckt;11;11;0;Stadt Konstanz, Amt für Stadtplanung und Umwelt
15.11.2022 16:00;849;390;459;Bedeckt;10;10;0;Stadt Konstanz, Amt für Stadtplanung und Umwelt
15.11.2022 17:00;1001;441;560;Bewoelkt;9;9;0;Stadt Konstanz, Amt für Stadtplanung und Umwelt
15.11.2022 18:00;816;347;469;Bewoelkt;8;8;0;Stadt Konstanz, Amt für Stadtplanung und Umwelt
15.11.2022 19:00;573;283;290;Bewoelkt;7;8;0;Stadt Konstanz, Amt für Stadtplanung und Umwelt
15.11.2022 20:00;380;192;188;Bewoelkt;7;7;0;Stadt Konstanz, Amt für Stadtplanung und Umwelt
15.11.2022 21:00;310;129;181;Bewoelkt;7;7;0;Stadt Konstanz, Amt für Stadtplanung und Umwelt
15.11.2022 22:00;218;86;132;Bewoelkt;6;6;0;Stadt Konstanz, Amt für Stadtplanung und Umwelt
15.11.2022 23:00;105;53;52;Bedeckt;6;6;0;Stadt Konstanz, Amt für Stadtplanung und Umwelt
16.11.2022 00:00;54;23;31;Bedeckt;6;5;0;Stadt Konstanz, Amt für Stadtplanung und Umwelt
16.11.2022 01:00;49;26;23;Bedeckt;6;5;0;Stadt Konstanz, Amt für Stadtplanung und Umwelt
16.11.2022 02:00;10;3;7;Bedeckt;6;6;0;Stadt Konstanz, Amt für Stadtplanung und Umwelt
16.11.2022 03:00;5;4;1;Bedeckt;6;6;0;Stadt Konstanz, Amt für Stadtplanung und Umwelt
16.11.2022 04:00;14;8;6;Bedeckt;6;6;0;Stadt Konstanz, Amt für Stadtplanung und Umwelt
16.11.2022 05:00;34;24;10;Nieselregen;7;6;0.1;Stadt Konstanz, Amt für Stadtplanung und Umwelt
16.11.2022 06:00;178;116;62;Nieselregen;7;6;0.2;Stadt Konstanz, Amt für Stadtplanung und Umwelt
16.11.2022 07:00;1106;701;405;Nieselregen;7;6;0.1;Stadt Konstanz, Amt für Stadtplanung und Umwelt
16.11.2022 08:00;774;425;349;Leichter Nebel;7;7;0;Stadt Konstanz, Amt für Stadtplanung und Umwelt
16.11.2022 09:00;704;400;304;Leichter Nebel;8;7;0;Stadt Konstanz, Amt für Stadtplanung und Umwelt
16.11.2022 10:00;458;249;209;Leichter Nebel;8;8;0;Stadt Konstanz, Amt für Stadtplanung und Umwelt
16.11.2022 11:00;647;311;336;Nieselregen;9;8;0.1;Stadt Konstanz, Amt für Stadtplanung und Umwelt
16.11.2022 12:00;682;331;351;Nieselregen;9;9;0.2;Stadt Konstanz, Amt für Stadtplanung und Umwelt
16.11.2022 13:00;929;450;479;Nieselregen;9;9;0.1;Stadt Konstanz, Amt für Stadtplanung und Umwelt
16.11.2022 14:00;727;347;380;Bewoelkt;10;10;0;Stadt Konstanz, Amt für Stadtplanung und Umwelt
16.11.2022 15:00;1008;423;585;Bewoelkt;10;10;0;Stadt Konstanz, Amt für Stadtplanung und Umwelt
16.11.2022 16:00;935;436;499;Bewoelkt;9;9;0;Stadt Konstanz, Amt für Stadtplanung und Umwelt
16.11.2022 17:00;1057;487;570;Sonnig;8;8;0;Stadt Konstanz, Amt für Stadtplanung und Umwelt
16.11.2022 18:00;848;418;430;Sonnig;8;8;0;Stadt Konstanz, Amt für Stadtplanung und Umwelt
16.11.2022 19:00;610;319;291;Sonnig;7;7;0;Stadt Konstanz, Amt für Stadtplanung und Umwelt
16.11.2022 20:00;490;219;271;Sonnig;6;6;0;Stadt Konstanz, Amt für Stadtplanung und Umwelt
16.11.2022 21:00;318;147;171;Sonnig;5;5;0;Stadt Konstanz, Amt für Stadtplanung und Umwelt
16.11.2022 22:00;236;79;157;Sonnig;5;4;0;Stadt Konstanz, Amt für Stadtplanung und Umwelt
16.11.2022 23:00;151;47;104;Sonnig;5;4;0;Stadt Konstanz, Amt für Stadtplanung und Umwelt
17.11.2022 00:00;74;26;48;Sonnig;5;4;0;Stadt Konstanz, Amt für Stadtplanung und Umwelt
17.11.2022 01:00;34;10;24;Sonnig;5;4;0;Stadt Konstanz, Amt für Stadtplanung und Umwelt
17.11.2022 02:00;29;17;12;Leicht bewoelkt;4;4;0;Stadt Konstanz, Amt für Stadtplanung und Umwelt
17.11.2022 03:00;22;18;4;Leicht bewoelkt;4;4;0;Stadt Konstanz, Amt für Stadtplanung und Umwelt
17.11.2022 04:00;17;11;6;Leicht bewoelkt;5;4;0;Stadt Konstanz, Amt für Stadtplanung und Umwelt
17.11.2022 05:00;49;37;12;Bedeckt;5;4;0;Stadt Konstanz, Amt für Stadtplanung und Umwelt
17.11.2022 06:00;162;99;63;Bedeckt;5;4;0;Stadt Konstanz, Amt für Stadtplanung und Umwelt
17.11.2022 07:00;998;602;396;Bedeckt;6;5;0;Stadt Konstanz, Amt für Stadtplanung und Umwelt
17.11.2022 08:00;731;399;332;Bewoelkt;7;6;0;Stadt Konstanz, Amt für Stadtplanung und Umwelt
17.11.2022 09:00;731;417;314;Bewoelkt;7;7;0;Stadt Konstanz, Amt für Stadtplanung und Umwelt
17.11.2022 10:00;404;243;161;Bewoelkt;7;7;0;Stadt Konstanz, Amt für Stadtplanung und Umwelt
17.11.2022 11:00;616;287;329;Stellenweiser Regenfall;7;7;0.1;Stadt Konstanz, Amt für Stadtplanung und Umwelt
17.11.2022 12:00;614;273;341;Stellenweiser Regenfall;8;6;0.2;Stadt Konstanz, Amt für Stadtplanung und Umwelt
17.11.2022 13:00;993;428;565;Stellenweiser Regenfall;9;8;0.1;Stadt Konstanz, Amt für Stadtplanung und Umwelt
17.11.2022 14:00;698;348;350;Leicht bewoelkt;10;9;0;Stadt Konstanz, Amt für Stadtplanung und Umwelt
17.11.2022 15:00;1066;522;544;Leicht bewoelkt;11;10;0;Stadt Konstanz, Amt für Stadtplanung und Umwelt
17.11.2022 16:00;849;353;496;Leicht bewoelkt;10;9;0;Stadt Konstanz, Amt für Stadtplanung und Umwelt
17.11.2022 17:00;1018;444;574;Leichter Regenschauer;10;8;0.1;Stadt Konstanz, Amt für Stadtplanung und Umwelt
17.11.2022 18:00;756;377;379;Leichter Regenschauer;9;7;0.1;Stadt Konstanz, Amt für Stadtplanung und Umwelt
17.11.2022 19:00;528;265;263;Leichter Regenschauer;8;7;0;Stadt Konstanz, Amt für Stadtplanung und Umwelt
17.11.2022 20:00;414;214;200;Stellenweiser Regenfall;8;6;0;Stadt Konstanz, Amt für Stadtplanung und Umwelt
17.11.2022 21:00;280;114;166;Stellenweiser Regenfall;7;5;0;Stadt Konstanz, Amt für Stadtplanung und Umwelt
17.11.2022 22:00;220;90;130;Stellenweiser Regenfall;7;6;0;Stadt Konstanz, Amt für Stadtplanung und Umwelt
17.11.2022 23:00;98;45;53;Nieselregen;7;6;0.1;Stadt Konstanz, Amt für Stadtplanung und Umwelt
18.11.2022 00:00;72;24;48;Nieselregen;7;7;0.1;Stadt Konstanz, Amt für Stadtplanung und Umwelt
18.11.2022 01:00;25;12;13;Nieselregen;7;6;0.1;Stadt Konstanz, Amt für Stadtplanung und Umwelt
18.11.2022 02:00;5;3;2;Nieselregen;7;5;0.2;Stadt Konstanz, Amt für Stadtplanung und Umwelt
18.11.2022 03:00;3;1;2;Nieselregen;7;4;0.2;Stadt Konstanz, Amt für Stadtplanung und Umwelt
18.11.2022 04:00;14;8;6;Nieselregen;7;5;0.1;Stadt Konstanz, Amt für Stadtplanung und Umwelt
18.11.2022 05:00;34;26;8;Leichter Regenfall;8;5;0.4;Stadt Konstanz, Amt für Stadtplanung und Umwelt
18.11.2022 06:00;122;77;45;Leichter Regenfall;8;6;0.6;Stadt Konstanz, Amt für Stadtplanung und Umwelt
18.11.2022 07:00;842;499;343;Leichter Regenfall;8;5;0.3;Stadt Konstanz, Amt für Stadtplanung und Umwelt
18.11.2022 08:00;592;330;262;Bedeckt;8;5;0;Stadt Konstanz, Amt für Stadtplanung und Umwelt
18.11.2022 09:00;699;399;300;Bedeckt;8;5;0;Stadt Konstanz, Amt für Stadtplanung und Umwelt
18.11.2022 10:00;413;228;185;Bedeckt;8;5;0;Stadt Konstanz, Amt für Stadtplanung und Umwelt
18.11.2022 11:00;563;297;266;Stellenweiser Regenfall;9;6;0.1;Stadt Konstanz, Amt für Stadtplanung und Umwelt
18.11.2022 12:00;671;347;324;Stellenweiser Regenfall;9;7;0.2;Stadt Konstanz, Amt für Stadtplanung und Umwelt
18.11.2022 13:00;917;360;557;Stellenweiser Regenfall;9;7;0.1;Stadt Konstanz, Amt für Stadtplanung und Umwelt
18.11.2022 14:00;651;338;313;Bewoelkt;9;7;0;Stadt Konstanz, Amt für Stadtplanung und Umwelt
18.11.2022 15:00;647;298;349;Bewoelkt;9;8;0;Stadt Konstanz, Amt für Stadtplanung und Umwelt
18.11.2022 16:00;627;304;323;Bewoelkt;8;7;0;Stadt Konstanz, Amt für Stadtplanung und Umwelt
18.11.2022 17:00;627;304;323;Stellenweiser Regenfall;8;7;0;Stadt Konstanz, Amt für Stadtplanung und Umwelt
18.11.2022 18:00;554;264;290;Stellenweiser Regenfall;7;7;0;Stadt Konstanz, Amt für Stadtplanung und Umwelt
18.11.2022 19:00;508;292;216;Stellenweiser Regenfall;7;7;0;Stadt Konstanz, Amt für Stadtplanung und Umwelt
18.11.2022 20:00;314;169;145;Stellenweiser Regenfall;7;7;0;Stadt Konstanz, Amt für Stadtplanung und Umwelt
18.11.2022 21:00;297;137;160;Stellenweiser Regenfall;7;7;0;Stadt Konstanz, Amt für Stadtplanung und Umwelt
18.11.2022 22:00;229;89;140;Stellenweiser Regenfall;6;6;0;Stadt Konstanz, Amt für Stadtplanung und Umwelt
18.11.2022 23:00;199;73;126;Stellenweiser Regenfall;6;5;0;Stadt Konstanz, Amt für Stadtplanung und Umwelt
19.11.2022 00:00;171;56;115;Stellenweiser Regenfall;5;4;0.1;Stadt Konstanz, Amt für Stadtplanung und Umwelt
19.11.2022 01:00;91;30;61;Stellenweiser Regenfall;5;4;0;Stadt Konstanz, Amt für Stadtplanung und Umwelt
19.11.2022 02:00;59;25;34;Bedeckt;5;4;0;Stadt Konstanz, Amt für Stadtplanung und Umwelt
19.11.2022 03:00;46;17;29;Bedeckt;5;5;0;Stadt Konstanz, Amt für Stadtplanung und Umwelt
19.11.2022 04:00;33;14;19;Bedeckt;5;5;0;Stadt Konstanz, Amt für Stadtplanung und Umwelt
19.11.2022 05:00;33;15;18;Bedeckt;5;5;0;Stadt Konstanz, Amt für Stadtplanung und Umwelt
19.11.2022 06:00;37;23;14;Bedeckt;5;5;0;Stadt Konstanz, Amt für Stadtplanung und Umwelt
19.11.2022 07:00;62;34;28;Bedeckt;6;6;0;Stadt Konstanz, Amt für Stadtplanung und Umwelt
19.11.2022 08:00;194;101;93;Bedeckt;6;6;0;Stadt Konstanz, Amt für Stadtplanung und Umwelt
19.11.2022 09:00;339;205;134;Bedeckt;6;6;0;Stadt Konstanz, Amt für Stadtplanung und Umwelt
19.11.2022 10:00;398;242;156;Bedeckt;6;6;0;Stadt Konstanz, Amt für Stadtplanung und Umwelt
19.11.2022 11:00;544;322;222;Bewoelkt;7;7;0;Stadt Konstanz, Amt für Stadtplanung und Umwelt
19.11.2022 12:00;507;271;236;Bewoelkt;7;7;0;Stadt Konstanz, Amt für Stadtplanung und Umwelt
19.11.2022 13:00;636;319;317;Bewoelkt;7;7;0;Stadt Konstanz, Amt für Stadtplanung und Umwelt
19.11.2022 14:00;601;283;318;Bedeckt;7;7;0;Stadt Konstanz, Amt für Stadtplanung und Umwelt
19.11.2022 15:00;628;259;369;Bedeckt;7;7;0;Stadt Konstanz, Amt für Stadtplanung und Umwelt
19.11.2022 16:00;548;217;331;Bedeckt;7;7;0;Stadt Konstanz, Amt für Stadtplanung und Umwelt
19.11.2022 17:00;497;227;270;Leicht bewoelkt;6;6;0;Stadt Konstanz, Amt für Stadtplanung und Umwelt
19.11.2022 18:00;394;166;228;Leicht bewoelkt;6;6;0;Stadt Konstanz, Amt für Stadtplanung und Umwelt
19.11.2022 19:00;353;192;161;Leicht bewoelkt;6;6;0;Stadt Konstanz, Amt für Stadtplanung und Umwelt
19.11.2022 20:00;232;122;110;Bewoelkt;6;5;0;Stadt Konstanz, Amt für Stadtplanung und Umwelt
19.11.2022 21:00;170;86;84;Bewoelkt;5;5;0;Stadt Konstanz, Amt für Stadtplanung und Umwelt
19.11.2022 22:00;174;56;118;Bewoelkt;5;5;0;Stadt Konstanz, Amt für Stadtplanung und Umwelt
19.11.2022 23:00;137;52;85;Stellenweiser Regenfall;5;4;0;Stadt Konstanz, Amt für Stadtplanung und Umwelt
20.11.2022 00:00;132;50;82;Stellenweiser Regenfall;5;4;0.1;Stadt Konstanz, Amt für Stadtplanung und Umwelt
20.11.2022 01:00;116;42;74;Stellenweiser Regenfall;5;4;0;Stadt Konstanz, Amt für Stadtplanung und Umwelt
20.11.2022 02:00;89;38;51;Stellenweiser Regenfall;5;3;0;Stadt Konstanz, Amt für Stadtplanung und Umwelt
20.11.2022 03:00;60;21;39;Stellenweiser Regenfall;5;3;0;Stadt Konstanz, Amt für Stadtplanung und Umwelt
20.11.2022 04:00;23;14;9;Stellenweiser Regenfall;5;3;0;Stadt Konstanz, Amt für Stadtplanung und Umwelt
20.11.2022 05:00;32;16;16;Leichter Regenschauer;5;3;0.1;Stadt Konstanz, Amt für Stadtplanung und Umwelt
20.11.2022 06:00;31;24;7;Leichter Regenschauer;5;3;0.1;Stadt Konstanz, Amt für Stadtplanung und Umwelt
20.11.2022 07:00;31;15;16;Leichter Regenschauer;5;3;0;Stadt Konstanz, Amt für Stadtplanung und Umwelt
20.11.2022 08:00;80;36;44;Leichter Regenschauer;5;3;0.1;Stadt Konstanz, Amt für Stadtplanung und Umwelt
20.11.2022 09:00;199;113;86;Leichter Regenschauer;5;2;0.1;Stadt Konstanz, Amt für Stadtplanung und Umwelt
20.11.2022 10:00;182;100;82;Leichter Regenschauer;5;3;0;Stadt Konstanz, Amt für Stadtplanung und Umwelt
20.11.2022 11:00;259;137;122;Stellenweiser Regenfall;6;3;0;Stadt Konstanz, Amt für Stadtplanung und Umwelt
20.11.2022 12:00;285;146;139;Stellenweiser Regenfall;6;3;0;Stadt Konstanz, Amt für Stadtplanung und Umwelt
20.11.2022 13:00;296;161;135;Stellenweiser Regenfall;6;4;0;Stadt Konstanz, Amt für Stadtplanung und Umwelt
20.11.2022 14:00;349;171;178;Bewoelkt;6;4;0;Stadt Konstanz, Amt für Stadtplanung und Umwelt
20.11.2022 15:00;325;174;151;Bewoelkt;6;4;0;Stadt Konstanz, Amt für Stadtplanung und Umwelt
20.11.2022 16:00;409;211;198;Bewoelkt;5;3;0;Stadt Konstanz, Amt für Stadtplanung und Umwelt
20.11.2022 17:00;291;120;171;Leicht bewoelkt;4;2;0;Stadt Konstanz, Amt für Stadtplanung und Umwelt
20.11.2022 18:00;274;120;154;Leicht bewoelkt;3;1;0;Stadt Konstanz, Amt für Stadtplanung und Umwelt
20.11.2022 19:00;228;101;127;Leicht bewoelkt;3;1;0;Stadt Konstanz, Amt für Stadtplanung und Umwelt
20.11.2022 20:00;144;68;76;Bedeckt;3;0;0;Stadt Konstanz, Amt für Stadtplanung und Umwelt
20.11.2022 21:00;109;38;71;Bedeckt;2;0;0;Stadt Konstanz, Amt für Stadtplanung und Umwelt
20.11.2022 22:00;87;46;41;Bedeckt;3;0;0;Stadt Konstanz, Amt für Stadtplanung und Umwelt
20.11.2022 23:00;51;31;20;Stellenweiser Regenfall;4;1;0;Stadt Konstanz, Amt für Stadtplanung und Umwelt
21.11.2022 00:00;17;7;10;Stellenweiser Regenfall;5;1;0.1;Stadt Konstanz, Amt für Stadtplanung und Umwelt
21.11.2022 01:00;18;8;10;Stellenweiser Regenfall;5;1;0;Stadt Konstanz, Amt für Stadtplanung und Umwelt
21.11.2022 02:00;3;1;2;Nieselregen;5;1;0.1;Stadt Konstanz, Amt für Stadtplanung und Umwelt
21.11.2022 03:00;6;2;4;Nieselregen;5;1;0.1;Stadt Konstanz, Amt für Stadtplanung und Umwelt
21.11.2022 04:00;19;10;9;Nieselregen;5;1;0;Stadt Konstanz, Amt für Stadtplanung und Umwelt
21.11.2022 05:00;33;22;11;Stellenweiser Regenfall;5;1;0;Stadt Konstanz, Amt für Stadtplanung und Umwelt
21.11.2022 06:00;161;92;69;Stellenweiser Regenfall;5;2;0;Stadt Konstanz, Amt für Stadtplanung und Umwelt
21.11.2022 07:00;994;597;397;Stellenweiser Regenfall;5;2;0;Stadt Konstanz, Amt für Stadtplanung und Umwelt
21.11.2022 08:00;676;357;319;Sonnig;5;3;0;Stadt Konstanz, Amt für Stadtplanung und Umwelt
21.11.2022 09:00;636;362;274;Sonnig;5;3;0;Stadt Konstanz, Amt für Stadtplanung und Umwelt
21.11.2022 10:00;389;189;200;Sonnig;6;5;0;Stadt Konstanz, Amt für Stadtplanung und Umwelt
21.11.2022 11:00;482;254;228;Sonnig;8;6;0;Stadt Konstanz, Amt für Stadtplanung und Umwelt
21.11.2022 12:00;535;234;301;Sonnig;9;8;0;Stadt Konstanz, Amt für Stadtplanung und Umwelt
21.11.2022 13:00;822;372;450;Sonnig;9;8;0;Stadt Konstanz, Amt für Stadtplanung und Umwelt
21.11.2022 14:00;568;290;278;Sonnig;9;8;0;Stadt Konstanz, Amt für Stadtplanung und Umwelt
21.11.2022 15:00;957;441;516;Sonnig;9;7;0;Stadt Konstanz, Amt für Stadtplanung und Umwelt
21.11.2022 16:00;822;374;448;Sonnig;7;6;0;Stadt Konstanz, Amt für Stadtplanung und Umwelt
21.11.2022 17:00;940;439;501;Bewoelkt;6;4;0;Stadt Konstanz, Amt für Stadtplanung und Umwelt
21.11.2022 18:00;669;315;354;Bewoelkt;4;2;0;Stadt Konstanz, Amt für Stadtplanung und Umwelt
21.11.2022 19:00;574;277;297;Bewoelkt;4;3;0;Stadt Konstanz, Amt für Stadtplanung und Umwelt
21.11.2022 20:00;376;188;188;Bedeckt;4;3;0;Stadt Konstanz, Amt für Stadtplanung und Umwelt
21.11.2022 21:00;247;107;140;Bedeckt;4;4;0;Stadt Konstanz, Amt für Stadtplanung und Umwelt
21.11.2022 22:00;179;75;104;Bedeckt;4;3;0;Stadt Konstanz, Amt für Stadtplanung und Umwelt
21.11.2022 23:00;86;38;48;Leicht bewoelkt;3;2;0;Stadt Konstanz, Amt für Stadtplanung und Umwelt
22.11.2022 00:00;43;21;22;Leicht bewoelkt;3;2;0;Stadt Konstanz, Amt für Stadtplanung und Umwelt
22.11.2022 01:00;6;3;3;Leicht bewoelkt;3;2;0;Stadt Konstanz, Amt für Stadtplanung und Umwelt
22.11.2022 02:00;8;6;2;Bedeckt;3;2;0;Stadt Konstanz, Amt für Stadtplanung und Umwelt
22.11.2022 03:00;4;2;2;Bedeckt;3;2;0;Stadt Konstanz, Amt für Stadtplanung und Umwelt
22.11.2022 04:00;18;10;8;Bedeckt;3;2;0;Stadt Konstanz, Amt für Stadtplanung und Umwelt
22.11.2022 05:00;44;33;11;Bedeckt;4;3;0;Stadt Konstanz, Amt für Stadtplanung und Umwelt
22.11.2022 06:00;185;114;71;Bedeckt;4;3;0;Stadt Konstanz, Amt für Stadtplanung und Umwelt
22.11.2022 07:00;1040;626;414;Bedeckt;4;2;0;Stadt Konstanz, Amt für Stadtplanung und Umwelt
22.11.2022 08:00;805;439;366;Leichter Regenfall;4;2;0.3;Stadt Konstanz, Amt für Stadtplanung und Umwelt
22.11.2022 09:00;802;487;315;Leichter Regenfall;4;2;0.4;Stadt Konstanz, Amt für Stadtplanung und Umwelt
22.11.2022 10:00;414;247;167;Leichter Regenfall;3;2;0.2;Stadt Konstanz, Amt für Stadtplanung und Umwelt
22.11.2022 11:00;543;257;286;Leichter Eisregen;3;1;0.4;Stadt Konstanz, Amt für Stadtplanung und Umwelt
22.11.2022 12:00;665;261;404;Leichter Eisregen;3;1;0.5;Stadt Konstanz, Amt für Stadtplanung und Umwelt
22.11.2022 13:00;917;356;561;Leichter Eisregen;4;1;0.3;Stadt Konstanz, Amt für Stadtplanung und Umwelt
22.11.2022 14:00;630;334;296;Nieselregen;4;1;0.2;Stadt Konstanz, Amt für Stadtplanung und Umwelt
22.11.2022 15:00;910;456;454;Nieselregen;4;2;0.2;Stadt Konstanz, Amt für Stadtplanung und Umwelt
22.11.2022 16:00;821;381;440;Nieselregen;4;1;0.1;Stadt Konstanz, Amt für Stadtplanung und Umwelt
22.11.2022 17:00;974;444;530;Leichter Regenschauer;4;1;0.1;Stadt Konstanz, Amt für Stadtplanung und Umwelt
22.11.2022 18:00;760;333;427;Leichter Regenschauer;4;1;0.1;Stadt Konstanz, Amt für Stadtplanung und Umwelt
22.11.2022 19:00;526;249;277;Leichter Regenschauer;3;1;0.1;Stadt Konstanz, Amt für Stadtplanung und Umwelt
22.11.2022 20:00;409;203;206;Leichter Nebel;3;1;0;Stadt Konstanz, Amt für Stadtplanung und Umwelt
22.11.2022 21:00;285;136;149;Leichter Nebel;3;1;0;Stadt Konstanz, Amt für Stadtplanung und Umwelt
22.11.2022 22:00;232;104;128;Leichter Nebel;2;0;0;Stadt Konstanz, Amt für Stadtplanung und Umwelt
22.11.2022 23:00;113;47;66;Bewoelkt;2;0;0;Stadt Konstanz, Amt für Stadtplanung und Umwelt
23.11.2022 00:00;57;17;40;Bewoelkt;1;0;0;Stadt Konstanz, Amt für Stadtplanung und Umwelt
23.11.2022 01:00;82;33;49;Bewoelkt;1;0;0;Stadt Konstanz, Amt für Stadtplanung und Umwelt
23.11.2022 02:00;50;3;47;Bedeckt;1;0;0;Stadt Konstanz, Amt für Stadtplanung und Umwelt
23.11.2022 03:00;15;4;11;Bedeckt;1;0;0;Stadt Konstanz, Amt für Stadtplanung und Umwelt
23.11.2022 04:00;18;8;10;Bedeckt;1;0;0;Stadt Konstanz, Amt für Stadtplanung und Umwelt
23.11.2022 05:00;40;26;14;Bedeckt;2;0;0;Stadt Konstanz, Amt für Stadtplanung und Umwelt
23.11.2022 06:00;186;112;74;Bedeckt;2;1;0;Stadt Konstanz, Amt für Stadtplanung und Umwelt
23.11.2022 07:00;990;630;360;Bedeckt;3;1;0;Stadt Konstanz, Amt für Stadtplanung und Umwelt
23.11.2022 08:00;789;437;352;Leicht bewoelkt;3;2;0;Stadt Konstanz, Amt für Stadtplanung und Umwelt
23.11.2022 09:00;675;374;301;Leicht bewoelkt;4;2;0;Stadt Konstanz, Amt für Stadtplanung und Umwelt
23.11.2022 10:00;432;236;196;Leicht bewoelkt;5;3;0;Stadt Konstanz, Amt für Stadtplanung und Umwelt
23.11.2022 11:00;582;242;340;Leicht bewoelkt;6;4;0;Stadt Konstanz, Amt für Stadtplanung und Umwelt
23.11.2022 12:00;657;291;366;Leicht bewoelkt;7;5;0;Stadt Konstanz, Amt für Stadtplanung und Umwelt
23.11.2022 13:00;1029;489;540;Leicht bewoelkt;7;6;0;Stadt Konstanz, Amt für Stadtplanung und Umwelt
23.11.2022 14:00;681;338;343;Leicht bewoelkt;8;6;0;Stadt Konstanz, Amt für Stadtplanung und Umwelt
23.11.2022 15:00;853;386;467;Leicht bewoelkt;8;7;0;Stadt Konstanz, Amt für Stadtplanung und Umwelt
23.11.2022 16:00;859;370;489;Leicht bewoelkt;6;5;0;Stadt Konstanz, Amt für Stadtplanung und Umwelt
23.11.2022 17:00;1052;489;563;Sonnig;5;4;0;Stadt Konstanz, Amt für Stadtplanung und Umwelt
23.11.2022 18:00;690;296;394;Sonnig;3;3;0;Stadt Konstanz, Amt für Stadtplanung und Umwelt
23.11.2022 19:00;495;231;264;Sonnig;3;2;0;Stadt Konstanz, Amt für Stadtplanung und Umwelt
23.11.2022 20:00;349;171;178;Leichter Regenfall;3;1;0.6;Stadt Konstanz, Amt für Stadtplanung und Umwelt
23.11.2022 21:00;229;108;121;Leichter Regenfall;2;-1;0.8;Stadt Konstanz, Amt für Stadtplanung und Umwelt
23.11.2022 22:00;209;82;127;Leichter Regenfall;4;1;0.4;Stadt Konstanz, Amt für Stadtplanung und Umwelt
23.11.2022 23:00;111;45;66;Stellenweiser Nieselregen;5;2;0.2;Stadt Konstanz, Amt für Stadtplanung und Umwelt
24.11.2022 00:00;64;31;33;Stellenweiser Nieselregen;6;3;0.2;Stadt Konstanz, Amt für Stadtplanung und Umwelt
24.11.2022 01:00;38;4;34;Stellenweiser Nieselregen;5;2;0.1;Stadt Konstanz, Amt für Stadtplanung und Umwelt
24.11.2022 02:00;11;7;4;Leicht bewoelkt;5;2;0;Stadt Konstanz, Amt für Stadtplanung und Umwelt
24.11.2022 03:00;6;3;3;Leicht bewoelkt;4;1;0;Stadt Konstanz, Amt für Stadtplanung und Umwelt
24.11.2022 04:00;18;7;11;Leicht bewoelkt;4;1;0;Stadt Konstanz, Amt für Stadtplanung und Umwelt
24.11.2022 05:00;36;26;10;Sonnig;3;1;0;Stadt Konstanz, Amt für Stadtplanung und Umwelt
24.11.2022 06:00;176;108;68;Sonnig;3;1;0;Stadt Konstanz, Amt für Stadtplanung und Umwelt
24.11.2022 07:00;1015;640;375;Sonnig;4;2;0;Stadt Konstanz, Amt für Stadtplanung und Umwelt
24.11.2022 08:00;709;364;345;Bewoelkt;4;2;0;Stadt Konstanz, Amt für Stadtplanung und Umwelt
24.11.2022 09:00;706;398;308;Bewoelkt;4;3;0;Stadt Konstanz, Amt für Stadtplanung und Umwelt
24.11.2022 10:00;327;183;144;Bewoelkt;5;4;0;Stadt Konstanz, Amt für Stadtplanung und Umwelt
24.11.2022 11:00;444;231;213;Leicht bewoelkt;7;5;0;Stadt Konstanz, Amt für Stadtplanung und Umwelt
24.11.2022 12:00;534;224;310;Leicht bewoelkt;8;7;0;Stadt Konstanz, Amt für Stadtplanung und Umwelt
24.11.2022 13:00;872;373;499;Leicht bewoelkt;8;7;0;Stadt Konstanz, Amt für Stadtplanung und Umwelt
24.11.2022 14:00;585;306;279;Sonnig;9;8;0;Stadt Konstanz, Amt für Stadtplanung und Umwelt
24.11.2022 15:00;928;439;489;Sonnig;9;9;0;Stadt Konstanz, Amt für Stadtplanung und Umwelt
24.11.2022 16:00;841;422;419;Sonnig;8;8;0;Stadt Konstanz, Amt für Stadtplanung und Umwelt
24.11.2022 17:00;942;440;502;Sonnig;7;7;0;Stadt Konstanz, Amt für Stadtplanung und Umwelt
24.11.2022 18:00;722;359;363;Sonnig;6;6;0;Stadt Konstanz, Amt für Stadtplanung und Umwelt
24.11.2022 19:00;601;306;295;Sonnig;5;4;0;Stadt Konstanz, Amt für Stadtplanung und Umwelt
24.11.2022 20:00;392;177;215;Sonnig;4;3;0;Stadt Konstanz, Amt für Stadtplanung und Umwelt
24.11.2022 21:00;306;116;190;Sonnig;3;2;0;Stadt Konstanz, Amt für Stadtplanung und Umwelt
24.11.2022 22:00;304;82;222;Sonnig;3;2;0;Stadt Konstanz, Amt für Stadtplanung und Umwelt
24.11.2022 23:00;150;62;88;Bedeckt;2;2;0;Stadt Konstanz, Amt für Stadtplanung und Umwelt
25.11.2022 00:00;105;27;78;Bedeckt;2;1;0;Stadt Konstanz, Amt für Stadtplanung und Umwelt
25.11.2022 01:00;35;15;20;Bedeckt;2;1;0;Stadt Konstanz, Amt für Stadtplanung und Umwelt
25.11.2022 02:00;14;7;7;Bedeckt;2;1;0;Stadt Konstanz, Amt für Stadtplanung und Umwelt
25.11.2022 03:00;7;3;4;Bedeckt;3;1;0;Stadt Konstanz, Amt für Stadtplanung und Umwelt
25.11.2022 04:00;16;9;7;Bedeckt;3;1;0;Stadt Konstanz, Amt für Stadtplanung und Umwelt
25.11.2022 05:00;46;34;12;Stellenweiser Regenfall;3;1;0;Stadt Konstanz, Amt für Stadtplanung und Umwelt
25.11.2022 06:00;143;79;64;Stellenweiser Regenfall;3;2;0;Stadt Konstanz, Amt für Stadtplanung und Umwelt
25.11.2022 07:00;918;552;366;Stellenweiser Regenfall;4;2;0;Stadt Konstanz, Amt für Stadtplanung und Umwelt
25.11.2022 08:00;497;270;227;Nieselregen;5;3;0.1;Stadt Konstanz, Amt für Stadtplanung und Umwelt
25.11.2022 09:00;666;368;298;Nieselregen;6;3;0.1;Stadt Konstanz, Amt für Stadtplanung und Umwelt
25.11.2022 10:00;492;262;230;Nieselregen;6;4;0;Stadt Konstanz, Amt für Stadtplanung und Umwelt
25.11.2022 11:00;565;298;267;Leichter Regenschauer;7;5;0.1;Stadt Konstanz, Amt für Stadtplanung und Umwelt
25.11.2022 12:00;715;344;371;Leichter Regenschauer;8;6;0.1;Stadt Konstanz, Amt für Stadtplanung und Umwelt
25.11.2022 13:00;955;380;575;Leichter Regenschauer;9;7;0;Stadt Konstanz, Amt für Stadtplanung und Umwelt
25.11.2022 14:00;646;338;308;Stellenweiser Regenfall;9;7;0;Stadt Konstanz, Amt für Stadtplanung und Umwelt
25.11.2022 15:00;696;327;369;Stellenweiser Regenfall;9;7;0;Stadt Konstanz, Amt für Stadtplanung und Umwelt
25.11.2022 16:00;655;320;335;Stellenweiser Regenfall;8;6;0;Stadt Konstanz, Amt für Stadtplanung und Umwelt
25.11.2022 17:00;739;322;417;Stellenweiser Regenfall;7;5;0;Stadt Konstanz, Amt für Stadtplanung und Umwelt
25.11.2022 18:00;569;283;286;Stellenweiser Regenfall;5;4;0;Stadt Konstanz, Amt für Stadtplanung und Umwelt
25.11.2022 19:00;505;267;238;Stellenweiser Regenfall;5;5;0;Stadt Konstanz, Amt für Stadtplanung und Umwelt
25.11.2022 20:00;317;147;170;Bedeckt;5;5;0;Stadt Konstanz, Amt für Stadtplanung und Umwelt
25.11.2022 21:00;261;98;163;Bedeckt;5;5;0;Stadt Konstanz, Amt für Stadtplanung und Umwelt
25.11.2022 22:00;271;83;188;Bedeckt;5;5;0;Stadt Konstanz, Amt für Stadtplanung und Umwelt
25.11.2022 23:00;188;60;128;Leichter Regenschauer;5;5;0.1;Stadt Konstanz, Amt für Stadtplanung und Umwelt
26.11.2022 00:00;156;56;100;Leichter Regenschauer;5;5;0.1;Stadt Konstanz, Amt für Stadtplanung und Umwelt
26.11.2022 01:00;90;23;67;Leichter Regenschauer;5;5;0.1;Stadt Konstanz, Amt für Stadtplanung und Umwelt
26.11.2022 02:00;78;39;39;Leichter Nebel;5;5;0;Stadt Konstanz, Amt für Stadtplanung und Umwelt
26.11.2022 03:00;54;23;31;Leichter Nebel;5;5;0;Stadt Konstanz, Amt für Stadtplanung und Umwelt
26.11.2022 04:00;34;13;21;Leichter Nebel;5;5;0;Stadt Konstanz, Amt für Stadtplanung und Umwelt
26.11.2022 05:00;27;15;12;Stellenweiser Regenfall;5;5;0;Stadt Konstanz, Amt für Stadtplanung und Umwelt
26.11.2022 06:00;35;23;12;Stellenweiser Regenfall;4;4;0;Stadt Konstanz, Amt für Stadtplanung und Umwelt
26.11.2022 07:00;61;41;20;Stellenweiser Regenfall;5;5;0;Stadt Konstanz, Amt für Stadtplanung und Umwelt
26.11.2022 08:00;194;117;77;Leicht bewoelkt;5;5;0;Stadt Konstanz, Amt für Stadtplanung und Umwelt
26.11.2022 09:00;298;179;119;Leicht bewoelkt;5;5;0;Stadt Konstanz, Amt für Stadtplanung und Umwelt
26.11.2022 10:00;401;237;164;Leicht bewoelkt;6;6;0;Stadt Konstanz, Amt für Stadtplanung und Umwelt
26.11.2022 11:00;452;242;210;Leicht bewoelkt;7;7;0;Stadt Konstanz, Amt für Stadtplanung und Umwelt
26.11.2022 12:00;505;254;251;Leicht bewoelkt;8;8;0;Stadt Konstanz, Amt für Stadtplanung und Umwelt
26.11.2022 13:00;547;289;258;Leicht bewoelkt;8;8;0;Stadt Konstanz, Amt für Stadtplanung und Umwelt
26.11.2022 14:00;554;282;272;Leicht bewoelkt;8;8;0;Stadt Konstanz, Amt für Stadtplanung und Umwelt
26.11.2022 15:00;582;295;287;Leicht bewoelkt;8;8;0;Stadt Konstanz, Amt für Stadtplanung und Umwelt
26.11.2022 16:00;517;247;270;Leicht bewoelkt;7;6;0;Stadt Konstanz, Amt für Stadtplanung und Umwelt
26.11.2022 17:00;484;208;276;Sonnig;5;4;0;Stadt Konstanz, Amt für Stadtplanung und Umwelt
26.11.2022 18:00;477;227;250;Sonnig;3;2;0;Stadt Konstanz, Amt für Stadtplanung und Umwelt
26.11.2022 19:00;343;162;181;Sonnig;3;1;0;Stadt Konstanz, Amt für Stadtplanung und Umwelt
26.11.2022 20:00;292;143;149;Sonnig;2;1;0;Stadt Konstanz, Amt für Stadtplanung und Umwelt
26.11.2022 21:00;245;85;160;Sonnig;2;0;0;Stadt Konstanz, Amt für Stadtplanung und Umwelt
26.11.2022 22:00;226;84;142;Sonnig;1;0;0;Stadt Konstanz, Amt für Stadtplanung und Umwelt
26.11.2022 23:00;167;47;120;Leicht bewoelkt;1;-1;0;Stadt Konstanz, Amt für Stadtplanung und Umwelt
27.11.2022 00:00;131;29;102;Leicht bewoelkt;0;-2;0;Stadt Konstanz, Amt für Stadtplanung und Umwelt
27.11.2022 01:00;102;23;79;Leicht bewoelkt;0;-2;0;Stadt Konstanz, Amt für Stadtplanung und Umwelt
27.11.2022 02:00;71;28;43;Sonnig;0;-2;0;Stadt Konstanz, Amt für Stadtplanung und Umwelt
27.11.2022 03:00;51;30;21;Sonnig;-1;-2;0;Stadt Konstanz, Amt für Stadtplanung und Umwelt
27.11.2022 04:00;32;16;16;Sonnig;-1;-2;0;Stadt Konstanz, Amt für Stadtplanung und Umwelt
27.11.2022 05:00;16;6;10;Sonnig;-1;-2;0;Stadt Konstanz, Amt für Stadtplanung und Umwelt
27.11.2022 06:00;28;20;8;Sonnig;-1;-2;0;Stadt Konstanz, Amt für Stadtplanung und Umwelt
27.11.2022 07:00;40;20;20;Sonnig;0;-1;0;Stadt Konstanz, Amt für Stadtplanung und Umwelt
27.11.2022 08:00;49;24;25;Sonnig;0;0;0;Stadt Konstanz, Amt für Stadtplanung und Umwelt
27.11.2022 09:00;119;76;43;Sonnig;1;1;0;Stadt Konstanz, Amt für Stadtplanung und Umwelt
27.11.2022 10:00;128;77;51;Sonnig;3;3;0;Stadt Konstanz, Amt für Stadtplanung und Umwelt
27.11.2022 11:00;212;87;125;Leicht bewoelkt;5;5;0;Stadt Konstanz, Amt für Stadtplanung und Umwelt
27.11.2022 12:00;234;124;110;Leicht bewoelkt;7;7;0;Stadt Konstanz, Amt für Stadtplanung und Umwelt
27.11.2022 13:00;298;167;131;Leicht bewoelkt;7;7;0;Stadt Konstanz, Amt für Stadtplanung und Umwelt
27.11.2022 14:00;315;155;160;Leicht bewoelkt;7;7;0;Stadt Konstanz, Amt für Stadtplanung und Umwelt
27.11.2022 15:00;335;149;186;Leicht bewoelkt;7;8;0;Stadt Konstanz, Amt für Stadtplanung und Umwelt
27.11.2022 16:00;401;167;234;Leicht bewoelkt;6;6;0;Stadt Konstanz, Amt für Stadtplanung und Umwelt
27.11.2022 17:00;354;145;209;Leicht bewoelkt;4;4;0;Stadt Konstanz, Amt für Stadtplanung und Umwelt
27.11.2022 18:00;247;120;127;Leicht bewoelkt;3;3;0;Stadt Konstanz, Amt für Stadtplanung und Umwelt
27.11.2022 19:00;258;112;146;Leicht bewoelkt;2;2;0;Stadt Konstanz, Amt für Stadtplanung und Umwelt
27.11.2022 20:00;155;67;88;Leicht bewoelkt;2;2;0;Stadt Konstanz, Amt für Stadtplanung und Umwelt
27.11.2022 21:00;121;50;71;Leicht bewoelkt;2;2;0;Stadt Konstanz, Amt für Stadtplanung und Umwelt
27.11.2022 22:00;165;76;89;Leicht bewoelkt;2;2;0;Stadt Konstanz, Amt für Stadtplanung und Umwelt
27.11.2022 23:00;51;26;25;Bewoelkt;2;2;0;Stadt Konstanz, Amt für Stadtplanung und Umwelt
28.11.2022 00:00;18;9;9;Bewoelkt;2;2;0;Stadt Konstanz, Amt für Stadtplanung und Umwelt
28.11.2022 01:00;16;6;10;Bewoelkt;3;2;0;Stadt Konstanz, Amt für Stadtplanung und Umwelt
28.11.2022 02:00;7;4;3;Leicht bewoelkt;3;2;0;Stadt Konstanz, Amt für Stadtplanung und Umwelt
28.11.2022 03:00;3;0;3;Leicht bewoelkt;3;2;0;Stadt Konstanz, Amt für Stadtplanung und Umwelt
28.11.2022 04:00;7;3;4;Leicht bewoelkt;3;2;0;Stadt Konstanz, Amt für Stadtplanung und Umwelt
28.11.2022 05:00;46;30;16;Bewoelkt;3;3;0;Stadt Konstanz, Amt für Stadtplanung und Umwelt
28.11.2022 06:00;176;102;74;Bewoelkt;3;3;0;Stadt Konstanz, Amt für Stadtplanung und Umwelt
28.11.2022 07:00;910;545;365;Bewoelkt;3;3;0;Stadt Konstanz, Amt für Stadtplanung und Umwelt
28.11.2022 08:00;652;341;311;Leicht bewoelkt;4;3;0;Stadt Konstanz, Amt für Stadtplanung und Umwelt
28.11.2022 09:00;693;415;278;Leicht bewoelkt;4;3;0;Stadt Konstanz, Amt für Stadtplanung und Umwelt
28.11.2022 10:00;416;231;185;Leicht bewoelkt;5;4;0;Stadt Konstanz, Amt für Stadtplanung und Umwelt
28.11.2022 11:00;525;270;255;Bedeckt;6;6;0;Stadt Konstanz, Amt für Stadtplanung und Umwelt
28.11.2022 12:00;541;248;293;Bedeckt;8;7;0;Stadt Konstanz, Amt für Stadtplanung und Umwelt
28.11.2022 13:00;786;379;407;Bedeckt;7;7;0;Stadt Konstanz, Amt für Stadtplanung und Umwelt
28.11.2022 14:00;583;306;277;Bedeckt;7;6;0;Stadt Konstanz, Amt für Stadtplanung und Umwelt
28.11.2022 15:00;927;430;497;Bedeckt;7;6;0;Stadt Konstanz, Amt für Stadtplanung und Umwelt
28.11.2022 16:00;807;380;427;Bedeckt;6;5;0;Stadt Konstanz, Amt für Stadtplanung und Umwelt
28.11.2022 17:00;922;432;490;Nieselregen;5;4;0.1;Stadt Konstanz, Amt für Stadtplanung und Umwelt
28.11.2022 18:00;709;330;379;Nieselregen;5;3;0.1;Stadt Konstanz, Amt für Stadtplanung und Umwelt
28.11.2022 19:00;570;256;314;Nieselregen;5;3;0;Stadt Konstanz, Amt für Stadtplanung und Umwelt
28.11.2022 20:00;383;185;198;Leichter Nebel;5;3;0;Stadt Konstanz, Amt für Stadtplanung und Umwelt
28.11.2022 21:00;251;92;159;Leichter Nebel;5;3;0;Stadt Konstanz, Amt für Stadtplanung und Umwelt
28.11.2022 22:00;237;92;145;Leichter Nebel;5;3;0;Stadt Konstanz, Amt für Stadtplanung und Umwelt
28.11.2022 23:00;96;47;49;Nieselregen;5;3;0.2;Stadt Konstanz, Amt für Stadtplanung und Umwelt
29.11.2022 00:00;48;18;30;Nieselregen;5;3;0.3;Stadt Konstanz, Amt für Stadtplanung und Umwelt
29.11.2022 01:00;29;8;21;Nieselregen;5;3;0.2;Stadt Konstanz, Amt für Stadtplanung und Umwelt
29.11.2022 02:00;5;3;2;Nebel;5;3;0;Stadt Konstanz, Amt für Stadtplanung und Umwelt
29.11.2022 03:00;0;0;0;Nebel;5;3;0;Stadt Konstanz, Amt für Stadtplanung und Umwelt
29.11.2022 04:00;10;3;7;Nebel;5;3;0;Stadt Konstanz, Amt für Stadtplanung und Umwelt
29.11.2022 05:00;55;37;18;Nieselregen;5;3;0.2;Stadt Konstanz, Amt für Stadtplanung und Umwelt
29.11.2022 06:00;176;101;75;Nieselregen;5;4;0.3;Stadt Konstanz, Amt für Stadtplanung und Umwelt
29.11.2022 07:00;1017;636;381;Nieselregen;5;4;0.2;Stadt Konstanz, Amt für Stadtplanung und Umwelt
29.11.2022 08:00;746;392;354;Leichter Nebel;5;4;0;Stadt Konstanz, Amt für Stadtplanung und Umwelt
29.11.2022 09:00;737;411;326;Leichter Nebel;5;4;0;Stadt Konstanz, Amt für Stadtplanung und Umwelt
29.11.2022 10:00;432;236;196;Leichter Nebel;5;4;0;Stadt Konstanz, Amt für Stadtplanung und Umwelt
29.11.2022 11:00;580;314;266;Nieselregen;5;5;0.1;Stadt Konstanz, Amt für Stadtplanung und Umwelt
29.11.2022 12:00;573;220;353;Nieselregen;5;5;0.1;Stadt Konstanz, Amt für Stadtplanung und Umwelt
29.11.2022 13:00;836;378;458;Nieselregen;5;5;0.1;Stadt Konstanz, Amt für Stadtplanung und Umwelt
29.11.2022 14:00;586;286;300;Leichter Nebel;5;5;0;Stadt Konstanz, Amt für Stadtplanung und Umwelt
29.11.2022 15:00;796;339;457;Leichter Nebel;5;5;0;Stadt Konstanz, Amt für Stadtplanung und Umwelt
29.11.2022 16:00;697;332;365;Leichter Nebel;5;5;0;Stadt Konstanz, Amt für Stadtplanung und Umwelt
29.11.2022 17:00;823;361;462;Stellenweiser Regenfall;5;5;0;Stadt Konstanz, Amt für Stadtplanung und Umwelt
29.11.2022 18:00;610;275;335;Stellenweiser Regenfall;6;6;0;Stadt Konstanz, Amt für Stadtplanung und Umwelt
29.11.2022 19:00;459;203;256;Stellenweiser Regenfall;5;5;0;Stadt Konstanz, Amt für Stadtplanung und Umwelt
29.11.2022 20:00;298;135;163;Bedeckt;5;5;0;Stadt Konstanz, Amt für Stadtplanung und Umwelt
29.11.2022 21:00;229;103;126;Bedeckt;5;5;0;Stadt Konstanz, Amt für Stadtplanung und Umwelt
29.11.2022 22:00;172;64;108;Bedeckt;5;5;0;Stadt Konstanz, Amt für Stadtplanung und Umwelt
29.11.2022 23:00;68;30;38;Leichter Regenschauer;5;5;0.1;Stadt Konstanz, Amt für Stadtplanung und Umwelt
30.11.2022 00:00;35;12;23;Leichter Regenschauer;5;4;0.1;Stadt Konstanz, Amt für Stadtplanung und Umwelt
30.11.2022 01:00;27;14;13;Leichter Regenschauer;5;4;0.1;Stadt Konstanz, Amt für Stadtplanung und Umwelt
30.11.2022 02:00;4;3;1;Nieselregen;5;5;0.1;Stadt Konstanz, Amt für Stadtplanung und Umwelt
30.11.2022 03:00;5;2;3;Nieselregen;5;5;0.1;Stadt Konstanz, Amt für Stadtplanung und Umwelt
30.11.2022 04:00;13;10;3;Nieselregen;5;4;0;Stadt Konstanz, Amt für Stadtplanung und Umwelt
30.11.2022 05:00;41;26;15;Stellenweiser Regenfall;5;4;0;Stadt Konstanz, Amt für Stadtplanung und Umwelt
30.11.2022 06:00;166;95;71;Stellenweiser Regenfall;5;4;0;Stadt Konstanz, Amt für Stadtplanung und Umwelt
30.11.2022 07:00;969;596;373;Stellenweiser Regenfall;5;4;0;Stadt Konstanz, Amt für Stadtplanung und Umwelt
30.11.2022 08:00;776;437;339;Bedeckt;5;4;0;Stadt Konstanz, Amt für Stadtplanung und Umwelt
30.11.2022 09:00;710;400;310;Bedeckt;5;4;0;Stadt Konstanz, Amt für Stadtplanung und Umwelt
30.11.2022 10:00;391;184;207;Bedeckt;5;4;0;Stadt Konstanz, Amt für Stadtplanung und Umwelt
30.11.2022 11:00;550;251;299;Bedeckt;5;4;0;Stadt Konstanz, Amt für Stadtplanung und Umwelt
30.11.2022 12:00;633;298;335;Bedeckt;6;4;0;Stadt Konstanz, Amt für Stadtplanung und Umwelt
30.11.2022 13:00;947;469;478;Bedeckt;6;4;0;Stadt Konstanz, Amt für Stadtplanung und Umwelt
30.11.2022 14:00;659;333;326;Bedeckt;6;4;0;Stadt Konstanz, Amt für Stadtplanung und Umwelt
30.11.2022 15:00;828;363;465;Bedeckt;6;4;0;Stadt Konstanz, Amt für Stadtplanung und Umwelt
30.11.2022 16:00;814;379;435;Bedeckt;6;3;0;Stadt Konstanz, Amt für Stadtplanung und Umwelt
30.11.2022 17:00;922;427;495;Bedeckt;5;3;0;Stadt Konstanz, Amt für Stadtplanung und Umwelt
30.11.2022 18:00;799;375;424;Bedeckt;5;2;0;Stadt Konstanz, Amt für Stadtplanung und Umwelt
30.11.2022 19:00;537;225;312;Bedeckt;4;2;0;Stadt Konstanz, Amt für Stadtplanung und Umwelt
30.11.2022 20:00;376;157;219;Bedeckt;4;2;0;Stadt Konstanz, Amt für Stadtplanung und Umwelt
30.11.2022 21:00;305;120;185;Bedeckt;4;2;0;Stadt Konstanz, Amt für Stadtplanung und Umwelt
30.11.2022 22:00;235;93;142;Bedeckt;4;2;0;Stadt Konstanz, Amt für Stadtplanung und Umwelt
30.11.2022 23:00;120;45;75;Bewoelkt;4;2;0;Stadt Konstanz, Amt für Stadtplanung und Umwelt
01.12.2022 00:00;67;23;44;Bewoelkt;3;2;0;Stadt Konstanz, Amt für Stadtplanung und Umwelt
01.12.2022 01:00;50;17;33;Bewoelkt;3;1;0;Stadt Konstanz, Amt für Stadtplanung und Umwelt
01.12.2022 02:00;12;7;5;Bewoelkt;2;0;0;Stadt Konstanz, Amt für Stadtplanung und Umwelt
01.12.2022 03:00;4;3;1;Bewoelkt;1;-1;0;Stadt Konstanz, Amt für Stadtplanung und Umwelt
01.12.2022 04:00;15;10;5;Bewoelkt;1;-1;0;Stadt Konstanz, Amt für Stadtplanung und Umwelt
01.12.2022 05:00;39;24;15;Bedeckt;1;-1;0;Stadt Konstanz, Amt für Stadtplanung und Umwelt
01.12.2022 06:00;160;101;59;Bedeckt;1;-1;0;Stadt Konstanz, Amt für Stadtplanung und Umwelt
01.12.2022 07:00;960;594;366;Bedeckt;1;0;0;Stadt Konstanz, Amt für Stadtplanung und Umwelt
01.12.2022 08:00;747;414;333;Leicht bewoelkt;2;0;0;Stadt Konstanz, Amt für Stadtplanung und Umwelt
01.12.2022 09:00;678;379;299;Leicht bewoelkt;2;1;0;Stadt Konstanz, Amt für Stadtplanung und Umwelt
01.12.2022 10:00;393;226;167;Leicht bewoelkt;3;2;0;Stadt Konstanz, Amt für Stadtplanung und Umwelt
01.12.2022 11:00;548;273;275;Leicht bewoelkt;4;2;0;Stadt Konstanz, Amt für Stadtplanung und Umwelt
01.12.2022 12:00;570;265;305;Leicht bewoelkt;5;3;0;Stadt Konstanz, Amt für Stadtplanung und Umwelt
01.12.2022 13:00;877;353;524;Leicht bewoelkt;5;3;0;Stadt Konstanz, Amt für Stadtplanung und Umwelt
01.12.2022 14:00;583;277;306;Bedeckt;5;3;0;Stadt Konstanz, Amt für Stadtplanung und Umwelt
01.12.2022 15:00;922;434;488;Bedeckt;5;3;0;Stadt Konstanz, Amt für Stadtplanung und Umwelt
01.12.2022 16:00;768;382;386;Bedeckt;4;3;0;Stadt Konstanz, Amt für Stadtplanung und Umwelt
01.12.2022 17:00;953;447;506;Bedeckt;4;2;0;Stadt Konstanz, Amt für Stadtplanung und Umwelt
01.12.2022 18:00;783;382;401;Bedeckt;3;1;0;Stadt Konstanz, Amt für Stadtplanung und Umwelt
01.12.2022 19:00;660;296;364;Bedeckt;3;1;0;Stadt Konstanz, Amt für Stadtplanung und Umwelt
01.12.2022 20:00;383;142;241;Bewoelkt;3;2;0;Stadt Konstanz, Amt für Stadtplanung und Umwelt
01.12.2022 21:00;215;77;138;Bewoelkt;3;2;0;Stadt Konstanz, Amt für Stadtplanung und Umwelt
01.12.2022 22:00;311;110;201;Bewoelkt;3;1;0;Stadt Konstanz, Amt für Stadtplanung und Umwelt
01.12.2022 23:00;148;61;87;Bedeckt;2;0;0;Stadt Konstanz, Amt für Stadtplanung und Umwelt
02.12.2022 00:00;81;27;54;Bedeckt;2;0;0;Stadt Konstanz, Amt für Stadtplanung und Umwelt
02.12.2022 01:00;44;27;17;Bedeckt;2;0;0;Stadt Konstanz, Amt für Stadtplanung und Umwelt
02.12.2022 02:00;15;8;7;Leicht bewoelkt;2;0;0;Stadt Konstanz, Amt für Stadtplanung und Umwelt
02.12.2022 03:00;5;2;3;Leicht bewoelkt;2;0;0;Stadt Konstanz, Amt für Stadtplanung und Umwelt
02.12.2022 04:00;10;6;4;Leicht bewoelkt;1;-1;0;Stadt Konstanz, Amt für Stadtplanung und Umwelt
02.12.2022 05:00;48;34;14;Leicht bewoelkt;1;-1;0;Stadt Konstanz, Amt für Stadtplanung und Umwelt
02.12.2022 06:00;145;74;71;Leicht bewoelkt;0;-2;0;Stadt Konstanz, Amt für Stadtplanung und Umwelt
02.12.2022 07:00;851;529;322;Leicht bewoelkt;0;-2;0;Stadt Konstanz, Amt für Stadtplanung und Umwelt
02.12.2022 08:00;640;374;266;Leicht bewoelkt;0;-2;0;Stadt Konstanz, Amt für Stadtplanung und Umwelt
02.12.2022 09:00;642;376;266;Leicht bewoelkt;1;-1;0;Stadt Konstanz, Amt für Stadtplanung und Umwelt
02.12.2022 10:00;431;236;195;Leicht bewoelkt;2;0;0;Stadt Konstanz, Amt für Stadtplanung und Umwelt
02.12.2022 11:00;614;297;317;Bewoelkt;3;1;0;Stadt Konstanz, Amt für Stadtplanung und Umwelt
02.12.2022 12:00;683;305;378;Bewoelkt;4;2;0;Stadt Konstanz, Amt für Stadtplanung und Umwelt
02.12.2022 13:00;937;389;548;Bewoelkt;4;2;0;Stadt Konstanz, Amt für Stadtplanung und Umwelt
02.12.2022 14:00;641;320;321;Bedeckt;4;2;0;Stadt Konstanz, Amt für Stadtplanung und Umwelt
02.12.2022 15:00;619;288;331;Bedeckt;4;3;0;Stadt Konstanz, Amt für Stadtplanung und Umwelt
02.12.2022 16:00;633;291;342;Bedeckt;4;2;0;Stadt Konstanz, Amt für Stadtplanung und Umwelt
02.12.2022 17:00;664;349;315;Bedeckt;3;2;0;Stadt Konstanz, Amt für Stadtplanung und Umwelt
02.12.2022 18:00;631;338;293;Bedeckt;3;2;0;Stadt Konstanz, Amt für Stadtplanung und Umwelt
02.12.2022 19:00;460;231;229;Bedeckt;3;2;0;Stadt Konstanz, Amt für Stadtplanung und Umwelt
02.12.2022 20:00;332;152;180;Bedeckt;3;2;0;Stadt Konstanz, Amt für Stadtplanung und Umwelt
02.12.2022 21:00;265;108;157;Bedeckt;3;2;0;Stadt Konstanz, Amt für Stadtplanung und Umwelt
02.12.2022 22:00;270;95;175;Bedeckt;2;1;0;Stadt Konstanz, Amt für Stadtplanung und Umwelt
02.12.2022 23:00;178;46;132;Bedeckt;2;1;0;Stadt Konstanz, Amt für Stadtplanung und Umwelt
03.12.2022 00:00;105;30;75;Bedeckt;2;0;0;Stadt Konstanz, Amt für Stadtplanung und Umwelt
03.12.2022 01:00;125;46;79;Bedeckt;1;0;0;Stadt Konstanz, Amt für Stadtplanung und Umwelt
03.12.2022 02:00;65;16;49;Bedeckt;1;0;0;Stadt Konstanz, Amt für Stadtplanung und Umwelt
03.12.2022 03:00;49;17;32;Bedeckt;1;0;0;Stadt Konstanz, Amt für Stadtplanung und Umwelt
03.12.2022 04:00;19;7;12;Bedeckt;1;-1;0;Stadt Konstanz, Amt für Stadtplanung und Umwelt
03.12.2022 05:00;24;15;9;Leicht bewoelkt;1;-1;0;Stadt Konstanz, Amt für Stadtplanung und Umwelt
03.12.2022 06:00;37;21;16;Leicht bewoelkt;0;-1;0;Stadt Konstanz, Amt für Stadtplanung und Umwelt
03.12.2022 07:00;83;49;34;Leicht bewoelkt;0;-1;0;Stadt Konstanz, Amt für Stadtplanung und Umwelt
03.12.2022 08:00;150;82;68;Leicht bewoelkt;1;-1;0;Stadt Konstanz, Amt für Stadtplanung und Umwelt
03.12.2022 09:00;271;154;117;Leicht bewoelkt;1;-1;0;Stadt Konstanz, Amt für Stadtplanung und Umwelt
03.12.2022 10:00;375;215;160;Leicht bewoelkt;2;1;0;Stadt Konstanz, Amt für Stadtplanung und Umwelt
03.12.2022 11:00;363;194;169;Sonnig;4;2;0;Stadt Konstanz, Amt für Stadtplanung und Umwelt
03.12.2022 12:00;451;239;212;Sonnig;6;4;0;Stadt Konstanz, Amt für Stadtplanung und Umwelt
03.12.2022 13:00;452;236;216;Sonnig;6;4;0;Stadt Konstanz, Amt für Stadtplanung und Umwelt
03.12.2022 14:00;398;178;220;Sonnig;6;4;0;Stadt Konstanz, Amt für Stadtplanung und Umwelt
03.12.2022 15:00;425;198;227;Sonnig;6;4;0;Stadt Konstanz, Amt für Stadtplanung und Umwelt
03.12.2022 16:00;485;246;239;Sonnig;5;3;0;Stadt Konstanz, Amt für Stadtplanung und Umwelt
03.12.2022 17:00;404;195;209;Leicht bewoelkt;4;1;0;Stadt Konstanz, Amt für Stadtplanung und Umwelt
03.12.2022 18:00;449;208;241;Leicht bewoelkt;2;-1;0;Stadt Konstanz, Amt für Stadtplanung und Umwelt
03.12.2022 19:00;352;173;179;Leicht bewoelkt;2;-1;0;Stadt Konstanz, Amt für Stadtplanung und Umwelt
03.12.2022 20:00;257;121;136;Leicht bewoelkt;1;-1;0;Stadt Konstanz, Amt für Stadtplanung und Umwelt
03.12.2022 21:00;254;101;153;Leicht bewoelkt;1;-2;0;Stadt Konstanz, Amt für Stadtplanung und Umwelt
03.12.2022 22:00;181;66;115;Leicht bewoelkt;0;-2;0;Stadt Konstanz, Amt für Stadtplanung und Umwelt
03.12.2022 23:00;135;40;95;Bedeckt;-1;-3;0;Stadt Konstanz, Amt für Stadtplanung und Umwelt
04.12.2022 00:00;134;41;93;Bedeckt;-1;-4;0;Stadt Konstanz, Amt für Stadtplanung und Umwelt
04.12.2022 01:00;92;26;66;Bedeckt;-1;-4;0;Stadt Konstanz, Amt für Stadtplanung und Umwelt
04.12.2022 02:00;85;40;45;Leicht bewoelkt;-2;-4;0;Stadt Konstanz, Amt für Stadtplanung und Umwelt
04.12.2022 03:00;54;21;33;Leicht bewoelkt;-2;-4;0;Stadt Konstanz, Amt für Stadtplanung und Umwelt
04.12.2022 04:00;23;11;12;Leicht bewoelkt;-2;-4;0;Stadt Konstanz, Amt für Stadtplanung und Umwelt
04.12.2022 05:00;21;6;15;Leichter Nebel;-2;-4;0;Stadt Konstanz, Amt für Stadtplanung und Umwelt
04.12.2022 06:00;24;13;11;Leichter Nebel;-2;-4;0;Stadt Konstanz, Amt für Stadtplanung und Umwelt
04.12.2022 07:00;23;11;12;Leichter Nebel;-2;-4;0;Stadt Konstanz, Amt für Stadtplanung und Umwelt
04.12.2022 08:00;62;20;42;Leicht bewoelkt;-1;-3;0;Stadt Konstanz, Amt für Stadtplanung und Umwelt
04.12.2022 09:00;126;66;60;Leicht bewoelkt;0;-2;0;Stadt Konstanz, Amt für Stadtplanung und Umwelt
04.12.2022 10:00;166;82;84;Leicht bewoelkt;1;0;0;Stadt Konstanz, Amt für Stadtplanung und Umwelt
04.12.2022 11:00;218;116;102;Sonnig;3;1;0;Stadt Konstanz, Amt für Stadtplanung und Umwelt
04.12.2022 12:00;213;111;102;Sonnig;4;3;0;Stadt Konstanz, Amt für Stadtplanung und Umwelt
04.12.2022 13:00;232;113;119;Sonnig;5;3;0;Stadt Konstanz, Amt für Stadtplanung und Umwelt
04.12.2022 14:00;256;120;136;Sonnig;5;4;0;Stadt Konstanz, Amt für Stadtplanung und Umwelt
04.12.2022 15:00;252;129;123;Sonnig;5;4;0;Stadt Konstanz, Amt für Stadtplanung und Umwelt
04.12.2022 16:00;308;166;142;Sonnig;4;3;0;Stadt Konstanz, Amt für Stadtplanung und Umwelt
04.12.2022 17:00;242;105;137;Bedeckt;3;2;0;Stadt Konstanz, Amt für Stadtplanung und Umwelt
04.12.2022 18:00;316;138;178;Bedeckt;2;1;0;Stadt Konstanz, Amt für Stadtplanung und Umwelt
04.12.2022 19:00;207;96;111;Bedeckt;2;1;0;Stadt Konstanz, Amt für Stadtplanung und Umwelt
04.12.2022 20:00;180;74;106;Bedeckt;2;2;0;Stadt Konstanz, Amt für Stadtplanung und Umwelt
04.12.2022 21:00;117;52;65;Bedeckt;2;2;0;Stadt Konstanz, Amt für Stadtplanung und Umwelt
04.12.2022 22:00;86;45;41;Bedeckt;2;1;0;Stadt Konstanz, Amt für Stadtplanung und Umwelt
04.12.2022 23:00;51;22;29;Sonnig;1;0;0;Stadt Konstanz, Amt für Stadtplanung und Umwelt
05.12.2022 00:00;19;10;9;Sonnig;1;-2;0;Stadt Konstanz, Amt für Stadtplanung und Umwelt
05.12.2022 01:00;12;6;6;Sonnig;0;-2;0;Stadt Konstanz, Amt für Stadtplanung und Umwelt
05.12.2022 02:00;3;1;2;Leicht bewoelkt;0;-2;0;Stadt Konstanz, Amt für Stadtplanung und Umwelt
05.12.2022 03:00;1;0;1;Leicht bewoelkt;0;-2;0;Stadt Konstanz, Amt für Stadtplanung und Umwelt
05.12.2022 04:00;12;6;6;Leicht bewoelkt;0;-2;0;Stadt Konstanz, Amt für Stadtplanung und Umwelt
05.12.2022 05:00;52;36;16;Leicht bewoelkt;0;-2;0;Stadt Konstanz, Amt für Stadtplanung und Umwelt
05.12.2022 06:00;155;91;64;Leicht bewoelkt;0;-3;0;Stadt Konstanz, Amt für Stadtplanung und Umwelt
05.12.2022 07:00;898;552;346;Leicht bewoelkt;1;-2;0;Stadt Konstanz, Amt für Stadtplanung und Umwelt
05.12.2022 08:00;616;331;285;Bedeckt;2;-1;0;Stadt Konstanz, Amt für Stadtplanung und Umwelt
05.12.2022 09:00;601;348;253;Bedeckt;3;0;0;Stadt Konstanz, Amt für Stadtplanung und Umwelt
05.12.2022 10:00;282;160;122;Bedeckt;3;1;0;Stadt Konstanz, Amt für Stadtplanung und Umwelt
05.12.2022 11:00;426;226;200;Nieselregen;4;1;0.1;Stadt Konstanz, Amt für Stadtplanung und Umwelt
05.12.2022 12:00;477;214;263;Nieselregen;4;2;0.1;Stadt Konstanz, Amt für Stadtplanung und Umwelt
05.12.2022 13:00;699;290;409;Nieselregen;4;3;0;Stadt Konstanz, Amt für Stadtplanung und Umwelt
05.12.2022 14:00;561;272;289;Stellenweiser Regenfall;5;4;0;Stadt Konstanz, Amt für Stadtplanung und Umwelt
05.12.2022 15:00;822;405;417;Stellenweiser Regenfall;5;5;0;Stadt Konstanz, Amt für Stadtplanung und Umwelt
05.12.2022 16:00;755;358;397;Stellenweiser Regenfall;4;4;0;Stadt Konstanz, Amt für Stadtplanung und Umwelt
05.12.2022 17:00;862;391;471;Bedeckt;3;2;0;Stadt Konstanz, Amt für Stadtplanung und Umwelt
05.12.2022 18:00;623;297;326;Bedeckt;3;1;0;Stadt Konstanz, Amt für Stadtplanung und Umwelt
05.12.2022 19:00;584;284;300;Bedeckt;2;1;0;Stadt Konstanz, Amt für Stadtplanung und Umwelt
05.12.2022 20:00;335;147;188;Leicht bewoelkt;2;1;0;Stadt Konstanz, Amt für Stadtplanung und Umwelt
05.12.2022 21:00;222;66;156;Leicht bewoelkt;1;1;0;Stadt Konstanz, Amt für Stadtplanung und Umwelt
05.12.2022 22:00;192;73;119;Leicht bewoelkt;1;1;0;Stadt Konstanz, Amt für Stadtplanung und Umwelt
05.12.2022 23:00;88;41;47;Leicht bewoelkt;1;1;0;Stadt Konstanz, Amt für Stadtplanung und Umwelt
06.12.2022 00:00;33;12;21;Leicht bewoelkt;0;0;0;Stadt Konstanz, Amt für Stadtplanung und Umwelt
06.12.2022 01:00;17;5;12;Leicht bewoelkt;0;0;0;Stadt Konstanz, Amt für Stadtplanung und Umwelt
06.12.2022 02:00;3;1;2;Sonnig;0;0;0;Stadt Konstanz, Amt für Stadtplanung und Umwelt
06.12.2022 03:00;4;2;2;Sonnig;0;0;0;Stadt Konstanz, Amt für Stadtplanung und Umwelt
06.12.2022 04:00;10;5;5;Sonnig;0;0;0;Stadt Konstanz, Amt für Stadtplanung und Umwelt
06.12.2022 05:00;37;30;7;Leicht bewoelkt;0;0;0;Stadt Konstanz, Amt für Stadtplanung und Umwelt
06.12.2022 06:00;176;103;73;Leicht bewoelkt;0;0;0;Stadt Konstanz, Amt für Stadtplanung und Umwelt
06.12.2022 07:00;934;592;342;Leicht bewoelkt;0;0;0;Stadt Konstanz, Amt für Stadtplanung und Umwelt
06.12.2022 08:00;730;394;336;Sonnig;0;0;0;Stadt Konstanz, Amt für Stadtplanung und Umwelt
06.12.2022 09:00;701;416;285;Sonnig;0;0;0;Stadt Konstanz, Amt für Stadtplanung und Umwelt
06.12.2022 10:00;396;215;181;Sonnig;2;2;0;Stadt Konstanz, Amt für Stadtplanung und Umwelt
06.12.2022 11:00;581;287;294;Sonnig;3;3;0;Stadt Konstanz, Amt für Stadtplanung und Umwelt
06.12.2022 12:00;564;234;330;Sonnig;5;5;0;Stadt Konstanz, Amt für Stadtplanung und Umwelt
06.12.2022 13:00;863;351;512;Sonnig;5;5;0;Stadt Konstanz, Amt für Stadtplanung und Umwelt
06.12.2022 14:00;593;289;304;Leicht bewoelkt;5;5;0;Stadt Konstanz, Amt für Stadtplanung und Umwelt
06.12.2022 15:00;876;440;436;Leicht bewoelkt;5;4;0;Stadt Konstanz, Amt für Stadtplanung und Umwelt
06.12.2022 16:00;833;391;442;Leicht bewoelkt;4;3;0;Stadt Konstanz, Amt für Stadtplanung und Umwelt
06.12.2022 17:00;903;412;491;Leicht bewoelkt;3;1;0;Stadt Konstanz, Amt für Stadtplanung und Umwelt
06.12.2022 18:00;756;327;429;Leicht bewoelkt;2;-1;0;Stadt Konstanz, Amt für Stadtplanung und Umwelt
06.12.2022 19:00;565;256;309;Leicht bewoelkt;1;-1;0;Stadt Konstanz, Amt für Stadtplanung und Umwelt
06.12.2022 20:00;413;203;210;Leicht bewoelkt;1;-1;0;Stadt Konstanz, Amt für Stadtplanung und Umwelt
06.12.2022 21:00;277;112;165;Leicht bewoelkt;1;-1;0;Stadt Konstanz, Amt für Stadtplanung und Umwelt
06.12.2022 22:00;204;74;130;Leicht bewoelkt;0;-1;0;Stadt Konstanz, Amt für Stadtplanung und Umwelt
06.12.2022 23:00;96;36;60;Leicht bewoelkt;0;-1;0;Stadt Konstanz, Amt für Stadtplanung und Umwelt
07.12.2022 00:00;47;15;32;Leicht bewoelkt;0;0;0;Stadt Konstanz, Amt für Stadtplanung und Umwelt
07.12.2022 01:00;41;22;19;Leicht bewoelkt;0;0;0;Stadt Konstanz, Amt für Stadtplanung und Umwelt
07.12.2022 02:00;23;12;11;Bedeckt;0;0;0;Stadt Konstanz, Amt für Stadtplanung und Umwelt
07.12.2022 03:00;8;3;5;Bedeckt;0;0;0;Stadt Konstanz, Amt für Stadtplanung und Umwelt
07.12.2022 04:00;11;9;2;Bedeckt;0;0;0;Stadt Konstanz, Amt für Stadtplanung und Umwelt
07.12.2022 05:00;44;33;11;Leichter Schneefall;1;1;0;Stadt Konstanz, Amt für Stadtplanung und Umwelt
07.12.2022 06:00;168;112;56;Leichter Schneefall;1;1;0;Stadt Konstanz, Amt für Stadtplanung und Umwelt
07.12.2022 07:00;881;536;345;Leichter Schneefall;1;1;0;Stadt Konstanz, Amt für Stadtplanung und Umwelt
07.12.2022 08:00;716;411;305;Maessiger Schneefall;1;1;0.1;Stadt Konstanz, Amt für Stadtplanung und Umwelt
07.12.2022 09:00;654;345;309;Maessiger Schneefall;1;1;0.1;Stadt Konstanz, Amt für Stadtplanung und Umwelt
07.12.2022 10:00;375;193;182;Maessiger Schneefall;1;1;0;Stadt Konstanz, Amt für Stadtplanung und Umwelt
07.12.2022 11:00;518;260;258;Maessige bis starke Schneefaelle;2;2;0.1;Stadt Konstanz, Amt für Stadtplanung und Umwelt
07.12.2022 12:00;600;271;329;Maessige bis starke Schneefaelle;2;2;0.1;Stadt Konstanz, Amt für Stadtplanung und Umwelt
07.12.2022 13:00;821;385;436;Maessige bis starke Schneefaelle;2;2;0;Stadt Konstanz, Amt für Stadtplanung und Umwelt
07.12.2022 14:00;536;274;262;Leichter Schneefall;3;2;0;Stadt Konstanz, Amt für Stadtplanung und Umwelt
07.12.2022 15:00;836;393;443;Leichter Schneefall;3;2;0;Stadt Konstanz, Amt für Stadtplanung und Umwelt
07.12.2022 16:00;756;358;398;Leichter Schneefall;2;2;0;Stadt Konstanz, Amt für Stadtplanung und Umwelt
07.12.2022 17:00;886;397;489;Leichte Schneeschauer;2;1;0;Stadt Konstanz, Amt für Stadtplanung und Umwelt
07.12.2022 18:00;741;334;407;Leichte Schneeschauer;2;0;0;Stadt Konstanz, Amt für Stadtplanung und Umwelt
07.12.2022 19:00;578;276;302;Leichte Schneeschauer;2;0;0;Stadt Konstanz, Amt für Stadtplanung und Umwelt
07.12.2022 20:00;398;160;238;Bedeckt;1;0;0;Stadt Konstanz, Amt für Stadtplanung und Umwelt
07.12.2022 21:00;304;108;196;Bedeckt;1;-1;0;Stadt Konstanz, Amt für Stadtplanung und Umwelt
07.12.2022 22:00;231;81;150;Bedeckt;1;-1;0;Stadt Konstanz, Amt für Stadtplanung und Umwelt
07.12.2022 23:00;130;48;82;Leicht bewoelkt;0;-1;0;Stadt Konstanz, Amt für Stadtplanung und Umwelt
08.12.2022 00:00;57;20;37;Leicht bewoelkt;0;-1;0;Stadt Konstanz, Amt für Stadtplanung und Umwelt
08.12.2022 01:00;34;11;23;Leicht bewoelkt;0;-1;0;Stadt Konstanz, Amt für Stadtplanung und Umwelt
08.12.2022 02:00;12;6;6;Leicht bewoelkt;0;-1;0;Stadt Konstanz, Amt für Stadtplanung und Umwelt
08.12.2022 03:00;6;1;5;Leicht bewoelkt;-1;-1;0;Stadt Konstanz, Amt für Stadtplanung und Umwelt
08.12.2022 04:00;12;10;2;Leicht bewoelkt;-1;-1;0;Stadt Konstanz, Amt für Stadtplanung und Umwelt
08.12.2022 05:00;35;26;9;Leicht bewoelkt;-1;-1;0;Stadt Konstanz, Amt für Stadtplanung und Umwelt
08.12.2022 06:00;161;90;71;Leicht bewoelkt;-2;-2;0;Stadt Konstanz, Amt für Stadtplanung und Umwelt
08.12.2022 07:00;907;556;351;Leicht bewoelkt;-2;-2;0;Stadt Konstanz, Amt für Stadtplanung und Umwelt
08.12.2022 08:00;651;340;311;Leicht bewoelkt;-1;-1;0;Stadt Konstanz, Amt für Stadtplanung und Umwelt
08.12.2022 09:00;677;396;281;Leicht bewoelkt;-1;-1;0;Stadt Konstanz, Amt für Stadtplanung und Umwelt
08.12.2022 10:00;366;210;156;Leicht bewoelkt;0;0;0;Stadt Konstanz, Amt für Stadtplanung und Umwelt
08.12.2022 11:00;526;266;260;Sonnig;2;2;0;Stadt Konstanz, Amt für Stadtplanung und Umwelt
08.12.2022 12:00;529;241;288;Sonnig;3;3;0;Stadt Konstanz, Amt für Stadtplanung und Umwelt
08.12.2022 13:00;842;343;499;Sonnig;3;3;0;Stadt Konstanz, Amt für Stadtplanung und Umwelt
08.12.2022 14:00;584;285;299;Sonnig;3;3;0;Stadt Konstanz, Amt für Stadtplanung und Umwelt
08.12.2022 15:00;829;422;407;Sonnig;4;4;0;Stadt Konstanz, Amt für Stadtplanung und Umwelt
08.12.2022 16:00;762;376;386;Sonnig;2;2;0;Stadt Konstanz, Amt für Stadtplanung und Umwelt
08.12.2022 17:00;895;387;508;Sonnig;1;1;0;Stadt Konstanz, Amt für Stadtplanung und Umwelt
08.12.2022 18:00;696;308;388;Sonnig;-1;-1;0;Stadt Konstanz, Amt für Stadtplanung und Umwelt
08.12.2022 19:00;519;270;249;Sonnig;-1;-2;0;Stadt Konstanz, Amt für Stadtplanung und Umwelt
08.12.2022 20:00;368;158;210;Sonnig;-2;-3;0;Stadt Konstanz, Amt für Stadtplanung und Umwelt
08.12.2022 21:00;266;113;153;Sonnig;-2;-4;0;Stadt Konstanz, Amt für Stadtplanung und Umwelt
08.12.2022 22:00;203;66;137;Sonnig;-1;-3;0;Stadt Konstanz, Amt für Stadtplanung und Umwelt
08.12.2022 23:00;144;45;99;Bedeckt;-1;-2;0;Stadt Konstanz, Amt für Stadtplanung und Umwelt
09.12.2022 00:00;69;22;47;Bedeckt;0;-2;0;Stadt Konstanz, Amt für Stadtplanung und Umwelt
09.12.2022 01:00;30;6;24;Bedeckt;0;-1;0;Stadt Konstanz, Amt für Stadtplanung und Umwelt
09.12.2022 02:00;103;12;91;Bedeckt;1;-1;0;Stadt Konstanz, Amt für Stadtplanung und Umwelt
09.12.2022 03:00;3;3;0;Bedeckt;1;-1;0;Stadt Konstanz, Amt für Stadtplanung und Umwelt
09.12.2022 04:00;12;6;6;Bedeckt;1;-1;0;Stadt Konstanz, Amt für Stadtplanung und Umwelt
09.12.2022 05:00;25;20;5;Bedeckt;1;0;0;Stadt Konstanz, Amt für Stadtplanung und Umwelt
09.12.2022 06:00;119;63;56;Bedeckt;1;0;0;Stadt Konstanz, Amt für Stadtplanung und Umwelt
09.12.2022 07:00;723;457;266;Bedeckt;1;0;0;Stadt Konstanz, Amt für Stadtplanung und Umwelt
09.12.2022 08:00;545;310;235;Bedeckt;1;0;0;Stadt Konstanz, Amt für Stadtplanung und Umwelt
09.12.2022 09:00;553;343;210;Bedeckt;1;-1;0;Stadt Konstanz, Amt für Stadtplanung und Umwelt
09.12.2022 10:00;340;196;144;Bedeckt;1;-1;0;Stadt Konstanz, Amt für Stadtplanung und Umwelt
09.12.2022 11:00;390;180;210;Maessiger Schneefall;2;0;0;Stadt Konstanz, Amt für Stadtplanung und Umwelt
09.12.2022 12:00;547;245;302;Maessiger Schneefall;2;0;0;Stadt Konstanz, Amt für Stadtplanung und Umwelt
09.12.2022 13:00;647;278;369;Maessiger Schneefall;2;0;0;Stadt Konstanz, Amt für Stadtplanung und Umwelt
09.12.2022 14:00;468;261;207;Maessiger Schneefall;2;0;0;Stadt Konstanz, Amt für Stadtplanung und Umwelt
09.12.2022 15:00;523;234;289;Maessiger Schneefall;2;1;0;Stadt Konstanz, Amt für Stadtplanung und Umwelt
09.12.2022 16:00;456;199;257;Maessiger Schneefall;2;0;0;Stadt Konstanz, Amt für Stadtplanung und Umwelt
09.12.2022 17:00;518;222;296;Starker Schneefall;1;0;0.1;Stadt Konstanz, Amt für Stadtplanung und Umwelt
09.12.2022 18:00;443;208;235;Starker Schneefall;1;-1;0.1;Stadt Konstanz, Amt für Stadtplanung und Umwelt
09.12.2022 19:00;371;191;180;Starker Schneefall;1;-1;0.1;Stadt Konstanz, Amt für Stadtplanung und Umwelt
09.12.2022 20:00;250;120;130;Maessiger Schneefall;1;-2;0.1;Stadt Konstanz, Amt für Stadtplanung und Umwelt
09.12.2022 21:00;188;83;105;Maessiger Schneefall;0;-2;0.1;Stadt Konstanz, Amt für Stadtplanung und Umwelt
09.12.2022 22:00;157;47;110;Maessiger Schneefall;0;-2;0;Stadt Konstanz, Amt für Stadtplanung und Umwelt
09.12.2022 23:00;141;47;94;Maessiger Schneefall;0;-1;0.1;Stadt Konstanz, Amt für Stadtplanung und Umwelt
10.12.2022 00:00;102;33;69;Maessiger Schneefall;0;-1;0.1;Stadt Konstanz, Amt für Stadtplanung und Umwelt
10.12.2022 01:00;83;26;57;Maessiger Schneefall;0;-1;0.1;Stadt Konstanz, Amt für Stadtplanung und Umwelt
10.12.2022 02:00;65;29;36;Leichter Schneefall;0;-1;0;Stadt Konstanz, Amt für Stadtplanung und Umwelt
10.12.2022 03:00;54;22;32;Leichter Schneefall;0;-2;0;Stadt Konstanz, Amt für Stadtplanung und Umwelt
10.12.2022 04:00;17;10;7;Leichter Schneefall;0;-2;0;Stadt Konstanz, Amt für Stadtplanung und Umwelt
10.12.2022 05:00;27;18;9;Leichter Schneefall;-1;-2;0;Stadt Konstanz, Amt für Stadtplanung und Umwelt
10.12.2022 06:00;37;23;14;Leichter Schneefall;-1;-3;0;Stadt Konstanz, Amt für Stadtplanung und Umwelt
10.12.2022 07:00;46;26;20;Leichter Schneefall;0;-2;0;Stadt Konstanz, Amt für Stadtplanung und Umwelt
10.12.2022 08:00;119;66;53;Leichter Nebel;0;-2;0;Stadt Konstanz, Amt für Stadtplanung und Umwelt
10.12.2022 09:00;220;139;81;Leichter Nebel;0;-2;0;Stadt Konstanz, Amt für Stadtplanung und Umwelt
10.12.2022 10:00;227;133;94;Leichter Nebel;1;-1;0;Stadt Konstanz, Amt für Stadtplanung und Umwelt
10.12.2022 11:00;232;124;108;Leichter Schneefall;1;0;0;Stadt Konstanz, Amt für Stadtplanung und Umwelt
10.12.2022 12:00;255;126;129;Leichter Schneefall;2;0;0;Stadt Konstanz, Amt für Stadtplanung und Umwelt
10.12.2022 13:00;264;130;134;Leichter Schneefall;2;0;0;Stadt Konstanz, Amt für Stadtplanung und Umwelt
10.12.2022 14:00;248;120;128;Maessiger Schneefall;2;0;0;Stadt Konstanz, Amt für Stadtplanung und Umwelt
10.12.2022 15:00;274;140;134;Maessiger Schneefall;2;0;0;Stadt Konstanz, Amt für Stadtplanung und Umwelt
10.12.2022 16:00;273;145;128;Maessiger Schneefall;1;-1;0;Stadt Konstanz, Amt für Stadtplanung und Umwelt
10.12.2022 17:00;259;108;151;Maessiger Schneefall;1;-1;0.1;Stadt Konstanz, Amt für Stadtplanung und Umwelt
10.12.2022 18:00;261;100;161;Maessiger Schneefall;1;-2;0.1;Stadt Konstanz, Amt für Stadtplanung und Umwelt
10.12.2022 19:00;207;98;109;Maessiger Schneefall;1;-2;0;Stadt Konstanz, Amt für Stadtplanung und Umwelt
10.12.2022 20:00;181;86;95;Maessiger Schneefall;1;-2;0.1;Stadt Konstanz, Amt für Stadtplanung und Umwelt
10.12.2022 21:00;126;53;73;Maessiger Schneefall;0;-2;0.1;Stadt Konstanz, Amt für Stadtplanung und Umwelt
10.12.2022 22:00;125;51;74;Maessiger Schneefall;-1;-3;0;Stadt Konstanz, Amt für Stadtplanung und Umwelt
10.12.2022 23:00;99;37;62;Maessiger Schneefall;-2;-4;0;Stadt Konstanz, Amt für Stadtplanung und Umwelt
11.12.2022 00:00;67;22;45;Maessiger Schneefall;-3;-6;0.1;Stadt Konstanz, Amt für Stadtplanung und Umwelt
11.12.2022 01:00;61;19;42;Maessiger Schneefall;-3;-6;0;Stadt Konstanz, Amt für Stadtplanung und Umwelt
11.12.2022 02:00;59;21;38;Leichter Schneefall;-3;-6;0;Stadt Konstanz, Amt für Stadtplanung und Umwelt
11.12.2022 03:00;34;7;27;Leichter Schneefall;-3;-6;0;Stadt Konstanz, Amt für Stadtplanung und Umwelt
11.12.2022 04:00;8;4;4;Leichter Schneefall;-3;-5;0;Stadt Konstanz, Amt für Stadtplanung und Umwelt
11.12.2022 05:00;17;11;6;Leichter Schneefall;-3;-5;0;Stadt Konstanz, Amt für Stadtplanung und Umwelt
11.12.2022 06:00;17;10;7;Leichter Schneefall;-3;-5;0;Stadt Konstanz, Amt für Stadtplanung und Umwelt
11.12.2022 07:00;31;19;12;Leichter Schneefall;-3;-5;0;Stadt Konstanz, Amt für Stadtplanung und Umwelt
11.12.2022 08:00;41;17;24;Leichter Schneefall;-3;-5;0;Stadt Konstanz, Amt für Stadtplanung und Umwelt
11.12.2022 09:00;94;45;49;Leichter Schneefall;-3;-5;0;Stadt Konstanz, Amt für Stadtplanung und Umwelt
11.12.2022 10:00;108;58;50;Leichter Schneefall;-2;-4;0;Stadt Konstanz, Amt für Stadtplanung und Umwelt
11.12.2022 11:00;107;56;51;Leichte Schneeschauer;-2;-3;0;Stadt Konstanz, Amt für Stadtplanung und Umwelt
11.12.2022 12:00;162;80;82;Leichte Schneeschauer;-1;-3;0;Stadt Konstanz, Amt für Stadtplanung und Umwelt
11.12.2022 13:00;183;93;90;Leichte Schneeschauer;-1;-3;0;Stadt Konstanz, Amt für Stadtplanung und Umwelt
11.12.2022 14:00;212;102;110;Leichte Schneeschauer;-1;-3;0;Stadt Konstanz, Amt für Stadtplanung und Umwelt
11.12.2022 15:00;248;139;109;Leichte Schneeschauer;-1;-3;0;Stadt Konstanz, Amt für Stadtplanung und Umwelt
11.12.2022 16:00;243;130;113;Leichte Schneeschauer;-1;-4;0;Stadt Konstanz, Amt für Stadtplanung und Umwelt
11.12.2022 17:00;207;91;116;Leichte Schneeschauer;-2;-4;0;Stadt Konstanz, Amt für Stadtplanung und Umwelt
11.12.2022 18:00;203;97;106;Leichte Schneeschauer;-3;-5;0;Stadt Konstanz, Amt für Stadtplanung und Umwelt
11.12.2022 19:00;170;76;94;Leichte Schneeschauer;-4;-5;0;Stadt Konstanz, Amt für Stadtplanung und Umwelt
11.12.2022 20:00;161;62;99;Bewoelkt;-4;-5;0;Stadt Konstanz, Amt für Stadtplanung und Umwelt
11.12.2022 21:00;89;42;47;Bewoelkt;-5;-5;0;Stadt Konstanz, Amt für Stadtplanung und Umwelt
11.12.2022 22:00;81;46;35;Bewoelkt;-6;-7;0;Stadt Konstanz, Amt für Stadtplanung und Umwelt
11.12.2022 23:00;33;18;15;Leichter Nebel;-7;-8;0;Stadt Konstanz, Amt für Stadtplanung und Umwelt
12.12.2022 00:00;17;7;10;Leichter Nebel;-9;-10;0;Stadt Konstanz, Amt für Stadtplanung und Umwelt
12.12.2022 01:00;17;6;11;Leichter Nebel;-9;-10;0;Stadt Konstanz, Amt für Stadtplanung und Umwelt
12.12.2022 02:00;11;4;7;Leicht bewoelkt;-9;-10;0;Stadt Konstanz, Amt für Stadtplanung und Umwelt
12.12.2022 03:00;6;0;6;Leicht bewoelkt;-9;-10;0;Stadt Konstanz, Amt für Stadtplanung und Umwelt
12.12.2022 04:00;10;5;5;Leicht bewoelkt;-9;-10;0;Stadt Konstanz, Amt für Stadtplanung und Umwelt
12.12.2022 05:00;18;12;6;Leicht bewoelkt;-9;-10;0;Stadt Konstanz, Amt für Stadtplanung und Umwelt
12.12.2022 06:00;133;79;54;Leicht bewoelkt;-10;-10;0;Stadt Konstanz, Amt für Stadtplanung und Umwelt
12.12.2022 07:00;703;411;292;Leicht bewoelkt;-9;-10;0;Stadt Konstanz, Amt für Stadtplanung und Umwelt
12.12.2022 08:00;519;264;255;Bewoelkt;-9;-10;0;Stadt Konstanz, Amt für Stadtplanung und Umwelt
12.12.2022 09:00;493;298;195;Bewoelkt;-8;-10;0;Stadt Konstanz, Amt für Stadtplanung und Umwelt
12.12.2022 10:00;246;131;115;Bewoelkt;-6;-8;0;Stadt Konstanz, Amt für Stadtplanung und Umwelt
12.12.2022 11:00;387;196;191;Leicht bewoelkt;-5;-6;0;Stadt Konstanz, Amt für Stadtplanung und Umwelt
12.12.2022 12:00;422;183;239;Leicht bewoelkt;-3;-5;0;Stadt Konstanz, Amt für Stadtplanung und Umwelt
12.12.2022 13:00;566;266;300;Leicht bewoelkt;-3;-4;0;Stadt Konstanz, Amt für Stadtplanung und Umwelt
12.12.2022 14:00;406;198;208;Sonnig;-2;-3;0;Stadt Konstanz, Amt für Stadtplanung und Umwelt
12.12.2022 15:00;637;315;322;Sonnig;-2;-2;0;Stadt Konstanz, Amt für Stadtplanung und Umwelt
12.12.2022 16:00;577;292;285;Sonnig;-4;-4;0;Stadt Konstanz, Amt für Stadtplanung und Umwelt
12.12.2022 17:00;712;344;368;Sonnig;-6;-6;0;Stadt Konstanz, Amt für Stadtplanung und Umwelt
12.12.2022 18:00;501;225;276;Sonnig;-8;-8;0;Stadt Konstanz, Amt für Stadtplanung und Umwelt
12.12.2022 19:00;395;169;226;Sonnig;-9;-9;0;Stadt Konstanz, Amt für Stadtplanung und Umwelt
12.12.2022 20:00;292;129;163;Leicht bewoelkt;-9;-10;0;Stadt Konstanz, Amt für Stadtplanung und Umwelt
12.12.2022 21:00;182;77;105;Leicht bewoelkt;-10;-12;0;Stadt Konstanz, Amt für Stadtplanung und Umwelt
12.12.2022 22:00;161;67;94;Leicht bewoelkt;-10;-12;0;Stadt Konstanz, Amt für Stadtplanung und Umwelt
12.12.2022 23:00;44;19;25;Leichter Nebel;-11;-12;0;Stadt Konstanz, Amt für Stadtplanung und Umwelt
13.12.2022 00:00;40;10;30;Leichter Nebel;-12;-12;0;Stadt Konstanz, Amt für Stadtplanung und Umwelt
13.12.2022 01:00;15;9;6;Leichter Nebel;-12;-13;0;Stadt Konstanz, Amt für Stadtplanung und Umwelt
13.12.2022 02:00;6;3;3;Leichter Nebel;-12;-13;0;Stadt Konstanz, Amt für Stadtplanung und Umwelt
13.12.2022 03:00;1;1;0;Leichter Nebel;-12;-14;0;Stadt Konstanz, Amt für Stadtplanung und Umwelt
13.12.2022 04:00;3;0;3;Leichter Nebel;-13;-15;0;Stadt Konstanz, Amt für Stadtplanung und Umwelt
13.12.2022 05:00;30;22;8;Eisnebel;-13;-15;0;Stadt Konstanz, Amt für Stadtplanung und Umwelt
13.12.2022 06:00;142;79;63;Eisnebel;-13;-15;0;Stadt Konstanz, Amt für Stadtplanung und Umwelt
13.12.2022 07:00;696;405;291;Eisnebel;-13;-15;0;Stadt Konstanz, Amt für Stadtplanung und Umwelt
13.12.2022 08:00;555;291;264;Leicht bewoelkt;-12;-14;0;Stadt Konstanz, Amt für Stadtplanung und Umwelt
13.12.2022 09:00;530;316;214;Leicht bewoelkt;-12;-14;0;Stadt Konstanz, Amt für Stadtplanung und Umwelt
13.12.2022 10:00;287;161;126;Leicht bewoelkt;-9;-11;0;Stadt Konstanz, Amt für Stadtplanung und Umwelt
13.12.2022 11:00;470;237;233;Sonnig;-7;-9;0;Stadt Konstanz, Amt für Stadtplanung und Umwelt
13.12.2022 12:00;408;172;236;Sonnig;-4;-7;0;Stadt Konstanz, Amt für Stadtplanung und Umwelt
13.12.2022 13:00;660;309;351;Sonnig;-4;-7;0;Stadt Konstanz, Amt für Stadtplanung und Umwelt
13.12.2022 14:00;442;228;214;Leicht bewoelkt;-4;-7;0;Stadt Konstanz, Amt für Stadtplanung und Umwelt
13.12.2022 15:00;623;312;311;Leicht bewoelkt;-4;-7;0;Stadt Konstanz, Amt für Stadtplanung und Umwelt
13.12.2022 16:00;615;271;344;Leicht bewoelkt;-5;-8;0;Stadt Konstanz, Amt für Stadtplanung und Umwelt
13.12.2022 17:00;661;301;360;Bedeckt;-6;-9;0;Stadt Konstanz, Amt für Stadtplanung und Umwelt
13.12.2022 18:00;552;247;305;Bedeckt;-7;-10;0;Stadt Konstanz, Amt für Stadtplanung und Umwelt
13.12.2022 19:00;455;198;257;Bedeckt;-7;-10;0;Stadt Konstanz, Amt für Stadtplanung und Umwelt
13.12.2022 20:00;285;122;163;Bedeckt;-7;-10;0;Stadt Konstanz, Amt für Stadtplanung und Umwelt
13.12.2022 21:00;178;77;101;Bedeckt;-7;-10;0;Stadt Konstanz, Amt für Stadtplanung und Umwelt
13.12.2022 22:00;154;53;101;Bedeckt;-6;-8;0;Stadt Konstanz, Amt für Stadtplanung und Umwelt
13.12.2022 23:00;90;32;58;Starker Schneefall;-4;-5;0.1;Stadt Konstanz, Amt für Stadtplanung und Umwelt
14.12.2022 00:00;37;18;19;Starker Schneefall;-2;-3;0.2;Stadt Konstanz, Amt für Stadtplanung und Umwelt
14.12.2022 01:00;28;14;14;Starker Schneefall;-2;-2;0.1;Stadt Konstanz, Amt für Stadtplanung und Umwelt
14.12.2022 02:00;7;2;5;Bedeckt;-1;-1;0;Stadt Konstanz, Amt für Stadtplanung und Umwelt
14.12.2022 03:00;5;4;1;Bedeckt;-1;-1;0;Stadt Konstanz, Amt für Stadtplanung und Umwelt
14.12.2022 04:00;6;1;5;Bedeckt;0;-1;0;Stadt Konstanz, Amt für Stadtplanung und Umwelt
14.12.2022 05:00;32;24;8;Starker Nieselregen;0;-1;0;Stadt Konstanz, Amt für Stadtplanung und Umwelt
14.12.2022 06:00;108;54;54;Starker Nieselregen;0;0;0;Stadt Konstanz, Amt für Stadtplanung und Umwelt
14.12.2022 07:00;620;386;234;Starker Nieselregen;1;-1;0;Stadt Konstanz, Amt für Stadtplanung und Umwelt
14.12.2022 08:00;487;261;226;Leichter Regenfall;1;-1;0.3;Stadt Konstanz, Amt für Stadtplanung und Umwelt
14.12.2022 09:00;458;248;210;Leichter Regenfall;2;-1;0.4;Stadt Konstanz, Amt für Stadtplanung und Umwelt
14.12.2022 10:00;196;110;86;Leichter Regenfall;2;-1;0.2;Stadt Konstanz, Amt für Stadtplanung und Umwelt
14.12.2022 11:00;258;126;132;Leichter Regenfall;2;-1;0.3;Stadt Konstanz, Amt für Stadtplanung und Umwelt
14.12.2022 12:00;320;159;161;Leichter Regenfall;2;-1;0.4;Stadt Konstanz, Amt für Stadtplanung und Umwelt
14.12.2022 13:00;562;289;273;Leichter Regenfall;3;0;0.2;Stadt Konstanz, Amt für Stadtplanung und Umwelt
14.12.2022 14:00;331;155;176;Leichter Nebel;3;1;0;Stadt Konstanz, Amt für Stadtplanung und Umwelt
14.12.2022 15:00;479;217;262;Leichter Nebel;3;2;0;Stadt Konstanz, Amt für Stadtplanung und Umwelt
14.12.2022 16:00;459;233;226;Leichter Nebel;3;2;0;Stadt Konstanz, Amt für Stadtplanung und Umwelt
14.12.2022 17:00;544;250;294;Nieselregen;3;2;0.1;Stadt Konstanz, Amt für Stadtplanung und Umwelt
14.12.2022 18:00;524;240;284;Nieselregen;3;2;0.1;Stadt Konstanz, Amt für Stadtplanung und Umwelt
14.12.2022 19:00;369;198;171;Nieselregen;2;1;0;Stadt Konstanz, Amt für Stadtplanung und Umwelt
14.12.2022 20:00;278;112;166;Leichter Nebel;1;0;0;Stadt Konstanz, Amt für Stadtplanung und Umwelt
14.12.2022 21:00;188;85;103;Leichter Nebel;1;-1;0;Stadt Konstanz, Amt für Stadtplanung und Umwelt
14.12.2022 22:00;190;62;128;Leichter Nebel;2;1;0;Stadt Konstanz, Amt für Stadtplanung und Umwelt
14.12.2022 23:00;92;34;58;Nieselregen;2;2;0.1;Stadt Konstanz, Amt für Stadtplanung und Umwelt
15.12.2022 00:00;47;18;29;Nieselregen;3;3;0.2;Stadt Konstanz, Amt für Stadtplanung und Umwelt
15.12.2022 01:00;31;5;26;Nieselregen;3;2;0.1;Stadt Konstanz, Amt für Stadtplanung und Umwelt
15.12.2022 02:00;18;13;5;Nieselregen;3;1;0.1;Stadt Konstanz, Amt für Stadtplanung und Umwelt
15.12.2022 03:00;6;4;2;Nieselregen;2;0;0.1;Stadt Konstanz, Amt für Stadtplanung und Umwelt
15.12.2022 04:00;13;8;5;Nieselregen;2;0;0.1;Stadt Konstanz, Amt für Stadtplanung und Umwelt
15.12.2022 05:00;29;20;9;Leichter Eisregen;1;-1;0.1;Stadt Konstanz, Amt für Stadtplanung und Umwelt
15.12.2022 06:00;107;65;42;Leichter Eisregen;1;-2;0.2;Stadt Konstanz, Amt für Stadtplanung und Umwelt
15.12.2022 07:00;593;342;251;Leichter Eisregen;1;-2;0.1;Stadt Konstanz, Amt für Stadtplanung und Umwelt
15.12.2022 08:00;523;304;219;Starker Schneefall;1;-2;0.1;Stadt Konstanz, Amt für Stadtplanung und Umwelt
15.12.2022 09:00;522;313;209;Starker Schneefall;0;-3;0.1;Stadt Konstanz, Amt für Stadtplanung und Umwelt
15.12.2022 10:00;278;145;133;Starker Schneefall;0;-3;0.1;Stadt Konstanz, Amt für Stadtplanung und Umwelt
15.12.2022 11:00;417;188;229;Starker Schneefall;0;-3;0.2;Stadt Konstanz, Amt für Stadtplanung und Umwelt
15.12.2022 12:00;440;196;244;Starker Schneefall;0;-3;0.2;Stadt Konstanz, Amt für Stadtplanung und Umwelt
15.12.2022 13:00;626;263;363;Starker Schneefall;0;-3;0.1;Stadt Konstanz, Amt für Stadtplanung und Umwelt
15.12.2022 14:00;496;264;232;Leichter Schneefall;0;-3;0;Stadt Konstanz, Amt für Stadtplanung und Umwelt
15.12.2022 15:00;646;326;320;Leichter Schneefall;0;-3;0;Stadt Konstanz, Amt für Stadtplanung und Umwelt
15.12.2022 16:00;601;297;304;Leichter Schneefall;0;-4;0;Stadt Konstanz, Amt für Stadtplanung und Umwelt
15.12.2022 17:00;689;334;355;Maessiger Schneefall;-1;-5;0.1;Stadt Konstanz, Amt für Stadtplanung und Umwelt
15.12.2022 18:00;565;251;314;Maessiger Schneefall;-1;-5;0.1;Stadt Konstanz, Amt für Stadtplanung und Umwelt
15.12.2022 19:00;425;165;260;Maessiger Schneefall;-1;-5;0;Stadt Konstanz, Amt für Stadtplanung und Umwelt
15.12.2022 20:00;255;121;134;Maessiger Schneefall;-1;-5;0;Stadt Konstanz, Amt für Stadtplanung und Umwelt
15.12.2022 21:00;159;73;86;Maessiger Schneefall;-1;-5;0;Stadt Konstanz, Amt für Stadtplanung und Umwelt
15.12.2022 22:00;180;68;112;Maessiger Schneefall;-1;-5;0;Stadt Konstanz, Amt für Stadtplanung und Umwelt
15.12.2022 23:00;109;32;77;Starker Schneefall;-1;-5;0.2;Stadt Konstanz, Amt für Stadtplanung und Umwelt
16.12.2022 00:00;49;16;33;Starker Schneefall;-1;-5;0.3;Stadt Konstanz, Amt für Stadtplanung und Umwelt
16.12.2022 01:00;25;6;19;Starker Schneefall;-1;-5;0.2;Stadt Konstanz, Amt für Stadtplanung und Umwelt
16.12.2022 02:00;19;8;11;Starker Schneefall;-1;-5;0.3;Stadt Konstanz, Amt für Stadtplanung und Umwelt
16.12.2022 03:00;4;1;3;Starker Schneefall;-1;-5;0.4;Stadt Konstanz, Amt für Stadtplanung und Umwelt
16.12.2022 04:00;8;5;3;Starker Schneefall;-1;-5;0.2;Stadt Konstanz, Amt für Stadtplanung und Umwelt
16.12.2022 05:00;23;15;8;Starker Schneefall;-2;-5;0.2;Stadt Konstanz, Amt für Stadtplanung und Umwelt
16.12.2022 06:00;106;64;42;Starker Schneefall;-2;-5;0.3;Stadt Konstanz, Amt für Stadtplanung und Umwelt
16.12.2022 07:00;459;254;205;Starker Schneefall;-2;-6;0.2;Stadt Konstanz, Amt für Stadtplanung und Umwelt
16.12.2022 08:00;357;204;153;Maessiger Schneefall;-3;-6;0.1;Stadt Konstanz, Amt für Stadtplanung und Umwelt
16.12.2022 09:00;409;240;169;Maessiger Schneefall;-3;-6;0.1;Stadt Konstanz, Amt für Stadtplanung und Umwelt
16.12.2022 10:00;237;121;116;Maessiger Schneefall;-2;-5;0;Stadt Konstanz, Amt für Stadtplanung und Umwelt
16.12.2022 11:00;354;176;178;Maessiger Schneefall;-1;-5;0;Stadt Konstanz, Amt für Stadtplanung und Umwelt
16.12.2022 12:00;423;218;205;Maessiger Schneefall;-1;-4;0;Stadt Konstanz, Amt für Stadtplanung und Umwelt
16.12.2022 13:00;514;231;283;Maessiger Schneefall;-1;-4;0;Stadt Konstanz, Amt für Stadtplanung und Umwelt
16.12.2022 14:00;377;189;188;Leichter Schneefall;-1;-4;0;Stadt Konstanz, Amt für Stadtplanung und Umwelt
16.12.2022 15:00;385;192;193;Leichter Schneefall;-1;-5;0;Stadt Konstanz, Amt für Stadtplanung und Umwelt
16.12.2022 16:00;381;144;237;Leichter Schneefall;-3;-6;0;Stadt Konstanz, Amt für Stadtplanung und Umwelt
16.12.2022 17:00;412;218;194;Leichter Schneefall;-4;-8;0;Stadt Konstanz, Amt für Stadtplanung und Umwelt
16.12.2022 18:00;342;173;169;Leichter Schneefall;-5;-9;0;Stadt Konstanz, Amt für Stadtplanung und Umwelt
16.12.2022 19:00;298;161;137;Leichter Schneefall;-6;-10;0;Stadt Konstanz, Amt für Stadtplanung und Umwelt
16.12.2022 20:00;207;105;102;Leichter Schneefall;-6;-10;0;Stadt Konstanz, Amt für Stadtplanung und Umwelt
16.12.2022 21:00;193;78;115;Leichter Schneefall;-7;-10;0;Stadt Konstanz, Amt für Stadtplanung und Umwelt
16.12.2022 22:00;138;42;96;Leichter Schneefall;-8;-12;0;Stadt Konstanz, Amt für Stadtplanung und Umwelt
16.12.2022 23:00;114;30;84;Stellenweise leichter Schneefall;-9;-13;0;Stadt Konstanz, Amt für Stadtplanung und Umwelt
17.12.2022 00:00;98;36;62;Stellenweise leichter Schneefall;-10;-14;0;Stadt Konstanz, Amt für Stadtplanung und Umwelt
17.12.2022 01:00;72;15;57;Stellenweise leichter Schneefall;-11;-15;0;Stadt Konstanz, Amt für Stadtplanung und Umwelt
17.12.2022 02:00;42;12;30;Leichter Nebel;-11;-16;0;Stadt Konstanz, Amt für Stadtplanung und Umwelt
17.12.2022 03:00;38;14;24;Leichter Nebel;-12;-16;0;Stadt Konstanz, Amt für Stadtplanung und Umwelt
17.12.2022 04:00;13;5;8;Leichter Nebel;-13;-16;0;Stadt Konstanz, Amt für Stadtplanung und Umwelt
17.12.2022 05:00;23;13;10;Eisnebel;-13;-17;0;Stadt Konstanz, Amt für Stadtplanung und Umwelt
17.12.2022 06:00;44;32;12;Eisnebel;-13;-17;0;Stadt Konstanz, Amt für Stadtplanung und Umwelt
17.12.2022 07:00;42;24;18;Eisnebel;-13;-16;0;Stadt Konstanz, Amt für Stadtplanung und Umwelt
17.12.2022 08:00;91;42;49;Leichter Nebel;-13;-16;0;Stadt Konstanz, Amt für Stadtplanung und Umwelt
17.12.2022 09:00;190;126;64;Leichter Nebel;-12;-15;0;Stadt Konstanz, Amt für Stadtplanung und Umwelt
17.12.2022 10:00;234;158;76;Leichter Nebel;-10;-12;0;Stadt Konstanz, Amt für Stadtplanung und Umwelt
17.12.2022 11:00;277;144;133;Sonnig;-7;-9;0;Stadt Konstanz, Amt für Stadtplanung und Umwelt
17.12.2022 12:00;356;194;162;Sonnig;-4;-7;0;Stadt Konstanz, Amt für Stadtplanung und Umwelt
17.12.2022 13:00;341;167;174;Sonnig;-4;-6;0;Stadt Konstanz, Amt für Stadtplanung und Umwelt
17.12.2022 14:00;333;144;189;Sonnig;-3;-6;0;Stadt Konstanz, Amt für Stadtplanung und Umwelt
17.12.2022 15:00;355;182;173;Sonnig;-3;-6;0;Stadt Konstanz, Amt für Stadtplanung und Umwelt
17.12.2022 16:00;311;133;178;Sonnig;-5;-8;0;Stadt Konstanz, Amt für Stadtplanung und Umwelt
17.12.2022 17:00;327;136;191;Leichter Nebel;-7;-10;0;Stadt Konstanz, Amt für Stadtplanung und Umwelt
17.12.2022 18:00;262;102;160;Leichter Nebel;-9;-12;0;Stadt Konstanz, Amt für Stadtplanung und Umwelt
17.12.2022 19:00;216;101;115;Leichter Nebel;-9;-13;0;Stadt Konstanz, Amt für Stadtplanung und Umwelt
17.12.2022 20:00;150;75;75;Eisnebel;-10;-13;0;Stadt Konstanz, Amt für Stadtplanung und Umwelt
17.12.2022 21:00;166;85;81;Eisnebel;-10;-14;0;Stadt Konstanz, Amt für Stadtplanung und Umwelt
17.12.2022 22:00;90;24;66;Eisnebel;-11;-14;0;Stadt Konstanz, Amt für Stadtplanung und Umwelt
17.12.2022 23:00;111;39;72;Eisnebel;-11;-15;0;Stadt Konstanz, Amt für Stadtplanung und Umwelt
18.12.2022 00:00;93;35;58;Eisnebel;-12;-15;0;Stadt Konstanz, Amt für Stadtplanung und Umwelt
18.12.2022 01:00;72;23;49;Eisnebel;-12;-15;0;Stadt Konstanz, Amt für Stadtplanung und Umwelt
18.12.2022 02:00;57;17;40;Eisnebel;-11;-15;0;Stadt Konstanz, Amt für Stadtplanung und Umwelt
18.12.2022 03:00;27;11;16;Eisnebel;-11;-15;0;Stadt Konstanz, Amt für Stadtplanung und Umwelt
18.12.2022 04:00;10;8;2;Eisnebel;-11;-13;0;Stadt Konstanz, Amt für Stadtplanung und Umwelt
18.12.2022 05:00;18;10;8;Leichter Nebel;-10;-11;0;Stadt Konstanz, Amt für Stadtplanung und Umwelt
18.12.2022 06:00;16;13;3;Leichter Nebel;-10;-10;0;Stadt Konstanz, Amt für Stadtplanung und Umwelt
18.12.2022 07:00;24;14;10;Leichter Nebel;-9;-9;0;Stadt Konstanz, Amt für Stadtplanung und Umwelt
18.12.2022 08:00;45;22;23;Leichter Nebel;-9;-9;0;Stadt Konstanz, Amt für Stadtplanung und Umwelt
18.12.2022 09:00;105;73;32;Leichter Nebel;-8;-9;0;Stadt Konstanz, Amt für Stadtplanung und Umwelt
18.12.2022 10:00;100;63;37;Leichter Nebel;-6;-7;0;Stadt Konstanz, Amt für Stadtplanung und Umwelt
18.12.2022 11:00;117;46;71;Sonnig;-4;-6;0;Stadt Konstanz, Amt für Stadtplanung und Umwelt
18.12.2022 12:00;138;77;61;Sonnig;-3;-4;0;Stadt Konstanz, Amt für Stadtplanung und Umwelt
18.12.2022 13:00;128;65;63;Sonnig;-2;-3;0;Stadt Konstanz, Amt für Stadtplanung und Umwelt
18.12.2022 14:00;161;81;80;Bewoelkt;-2;-3;0;Stadt Konstanz, Amt für Stadtplanung und Umwelt
18.12.2022 15:00;215;103;112;Bewoelkt;-2;-3;0;Stadt Konstanz, Amt für Stadtplanung und Umwelt
18.12.2022 16:00;177;102;75;Bewoelkt;-4;-5;0;Stadt Konstanz, Amt für Stadtplanung und Umwelt
18.12.2022 17:00;167;81;86;Leichter Nebel;-5;-7;0;Stadt Konstanz, Amt für Stadtplanung und Umwelt
18.12.2022 18:00;144;72;72;Leichter Nebel;-7;-9;0;Stadt Konstanz, Amt für Stadtplanung und Umwelt
18.12.2022 19:00;162;72;90;Leichter Nebel;-8;-10;0;Stadt Konstanz, Amt für Stadtplanung und Umwelt
18.12.2022 20:00;144;56;88;Leichter Nebel;-8;-11;0;Stadt Konstanz, Amt für Stadtplanung und Umwelt
18.12.2022 21:00;94;46;48;Leichter Nebel;-9;-12;0;Stadt Konstanz, Amt für Stadtplanung und Umwelt
18.12.2022 22:00;70;25;45;Leichter Nebel;-8;-9;0;Stadt Konstanz, Amt für Stadtplanung und Umwelt
18.12.2022 23:00;43;21;22;Leicht bewoelkt;-7;-7;0;Stadt Konstanz, Amt für Stadtplanung und Umwelt
19.12.2022 00:00;22;12;10;Leicht bewoelkt;-5;-5;0;Stadt Konstanz, Amt für Stadtplanung und Umwelt
19.12.2022 01:00;7;3;4;Leicht bewoelkt;-5;-5;0;Stadt Konstanz, Amt für Stadtplanung und Umwelt
19.12.2022 02:00;6;2;4;Leicht bewoelkt;-5;-5;0;Stadt Konstanz, Amt für Stadtplanung und Umwelt
19.12.2022 03:00;3;1;2;Leicht bewoelkt;-5;-5;0;Stadt Konstanz, Amt für Stadtplanung und Umwelt
19.12.2022 04:00;5;3;2;Leicht bewoelkt;-4;-4;0;Stadt Konstanz, Amt für Stadtplanung und Umwelt
19.12.2022 05:00;33;19;14;Leicht bewoelkt;-4;-4;0;Stadt Konstanz, Amt für Stadtplanung und Umwelt
19.12.2022 06:00;121;82;39;Leicht bewoelkt;-3;-3;0;Stadt Konstanz, Amt für Stadtplanung und Umwelt
19.12.2022 07:00;635;353;282;Leicht bewoelkt;-3;-3;0;Stadt Konstanz, Amt für Stadtplanung und Umwelt
19.12.2022 08:00;501;262;239;Leicht bewoelkt;-3;-3;0;Stadt Konstanz, Amt für Stadtplanung und Umwelt
19.12.2022 09:00;518;299;219;Leicht bewoelkt;-3;-3;0;Stadt Konstanz, Amt für Stadtplanung und Umwelt
19.12.2022 10:00;316;181;135;Leicht bewoelkt;-1;-1;0;Stadt Konstanz, Amt für Stadtplanung und Umwelt
19.12.2022 11:00;422;213;209;Sonnig;0;0;0;Stadt Konstanz, Amt für Stadtplanung und Umwelt
19.12.2022 12:00;442;189;253;Sonnig;2;2;0;Stadt Konstanz, Amt für Stadtplanung und Umwelt
19.12.2022 13:00;649;290;359;Sonnig;2;2;0;Stadt Konstanz, Amt für Stadtplanung und Umwelt
19.12.2022 14:00;476;240;236;Leichter Nebel;2;2;0;Stadt Konstanz, Amt für Stadtplanung und Umwelt
19.12.2022 15:00;679;355;324;Leichter Nebel;2;2;0;Stadt Konstanz, Amt für Stadtplanung und Umwelt
19.12.2022 16:00;664;313;351;Leichter Nebel;1;1;0;Stadt Konstanz, Amt für Stadtplanung und Umwelt
19.12.2022 17:00;753;382;371;Leichter Nebel;-1;-1;0;Stadt Konstanz, Amt für Stadtplanung und Umwelt
19.12.2022 18:00;605;282;323;Leichter Nebel;-2;-2;0;Stadt Konstanz, Amt für Stadtplanung und Umwelt
19.12.2022 19:00;416;186;230;Leichter Nebel;-2;-2;0;Stadt Konstanz, Amt für Stadtplanung und Umwelt
19.12.2022 20:00;299;121;178;Sonnig;-3;-3;0;Stadt Konstanz, Amt für Stadtplanung und Umwelt
19.12.2022 21:00;208;74;134;Sonnig;-3;-3;0;Stadt Konstanz, Amt für Stadtplanung und Umwelt
19.12.2022 22:00;155;55;100;Sonnig;-2;-2;0;Stadt Konstanz, Amt für Stadtplanung und Umwelt
19.12.2022 23:00;102;47;55;Sonnig;-2;-2;0;Stadt Konstanz, Amt für Stadtplanung und Umwelt
20.12.2022 00:00;63;20;43;Sonnig;-2;-2;0;Stadt Konstanz, Amt für Stadtplanung und Umwelt
20.12.2022 01:00;29;10;19;Sonnig;-2;-2;0;Stadt Konstanz, Amt für Stadtplanung und Umwelt
20.12.2022 02:00;24;7;17;Sonnig;-2;-2;0;Stadt Konstanz, Amt für Stadtplanung und Umwelt
20.12.2022 03:00;6;3;3;Sonnig;-2;-2;0;Stadt Konstanz, Amt für Stadtplanung und Umwelt
20.12.2022 04:00;7;4;3;Sonnig;-2;-2;0;Stadt Konstanz, Amt für Stadtplanung und Umwelt
20.12.2022 05:00;29;21;8;Bedeckt;-2;-2;0;Stadt Konstanz, Amt für Stadtplanung und Umwelt
20.12.2022 06:00;129;85;44;Bedeckt;-2;-2;0;Stadt Konstanz, Amt für Stadtplanung und Umwelt
20.12.2022 07:00;492;242;250;Bedeckt;-2;-2;0;Stadt Konstanz, Amt für Stadtplanung und Umwelt
20.12.2022 08:00;598;334;264;Leicht bewoelkt;-1;-2;0;Stadt Konstanz, Amt für Stadtplanung und Umwelt
20.12.2022 09:00;762;490;272;Leicht bewoelkt;0;-2;0;Stadt Konstanz, Amt für Stadtplanung und Umwelt
20.12.2022 10:00;360;219;141;Leicht bewoelkt;1;1;0;Stadt Konstanz, Amt für Stadtplanung und Umwelt
20.12.2022 11:00;595;319;276;Sonnig;3;3;0;Stadt Konstanz, Amt für Stadtplanung und Umwelt
20.12.2022 12:00;590;227;363;Sonnig;5;5;0;Stadt Konstanz, Amt für Stadtplanung und Umwelt
20.12.2022 13:00;635;277;358;Sonnig;5;5;0;Stadt Konstanz, Amt für Stadtplanung und Umwelt
20.12.2022 14:00;533;271;262;Leichter Nebel;5;5;0;Stadt Konstanz, Amt für Stadtplanung und Umwelt
20.12.2022 15:00;669;343;326;Leichter Nebel;5;5;0;Stadt Konstanz, Amt für Stadtplanung und Umwelt
20.12.2022 16:00;688;318;370;Leichter Nebel;3;3;0;Stadt Konstanz, Amt für Stadtplanung und Umwelt
20.12.2022 17:00;701;335;366;Sonnig;2;2;0;Stadt Konstanz, Amt für Stadtplanung und Umwelt
20.12.2022 18:00;574;246;328;Sonnig;0;0;0;Stadt Konstanz, Amt für Stadtplanung und Umwelt
20.12.2022 19:00;513;227;286;Sonnig;0;0;0;Stadt Konstanz, Amt für Stadtplanung und Umwelt
20.12.2022 20:00;280;127;153;Sonnig;-1;-1;0;Stadt Konstanz, Amt für Stadtplanung und Umwelt
20.12.2022 21:00;237;83;154;Sonnig;-2;-2;0;Stadt Konstanz, Amt für Stadtplanung und Umwelt
20.12.2022 22:00;182;78;104;Sonnig;-2;-2;0;Stadt Konstanz, Amt für Stadtplanung und Umwelt
20.12.2022 23:00;120;36;84;Bewoelkt;-1;-1;0;Stadt Konstanz, Amt für Stadtplanung und Umwelt
21.12.2022 00:00;90;31;59;Bewoelkt;-1;-1;0;Stadt Konstanz, Amt für Stadtplanung und Umwelt
21.12.2022 01:00;67;36;31;Bewoelkt;-1;-1;0;Stadt Konstanz, Amt für Stadtplanung und Umwelt
21.12.2022 02:00;24;12;12;Leichter Nebel;-2;-2;0;Stadt Konstanz, Amt für Stadtplanung und Umwelt
21.12.2022 03:00;18;5;13;Leichter Nebel;-2;-2;0;Stadt Konstanz, Amt für Stadtplanung und Umwelt
21.12.2022 04:00;11;5;6;Leichter Nebel;-2;-2;0;Stadt Konstanz, Amt für Stadtplanung und Umwelt
21.12.2022 05:00;42;34;8;Leichter Nebel;-1;-2;0;Stadt Konstanz, Amt für Stadtplanung und Umwelt
21.12.2022 06:00;112;68;44;Leichter Nebel;-1;-2;0;Stadt Konstanz, Amt für Stadtplanung und Umwelt
21.12.2022 07:00;315;193;122;Leichter Nebel;-1;-2;0;Stadt Konstanz, Amt für Stadtplanung und Umwelt
21.12.2022 08:00;410;221;189;Nieselregen;0;-1;0.2;Stadt Konstanz, Amt für Stadtplanung und Umwelt
21.12.2022 09:00;421;255;166;Nieselregen;1;-1;0.2;Stadt Konstanz, Amt für Stadtplanung und Umwelt
21.12.2022 10:00;341;202;139;Nieselregen;2;0;0.1;Stadt Konstanz, Amt für Stadtplanung und Umwelt
21.12.2022 11:00;409;204;205;Nieselregen;3;1;0.2;Stadt Konstanz, Amt für Stadtplanung und Umwelt
21.12.2022 12:00;466;225;241;Nieselregen;4;2;0.2;Stadt Konstanz, Amt für Stadtplanung und Umwelt
21.12.2022 13:00;488;253;235;Nieselregen;4;2;0.1;Stadt Konstanz, Amt für Stadtplanung und Umwelt
21.12.2022 14:00;507;258;249;Nieselregen;5;2;0.2;Stadt Konstanz, Amt für Stadtplanung und Umwelt
21.12.2022 15:00;614;283;331;Nieselregen;5;3;0.3;Stadt Konstanz, Amt für Stadtplanung und Umwelt
21.12.2022 16:00;641;299;342;Nieselregen;6;3;0.1;Stadt Konstanz, Amt für Stadtplanung und Umwelt
21.12.2022 17:00;693;355;338;Nieselregen;6;3;0.1;Stadt Konstanz, Amt für Stadtplanung und Umwelt
21.12.2022 18:00;554;248;306;Nieselregen;6;3;0.2;Stadt Konstanz, Amt für Stadtplanung und Umwelt
21.12.2022 19:00;450;184;266;Nieselregen;5;3;0.1;Stadt Konstanz, Amt für Stadtplanung und Umwelt
21.12.2022 20:00;292;127;165;Bedeckt;5;2;0;Stadt Konstanz, Amt für Stadtplanung und Umwelt
21.12.2022 21:00;217;81;136;Bedeckt;5;2;0;Stadt Konstanz, Amt für Stadtplanung und Umwelt
21.12.2022 22:00;206;54;152;Bedeckt;4;2;0;Stadt Konstanz, Amt für Stadtplanung und Umwelt
21.12.2022 23:00;127;42;85;Leichter Nebel;3;1;0;Stadt Konstanz, Amt für Stadtplanung und Umwelt
22.12.2022 00:00;87;20;67;Leichter Nebel;3;1;0;Stadt Konstanz, Amt für Stadtplanung und Umwelt
22.12.2022 01:00;61;24;37;Leichter Nebel;4;2;0;Stadt Konstanz, Amt für Stadtplanung und Umwelt
22.12.2022 02:00;19;10;9;Bewoelkt;4;2;0;Stadt Konstanz, Amt für Stadtplanung und Umwelt
22.12.2022 03:00;14;5;9;Bewoelkt;5;3;0;Stadt Konstanz, Amt für Stadtplanung und Umwelt
22.12.2022 04:00;11;9;2;Bewoelkt;6;3;0;Stadt Konstanz, Amt für Stadtplanung und Umwelt
22.12.2022 05:00;28;22;6;Nieselregen;6;3;0.1;Stadt Konstanz, Amt für Stadtplanung und Umwelt
22.12.2022 06:00;113;67;46;Nieselregen;6;3;0.2;Stadt Konstanz, Amt für Stadtplanung und Umwelt
22.12.2022 07:00;292;177;115;Nieselregen;6;3;0.1;Stadt Konstanz, Amt für Stadtplanung und Umwelt
22.12.2022 08:00;375;206;169;Bewoelkt;6;3;0;Stadt Konstanz, Amt für Stadtplanung und Umwelt
22.12.2022 09:00;412;251;161;Bewoelkt;6;4;0;Stadt Konstanz, Amt für Stadtplanung und Umwelt
22.12.2022 10:00;375;220;155;Bewoelkt;7;4;0;Stadt Konstanz, Amt für Stadtplanung und Umwelt
22.12.2022 11:00;374;204;170;Bedeckt;7;5;0;Stadt Konstanz, Amt für Stadtplanung und Umwelt
22.12.2022 12:00;442;202;240;Bedeckt;8;6;0;Stadt Konstanz, Amt für Stadtplanung und Umwelt
22.12.2022 13:00;477;231;246;Bedeckt;8;6;0;Stadt Konstanz, Amt für Stadtplanung und Umwelt
22.12.2022 14:00;484;235;249;Leicht bewoelkt;9;7;0;Stadt Konstanz, Amt für Stadtplanung und Umwelt
22.12.2022 15:00;548;268;280;Leicht bewoelkt;9;7;0;Stadt Konstanz, Amt für Stadtplanung und Umwelt
22.12.2022 16:00;619;325;294;Leicht bewoelkt;8;6;0;Stadt Konstanz, Amt für Stadtplanung und Umwelt
22.12.2022 17:00;569;268;301;Leicht bewoelkt;7;5;0;Stadt Konstanz, Amt für Stadtplanung und Umwelt
22.12.2022 18:00;479;235;244;Leicht bewoelkt;6;5;0;Stadt Konstanz, Amt für Stadtplanung und Umwelt
22.12.2022 19:00;351;180;171;Leicht bewoelkt;6;4;0;Stadt Konstanz, Amt für Stadtplanung und Umwelt
22.12.2022 20:00;243;97;146;Bewoelkt;6;4;0;Stadt Konstanz, Amt für Stadtplanung und Umwelt
22.12.2022 21:00;173;64;109;Bewoelkt;6;4;0;Stadt Konstanz, Amt für Stadtplanung und Umwelt
22.12.2022 22:00;149;36;113;Bewoelkt;6;4;0;Stadt Konstanz, Amt für Stadtplanung und Umwelt
22.12.2022 23:00;93;27;66;Bedeckt;5;3;0;Stadt Konstanz, Amt für Stadtplanung und Umwelt
23.12.2022 00:00;84;24;60;Bedeckt;5;3;0;Stadt Konstanz, Amt für Stadtplanung und Umwelt
23.12.2022 01:00;61;17;44;Bedeckt;5;3;0;Stadt Konstanz, Amt für Stadtplanung und Umwelt
23.12.2022 02:00;27;5;22;Bedeckt;6;4;0;Stadt Konstanz, Amt für Stadtplanung und Umwelt
23.12.2022 03:00;17;8;9;Bedeckt;6;4;0;Stadt Konstanz, Amt für Stadtplanung und Umwelt
23.12.2022 04:00;6;1;5;Bedeckt;6;4;0;Stadt Konstanz, Amt für Stadtplanung und Umwelt
23.12.2022 05:00;27;20;7;Nieselregen;6;4;0.1;Stadt Konstanz, Amt für Stadtplanung und Umwelt
23.12.2022 06:00;70;43;27;Nieselregen;6;4;0.2;Stadt Konstanz, Amt für Stadtplanung und Umwelt
23.12.2022 07:00;183;109;74;Nieselregen;6;4;0.1;Stadt Konstanz, Amt für Stadtplanung und Umwelt
23.12.2022 08:00;285;176;109;Nieselregen;6;4;0.2;Stadt Konstanz, Amt für Stadtplanung und Umwelt
23.12.2022 09:00;305;187;118;Nieselregen;6;4;0.2;Stadt Konstanz, Amt für Stadtplanung und Umwelt
23.12.2022 10:00;277;155;122;Nieselregen;7;5;0.1;Stadt Konstanz, Amt für Stadtplanung und Umwelt
23.12.2022 11:00;362;197;165;Leichter Regenfall;8;6;0.3;Stadt Konstanz, Amt für Stadtplanung und Umwelt
23.12.2022 12:00;351;135;216;Leichter Regenfall;8;6;0.4;Stadt Konstanz, Amt für Stadtplanung und Umwelt
23.12.2022 13:00;340;160;180;Leichter Regenfall;10;8;0.2;Stadt Konstanz, Amt für Stadtplanung und Umwelt
23.12.2022 14:00;261;137;124;Bedeckt;11;9;0;Stadt Konstanz, Amt für Stadtplanung und Umwelt
23.12.2022 15:00;257;133;124;Bedeckt;12;10;0;Stadt Konstanz, Amt für Stadtplanung und Umwelt
23.12.2022 16:00;240;103;137;Bedeckt;12;10;0;Stadt Konstanz, Amt für Stadtplanung und Umwelt
23.12.2022 17:00;212;99;113;Bewoelkt;12;10;0;Stadt Konstanz, Amt für Stadtplanung und Umwelt
23.12.2022 18:00;194;77;117;Bewoelkt;12;10;0;Stadt Konstanz, Amt für Stadtplanung und Umwelt
23.12.2022 19:00;162;73;89;Bewoelkt;12;10;0;Stadt Konstanz, Amt für Stadtplanung und Umwelt
23.12.2022 20:00;119;56;63;Bedeckt;12;9;0;Stadt Konstanz, Amt für Stadtplanung und Umwelt
23.12.2022 21:00;68;33;35;Bedeckt;12;9;0;Stadt Konstanz, Amt für Stadtplanung und Umwelt
23.12.2022 22:00;58;29;29;Bedeckt;11;9;0;Stadt Konstanz, Amt für Stadtplanung und Umwelt
23.12.2022 23:00;34;16;18;Leichter Regenschauer;11;8;0.4;Stadt Konstanz, Amt für Stadtplanung und Umwelt
24.12.2022 00:00;53;19;34;Leichter Regenschauer;10;8;0.7;Stadt Konstanz, Amt für Stadtplanung und Umwelt
24.12.2022 01:00;27;10;17;Leichter Regenschauer;10;8;0.4;Stadt Konstanz, Amt für Stadtplanung und Umwelt
24.12.2022 02:00;21;3;18;Leichter Regenschauer;10;7;0.1;Stadt Konstanz, Amt für Stadtplanung und Umwelt
24.12.2022 03:00;22;4;18;Leichter Regenschauer;10;7;0.1;Stadt Konstanz, Amt für Stadtplanung und Umwelt
24.12.2022 04:00;8;8;0;Leichter Regenschauer;9;7;0.1;Stadt Konstanz, Amt für Stadtplanung und Umwelt
24.12.2022 05:00;14;9;5;Leichter Regenschauer;9;7;0.2;Stadt Konstanz, Amt für Stadtplanung und Umwelt
24.12.2022 06:00;27;16;11;Leichter Regenschauer;8;6;0.3;Stadt Konstanz, Amt für Stadtplanung und Umwelt
24.12.2022 07:00;51;26;25;Leichter Regenschauer;8;6;0.2;Stadt Konstanz, Amt für Stadtplanung und Umwelt
24.12.2022 08:00;83;42;41;Leichter Regenfall;8;5;0.5;Stadt Konstanz, Amt für Stadtplanung und Umwelt
24.12.2022 09:00;164;111;53;Leichter Regenfall;7;5;0.7;Stadt Konstanz, Amt für Stadtplanung und Umwelt
24.12.2022 10:00;233;113;120;Leichter Regenfall;7;5;0.4;Stadt Konstanz, Amt für Stadtplanung und Umwelt
24.12.2022 11:00;233;124;109;Leichter Regenfall;7;5;0.5;Stadt Konstanz, Amt für Stadtplanung und Umwelt
24.12.2022 12:00;268;135;133;Leichter Regenfall;7;5;0.7;Stadt Konstanz, Amt für Stadtplanung und Umwelt
24.12.2022 13:00;235;102;133;Leichter Regenfall;7;5;0.3;Stadt Konstanz, Amt für Stadtplanung und Umwelt
24.12.2022 14:00;182;71;111;Nieselregen;7;5;0.1;Stadt Konstanz, Amt für Stadtplanung und Umwelt
24.12.2022 15:00;126;60;66;Nieselregen;7;5;0.1;Stadt Konstanz, Amt für Stadtplanung und Umwelt
24.12.2022 16:00;135;72;63;Nieselregen;7;5;0;Stadt Konstanz, Amt für Stadtplanung und Umwelt
24.12.2022 17:00;80;47;33;Nieselregen;7;5;0.1;Stadt Konstanz, Amt für Stadtplanung und Umwelt
24.12.2022 18:00;70;27;43;Nieselregen;7;5;0.1;Stadt Konstanz, Amt für Stadtplanung und Umwelt
24.12.2022 19:00;37;12;25;Nieselregen;7;5;0;Stadt Konstanz, Amt für Stadtplanung und Umwelt
24.12.2022 20:00;38;11;27;Nieselregen;7;5;0.1;Stadt Konstanz, Amt für Stadtplanung und Umwelt
24.12.2022 21:00;53;31;22;Nieselregen;7;5;0.2;Stadt Konstanz, Amt für Stadtplanung und Umwelt
24.12.2022 22:00;56;33;23;Nieselregen;7;6;0.1;Stadt Konstanz, Amt für Stadtplanung und Umwelt
24.12.2022 23:00;70;36;34;Nieselregen;7;7;0.2;Stadt Konstanz, Amt für Stadtplanung und Umwelt
25.12.2022 00:00;47;19;28;Nieselregen;8;8;0.3;Stadt Konstanz, Amt für Stadtplanung und Umwelt
25.12.2022 01:00;37;20;17;Nieselregen;8;8;0.2;Stadt Konstanz, Amt für Stadtplanung und Umwelt
25.12.2022 02:00;17;3;14;Bedeckt;8;8;0;Stadt Konstanz, Amt für Stadtplanung und Umwelt
25.12.2022 03:00;9;2;7;Bedeckt;8;8;0;Stadt Konstanz, Amt für Stadtplanung und Umwelt
25.12.2022 04:00;4;3;1;Bedeckt;8;8;0;Stadt Konstanz, Amt für Stadtplanung und Umwelt
25.12.2022 05:00;12;5;7;Leicht bewoelkt;8;8;0;Stadt Konstanz, Amt für Stadtplanung und Umwelt
25.12.2022 06:00;19;12;7;Leicht bewoelkt;8;8;0;Stadt Konstanz, Amt für Stadtplanung und Umwelt
25.12.2022 07:00;16;6;10;Leicht bewoelkt;7;7;0;Stadt Konstanz, Amt für Stadtplanung und Umwelt
25.12.2022 08:00;24;7;17;Sonnig;6;5;0;Stadt Konstanz, Amt für Stadtplanung und Umwelt
25.12.2022 09:00;47;25;22;Sonnig;5;4;0;Stadt Konstanz, Amt für Stadtplanung und Umwelt
25.12.2022 10:00;56;30;26;Sonnig;8;7;0;Stadt Konstanz, Amt für Stadtplanung und Umwelt
25.12.2022 11:00;84;38;46;Sonnig;10;9;0;Stadt Konstanz, Amt für Stadtplanung und Umwelt
25.12.2022 12:00;78;35;43;Sonnig;12;12;0;Stadt Konstanz, Amt für Stadtplanung und Umwelt
25.12.2022 13:00;90;49;41;Sonnig;12;12;0;Stadt Konstanz, Amt für Stadtplanung und Umwelt
25.12.2022 14:00;120;64;56;Sonnig;12;12;0;Stadt Konstanz, Amt für Stadtplanung und Umwelt
25.12.2022 15:00;117;52;65;Sonnig;11;11;0;Stadt Konstanz, Amt für Stadtplanung und Umwelt
25.12.2022 16:00;83;37;46;Sonnig;10;10;0;Stadt Konstanz, Amt für Stadtplanung und Umwelt
25.12.2022 17:00;167;92;75;Sonnig;9;8;0;Stadt Konstanz, Amt für Stadtplanung und Umwelt
25.12.2022 18:00;91;44;47;Sonnig;8;7;0;Stadt Konstanz, Amt für Stadtplanung und Umwelt
25.12.2022 19:00;74;35;39;Sonnig;7;6;0;Stadt Konstanz, Amt für Stadtplanung und Umwelt
25.12.2022 20:00;44;22;22;Sonnig;6;5;0;Stadt Konstanz, Amt für Stadtplanung und Umwelt
25.12.2022 21:00;36;25;11;Sonnig;5;4;0;Stadt Konstanz, Amt für Stadtplanung und Umwelt
25.12.2022 22:00;38;12;26;Sonnig;6;4;0;Stadt Konstanz, Amt für Stadtplanung und Umwelt
25.12.2022 23:00;31;11;20;Sonnig;6;4;0;Stadt Konstanz, Amt für Stadtplanung und Umwelt
26.12.2022 00:00;23;9;14;Sonnig;6;5;0;Stadt Konstanz, Amt für Stadtplanung und Umwelt
26.12.2022 01:00;20;10;10;Sonnig;5;4;0;Stadt Konstanz, Amt für Stadtplanung und Umwelt
26.12.2022 02:00;8;2;6;Sonnig;5;4;0;Stadt Konstanz, Amt für Stadtplanung und Umwelt
26.12.2022 03:00;3;2;1;Sonnig;5;4;0;Stadt Konstanz, Amt für Stadtplanung und Umwelt
26.12.2022 04:00;2;2;0;Sonnig;4;3;0;Stadt Konstanz, Amt für Stadtplanung und Umwelt
26.12.2022 05:00;6;2;4;Sonnig;4;3;0;Stadt Konstanz, Amt für Stadtplanung und Umwelt
26.12.2022 06:00;14;8;6;Sonnig;4;2;0;Stadt Konstanz, Amt für Stadtplanung und Umwelt
26.12.2022 07:00;18;10;8;Sonnig;4;2;0;Stadt Konstanz, Amt für Stadtplanung und Umwelt
26.12.2022 08:00;24;11;13;Sonnig;4;2;0;Stadt Konstanz, Amt für Stadtplanung und Umwelt
26.12.2022 09:00;55;40;15;Sonnig;4;3;0;Stadt Konstanz, Amt für Stadtplanung und Umwelt
26.12.2022 10:00;68;32;36;Sonnig;6;5;0;Stadt Konstanz, Amt für Stadtplanung und Umwelt
26.12.2022 11:00;81;37;44;Sonnig;8;6;0;Stadt Konstanz, Amt für Stadtplanung und Umwelt
26.12.2022 12:00;82;36;46;Sonnig;10;8;0;Stadt Konstanz, Amt für Stadtplanung und Umwelt
26.12.2022 13:00;72;37;35;Sonnig;10;9;0;Stadt Konstanz, Amt für Stadtplanung und Umwelt
26.12.2022 14:00;73;48;25;Bedeckt;11;9;0;Stadt Konstanz, Amt für Stadtplanung und Umwelt
26.12.2022 15:00;68;33;35;Bedeckt;12;10;0;Stadt Konstanz, Amt für Stadtplanung und Umwelt
26.12.2022 16:00;97;52;45;Bedeckt;11;9;0;Stadt Konstanz, Amt für Stadtplanung und Umwelt
26.12.2022 17:00;75;33;42;Nieselregen;11;8;0.2;Stadt Konstanz, Amt für Stadtplanung und Umwelt
26.12.2022 18:00;86;41;45;Nieselregen;10;7;0.2;Stadt Konstanz, Amt für Stadtplanung und Umwelt
26.12.2022 19:00;70;37;33;Nieselregen;9;6;0.1;Stadt Konstanz, Amt für Stadtplanung und Umwelt
26.12.2022 20:00;91;42;49;Leichter Regenfall;8;5;0.4;Stadt Konstanz, Amt für Stadtplanung und Umwelt
26.12.2022 21:00;67;25;42;Leichter Regenfall;7;5;0.5;Stadt Konstanz, Amt für Stadtplanung und Umwelt
26.12.2022 22:00;51;17;34;Leichter Regenfall;7;5;0.3;Stadt Konstanz, Amt für Stadtplanung und Umwelt
26.12.2022 23:00;25;5;20;Leichter Regenfall;8;6;0.4;Stadt Konstanz, Amt für Stadtplanung und Umwelt
27.12.2022 00:00;43;25;18;Leichter Regenfall;9;6;0.8;Stadt Konstanz, Amt für Stadtplanung und Umwelt
27.12.2022 01:00;10;5;5;Leichter Regenfall;8;5;0.4;Stadt Konstanz, Amt für Stadtplanung und Umwelt
27.12.2022 02:00;8;4;4;Leichter Regenfall;7;5;0.4;Stadt Konstanz, Amt für Stadtplanung und Umwelt
27.12.2022 03:00;10;9;1;Leichter Regenfall;7;4;0.5;Stadt Konstanz, Amt für Stadtplanung und Umwelt
27.12.2022 04:00;19;17;2;Leichter Regenfall;6;4;0.2;Stadt Konstanz, Amt für Stadtplanung und Umwelt
27.12.2022 05:00;27;20;7;Nieselregen;6;5;0.2;Stadt Konstanz, Amt für Stadtplanung und Umwelt
27.12.2022 06:00;45;33;12;Nieselregen;5;5;0.3;Stadt Konstanz, Amt für Stadtplanung und Umwelt
27.12.2022 07:00;87;50;37;Nieselregen;5;5;0.2;Stadt Konstanz, Amt für Stadtplanung und Umwelt
27.12.2022 08:00;151;99;52;Stellenweiser Regenfall;5;5;0;Stadt Konstanz, Amt für Stadtplanung und Umwelt
27.12.2022 09:00;171;126;45;Stellenweiser Regenfall;5;5;0;Stadt Konstanz, Amt für Stadtplanung und Umwelt
27.12.2022 10:00;268;158;110;Stellenweiser Regenfall;5;5;0;Stadt Konstanz, Amt für Stadtplanung und Umwelt
27.12.2022 11:00;266;149;117;Leicht bewoelkt;6;6;0;Stadt Konstanz, Amt für Stadtplanung und Umwelt
27.12.2022 12:00;280;120;160;Leicht bewoelkt;6;6;0;Stadt Konstanz, Amt für Stadtplanung und Umwelt
27.12.2022 13:00;321;159;162;Leicht bewoelkt;6;6;0;Stadt Konstanz, Amt für Stadtplanung und Umwelt
27.12.2022 14:00;329;159;170;Leicht bewoelkt;6;6;0;Stadt Konstanz, Amt für Stadtplanung und Umwelt
27.12.2022 15:00;305;130;175;Leicht bewoelkt;7;7;0;Stadt Konstanz, Amt für Stadtplanung und Umwelt
27.12.2022 16:00;339;149;190;Leicht bewoelkt;5;5;0;Stadt Konstanz, Amt für Stadtplanung und Umwelt
27.12.2022 17:00;260;87;173;Leicht bewoelkt;4;4;0;Stadt Konstanz, Amt für Stadtplanung und Umwelt
27.12.2022 18:00;257;100;157;Leicht bewoelkt;3;3;0;Stadt Konstanz, Amt für Stadtplanung und Umwelt
27.12.2022 19:00;174;73;101;Leicht bewoelkt;3;3;0;Stadt Konstanz, Amt für Stadtplanung und Umwelt
27.12.2022 20:00;126;55;71;Bewoelkt;2;2;0;Stadt Konstanz, Amt für Stadtplanung und Umwelt
27.12.2022 21:00;83;36;47;Bewoelkt;2;2;0;Stadt Konstanz, Amt für Stadtplanung und Umwelt
27.12.2022 22:00;74;25;49;Bewoelkt;2;1;0;Stadt Konstanz, Amt für Stadtplanung und Umwelt
27.12.2022 23:00;58;27;31;Leicht bewoelkt;1;1;0;Stadt Konstanz, Amt für Stadtplanung und Umwelt
28.12.2022 00:00;34;13;21;Leicht bewoelkt;1;0;0;Stadt Konstanz, Amt für Stadtplanung und Umwelt
28.12.2022 01:00;47;10;37;Leicht bewoelkt;1;0;0;Stadt Konstanz, Amt für Stadtplanung und Umwelt
28.12.2022 02:00;17;7;10;Sonnig;0;0;0;Stadt Konstanz, Amt für Stadtplanung und Umwelt
28.12.2022 03:00;12;4;8;Sonnig;0;-1;0;Stadt Konstanz, Amt für Stadtplanung und Umwelt
28.12.2022 04:00;8;5;3;Sonnig;0;-1;0;Stadt Konstanz, Amt für Stadtplanung und Umwelt
28.12.2022 05:00;30;15;15;Sonnig;0;-1;0;Stadt Konstanz, Amt für Stadtplanung und Umwelt
28.12.2022 06:00;60;43;17;Sonnig;0;-2;0;Stadt Konstanz, Amt für Stadtplanung und Umwelt
28.12.2022 07:00;109;61;48;Sonnig;1;-1;0;Stadt Konstanz, Amt für Stadtplanung und Umwelt
28.12.2022 08:00;116;75;41;Bewoelkt;1;0;0;Stadt Konstanz, Amt für Stadtplanung und Umwelt
28.12.2022 09:00;171;111;60;Bewoelkt;1;1;0;Stadt Konstanz, Amt für Stadtplanung und Umwelt
28.12.2022 10:00;221;131;90;Bewoelkt;3;3;0;Stadt Konstanz, Amt für Stadtplanung und Umwelt
28.12.2022 11:00;240;141;99;Sonnig;5;4;0;Stadt Konstanz, Amt für Stadtplanung und Umwelt
28.12.2022 12:00;279;122;157;Sonnig;7;6;0;Stadt Konstanz, Amt für Stadtplanung und Umwelt
28.12.2022 13:00;288;148;140;Sonnig;7;7;0;Stadt Konstanz, Amt für Stadtplanung und Umwelt
28.12.2022 14:00;314;155;159;Sonnig;8;8;0;Stadt Konstanz, Amt für Stadtplanung und Umwelt
28.12.2022 15:00;345;152;193;Sonnig;9;9;0;Stadt Konstanz, Amt für Stadtplanung und Umwelt
28.12.2022 16:00;365;162;203;Sonnig;7;7;0;Stadt Konstanz, Amt für Stadtplanung und Umwelt
28.12.2022 17:00;327;135;192;Sonnig;6;6;0;Stadt Konstanz, Amt für Stadtplanung und Umwelt
28.12.2022 18:00;279;94;185;Sonnig;5;5;0;Stadt Konstanz, Amt für Stadtplanung und Umwelt
28.12.2022 19:00;202;88;114;Sonnig;3;3;0;Stadt Konstanz, Amt für Stadtplanung und Umwelt
28.12.2022 20:00;131;59;72;Sonnig;2;1;0;Stadt Konstanz, Amt für Stadtplanung und Umwelt
28.12.2022 21:00;115;56;59;Sonnig;1;-1;0;Stadt Konstanz, Amt für Stadtplanung und Umwelt
28.12.2022 22:00;89;38;51;Sonnig;1;-1;0;Stadt Konstanz, Amt für Stadtplanung und Umwelt
28.12.2022 23:00;45;22;23;Sonnig;1;-1;0;Stadt Konstanz, Amt für Stadtplanung und Umwelt
29.12.2022 00:00;49;16;33;Sonnig;1;-1;0;Stadt Konstanz, Amt für Stadtplanung und Umwelt
29.12.2022 01:00;29;6;23;Sonnig;1;-2;0;Stadt Konstanz, Amt für Stadtplanung und Umwelt
29.12.2022 02:00;14;2;12;Sonnig;1;-2;0;Stadt Konstanz, Amt für Stadtplanung und Umwelt
29.12.2022 03:00;16;2;14;Sonnig;1;-2;0;Stadt Konstanz, Amt für Stadtplanung und Umwelt
29.12.2022 04:00;8;4;4;Sonnig;1;-2;0;Stadt Konstanz, Amt für Stadtplanung und Umwelt
29.12.2022 05:00;24;15;9;Leicht bewoelkt;1;-1;0;Stadt Konstanz, Amt für Stadtplanung und Umwelt
29.12.2022 06:00;53;38;15;Leicht bewoelkt;1;-1;0;Stadt Konstanz, Amt für Stadtplanung und Umwelt
29.12.2022 07:00;116;70;46;Leicht bewoelkt;2;-1;0;Stadt Konstanz, Amt für Stadtplanung und Umwelt
29.12.2022 08:00;107;69;38;Bedeckt;2;0;0;Stadt Konstanz, Amt für Stadtplanung und Umwelt
29.12.2022 09:00;195;131;64;Bedeckt;2;0;0;Stadt Konstanz, Amt für Stadtplanung und Umwelt
29.12.2022 10:00;226;143;83;Bedeckt;4;2;0;Stadt Konstanz, Amt für Stadtplanung und Umwelt
29.12.2022 11:00;291;153;138;Sonnig;6;4;0;Stadt Konstanz, Amt für Stadtplanung und Umwelt
29.12.2022 12:00;311;140;171;Sonnig;8;6;0;Stadt Konstanz, Amt für Stadtplanung und Umwelt
29.12.2022 13:00;284;127;157;Sonnig;8;7;0;Stadt Konstanz, Amt für Stadtplanung und Umwelt
29.12.2022 14:00;324;156;168;Sonnig;8;7;0;Stadt Konstanz, Amt für Stadtplanung und Umwelt
29.12.2022 15:00;296;128;168;Sonnig;9;8;0;Stadt Konstanz, Amt für Stadtplanung und Umwelt
29.12.2022 16:00;310;135;175;Sonnig;7;6;0;Stadt Konstanz, Amt für Stadtplanung und Umwelt
29.12.2022 17:00;306;139;167;Leicht bewoelkt;5;4;0;Stadt Konstanz, Amt für Stadtplanung und Umwelt
29.12.2022 18:00;237;98;139;Leicht bewoelkt;4;2;0;Stadt Konstanz, Amt für Stadtplanung und Umwelt
29.12.2022 19:00;131;61;70;Leicht bewoelkt;4;1;0;Stadt Konstanz, Amt für Stadtplanung und Umwelt
29.12.2022 20:00;120;34;86;Sonnig;3;1;0;Stadt Konstanz, Amt für Stadtplanung und Umwelt
29.12.2022 21:00;72;39;33;Sonnig;3;1;0;Stadt Konstanz, Amt für Stadtplanung und Umwelt
29.12.2022 22:00;45;24;21;Sonnig;4;2;0;Stadt Konstanz, Amt für Stadtplanung und Umwelt
29.12.2022 23:00;58;24;34;Stellenweiser Regenfall;5;2;0;Stadt Konstanz, Amt für Stadtplanung und Umwelt
30.12.2022 00:00;38;13;25;Stellenweiser Regenfall;6;3;0.1;Stadt Konstanz, Amt für Stadtplanung und Umwelt
30.12.2022 01:00;29;5;24;Stellenweiser Regenfall;6;3;0;Stadt Konstanz, Amt für Stadtplanung und Umwelt
30.12.2022 02:00;17;3;14;Leichter Regenfall;5;3;0.3;Stadt Konstanz, Amt für Stadtplanung und Umwelt
30.12.2022 03:00;6;2;4;Leichter Regenfall;5;2;0.4;Stadt Konstanz, Amt für Stadtplanung und Umwelt
30.12.2022 04:00;5;4;1;Leichter Regenfall;5;2;0.2;Stadt Konstanz, Amt für Stadtplanung und Umwelt
30.12.2022 05:00;22;15;7;Stellenweiser Nieselregen;5;2;0.2;Stadt Konstanz, Amt für Stadtplanung und Umwelt
30.12.2022 06:00;43;31;12;Stellenweiser Nieselregen;4;3;0.3;Stadt Konstanz, Amt für Stadtplanung und Umwelt
30.12.2022 07:00;104;62;42;Stellenweiser Nieselregen;4;3;0.2;Stadt Konstanz, Amt für Stadtplanung und Umwelt
30.12.2022 08:00;165;103;62;Sonnig;3;3;0;Stadt Konstanz, Amt für Stadtplanung und Umwelt
30.12.2022 09:00;230;156;74;Sonnig;3;3;0;Stadt Konstanz, Amt für Stadtplanung und Umwelt
30.12.2022 10:00;332;197;135;Sonnig;4;4;0;Stadt Konstanz, Amt für Stadtplanung und Umwelt
30.12.2022 11:00;377;229;148;Sonnig;6;6;0;Stadt Konstanz, Amt für Stadtplanung und Umwelt
30.12.2022 12:00;377;169;208;Sonnig;8;8;0;Stadt Konstanz, Amt für Stadtplanung und Umwelt
30.12.2022 13:00;448;239;209;Sonnig;8;8;0;Stadt Konstanz, Amt für Stadtplanung und Umwelt
30.12.2022 14:00;406;177;229;Sonnig;8;8;0;Stadt Konstanz, Amt für Stadtplanung und Umwelt
30.12.2022 15:00;328;150;178;Sonnig;8;7;0;Stadt Konstanz, Amt für Stadtplanung und Umwelt
30.12.2022 16:00;305;97;208;Sonnig;7;6;0;Stadt Konstanz, Amt für Stadtplanung und Umwelt
30.12.2022 17:00;235;109;126;Bedeckt;6;5;0;Stadt Konstanz, Amt für Stadtplanung und Umwelt
30.12.2022 18:00;221;106;115;Bedeckt;5;4;0;Stadt Konstanz, Amt für Stadtplanung und Umwelt
30.12.2022 19:00;153;67;86;Bedeckt;6;4;0;Stadt Konstanz, Amt für Stadtplanung und Umwelt
30.12.2022 20:00;111;47;64;Bedeckt;6;4;0;Stadt Konstanz, Amt für Stadtplanung und Umwelt
30.12.2022 21:00;131;54;77;Bedeckt;6;4;0;Stadt Konstanz, Amt für Stadtplanung und Umwelt
30.12.2022 22:00;76;41;35;Bedeckt;6;4;0;Stadt Konstanz, Amt für Stadtplanung und Umwelt
30.12.2022 23:00;65;18;47;Nieselregen;7;4;0.1;Stadt Konstanz, Amt für Stadtplanung und Umwelt
31.12.2022 00:00;41;18;23;Nieselregen;7;5;0.1;Stadt Konstanz, Amt für Stadtplanung und Umwelt
31.12.2022 01:00;43;12;31;Nieselregen;8;5;0.1;Stadt Konstanz, Amt für Stadtplanung und Umwelt
31.12.2022 02:00;24;2;22;Bewoelkt;8;6;0;Stadt Konstanz, Amt für Stadtplanung und Umwelt
31.12.2022 03:00;14;2;12;Bewoelkt;9;7;0;Stadt Konstanz, Amt für Stadtplanung und Umwelt
31.12.2022 04:00;15;7;8;Bewoelkt;9;6;0;Stadt Konstanz, Amt für Stadtplanung und Umwelt
31.12.2022 05:00;12;7;5;Leicht bewoelkt;8;6;0;Stadt Konstanz, Amt für Stadtplanung und Umwelt
31.12.2022 06:00;30;13;17;Leicht bewoelkt;8;6;0;Stadt Konstanz, Amt für Stadtplanung und Umwelt
31.12.2022 07:00;46;24;22;Leicht bewoelkt;8;6;0;Stadt Konstanz, Amt für Stadtplanung und Umwelt
31.12.2022 08:00;92;54;38;Leicht bewoelkt;8;6;0;Stadt Konstanz, Amt für Stadtplanung und Umwelt
31.12.2022 09:00;175;98;77;Leicht bewoelkt;8;7;0;Stadt Konstanz, Amt für Stadtplanung und Umwelt
31.12.2022 10:00;244;133;111;Leicht bewoelkt;9;8;0;Stadt Konstanz, Amt für Stadtplanung und Umwelt
31.12.2022 11:00;328;166;162;Leicht bewoelkt;10;9;0;Stadt Konstanz, Amt für Stadtplanung und Umwelt
31.12.2022 12:00;325;156;169;Leicht bewoelkt;11;10;0;Stadt Konstanz, Amt für Stadtplanung und Umwelt
31.12.2022 13:00;285;119;166;Leicht bewoelkt;11;11;0;Stadt Konstanz, Amt für Stadtplanung und Umwelt
31.12.2022 14:00;310;139;171;Sonnig;12;12;0;Stadt Konstanz, Amt für Stadtplanung und Umwelt
31.12.2022 15:00;315;147;168;Sonnig;13;13;0;Stadt Konstanz, Amt für Stadtplanung und Umwelt
31.12.2022 16:00;235;96;139;Sonnig;11;11;0;Stadt Konstanz, Amt für Stadtplanung und Umwelt
31.12.2022 17:00;225;121;104;Sonnig;10;10;0;Stadt Konstanz, Amt für Stadtplanung und Umwelt
31.12.2022 18:00;234;121;113;Sonnig;9;8;0;Stadt Konstanz, Amt für Stadtplanung und Umwelt
31.12.2022 19:00;242;120;122;Sonnig;8;7;0;Stadt Konstanz, Amt für Stadtplanung und Umwelt
31.12.2022 20:00;127;60;67;Sonnig;7;7;0;Stadt Konstanz, Amt für Stadtplanung und Umwelt
31.12.2022 21:00;91;51;40;Sonnig;7;6;0;Stadt Konstanz, Amt für Stadtplanung und Umwelt
31.12.2022 22:00;66;23;43;Sonnig;6;5;0;Stadt Konstanz, Amt für Stadtplanung und Umwelt
31.12.2022 23:00;91;41;50;Sonnig;6;5;0;Stadt Konstanz, Amt für Stadtplanung und Umwelt
