Zeit;Fahrradbruecke;Fahrradbruecke stadteinwaerts Fahrraeder;Fahrradbruecke stadtauswaerts Fahrraeder;Symbol Wetter;Temperatur (°C);Gefuehlte Temperatur (°C);Regen (mm);Quelle
01.01.2023 00:00;69;25;44;Sonnig;6;4;0;Stadt Konstanz, Amt fuer Stadtplanung und Umwelt
01.01.2023 01:00;190;80;110;Sonnig;5;4;0;Stadt Konstanz, Amt fuer Stadtplanung und Umwelt
01.01.2023 02:00;183;83;100;Sonnig;5;4;0;Stadt Konstanz, Amt fuer Stadtplanung und Umwelt
01.01.2023 03:00;135;59;76;Sonnig;5;4;0;Stadt Konstanz, Amt fuer Stadtplanung und Umwelt
01.01.2023 04:00;93;43;50;Sonnig;5;4;0;Stadt Konstanz, Amt fuer Stadtplanung und Umwelt
01.01.2023 05:00;42;16;26;Sonnig;5;3;0;Stadt Konstanz, Amt fuer Stadtplanung und Umwelt
01.01.2023 06:00;42;20;22;Sonnig;5;3;0;Stadt Konstanz, Amt fuer Stadtplanung und Umwelt
01.01.2023 07:00;17;5;12;Sonnig;5;3;0;Stadt Konstanz, Amt fuer Stadtplanung und Umwelt
01.01.2023 08:00;36;18;18;Sonnig;5;4;0;Stadt Konstanz, Amt fuer Stadtplanung und Umwelt
01.01.2023 09:00;47;23;24;Sonnig;5;4;0;Stadt Konstanz, Amt fuer Stadtplanung und Umwelt
01.01.2023 10:00;107;50;57;Sonnig;7;7;0;Stadt Konstanz, Amt fuer Stadtplanung und Umwelt
01.01.2023 11:00;98;45;53;Sonnig;10;10;0;Stadt Konstanz, Amt fuer Stadtplanung und Umwelt
01.01.2023 12:00;158;65;93;Sonnig;12;13;0;Stadt Konstanz, Amt fuer Stadtplanung und Umwelt
01.01.2023 13:00;216;112;104;Sonnig;12;12;0;Stadt Konstanz, Amt fuer Stadtplanung und Umwelt
01.01.2023 14:00;237;125;112;Sonnig;11;11;0;Stadt Konstanz, Amt fuer Stadtplanung und Umwelt
01.01.2023 15:00;236;120;116;Sonnig;11;11;0;Stadt Konstanz, Amt fuer Stadtplanung und Umwelt
01.01.2023 16:00;245;102;143;Sonnig;10;10;0;Stadt Konstanz, Amt fuer Stadtplanung und Umwelt
01.01.2023 17:00;162;90;72;Bedeckt;8;8;0;Stadt Konstanz, Amt fuer Stadtplanung und Umwelt
01.01.2023 18:00;120;48;72;Bedeckt;7;7;0;Stadt Konstanz, Amt fuer Stadtplanung und Umwelt
01.01.2023 19:00;87;43;44;Bedeckt;7;7;0;Stadt Konstanz, Amt fuer Stadtplanung und Umwelt
01.01.2023 20:00;87;38;49;Bedeckt;7;7;0;Stadt Konstanz, Amt fuer Stadtplanung und Umwelt
01.01.2023 21:00;47;25;22;Bedeckt;6;6;0;Stadt Konstanz, Amt fuer Stadtplanung und Umwelt
01.01.2023 22:00;48;32;16;Bedeckt;6;6;0;Stadt Konstanz, Amt fuer Stadtplanung und Umwelt
01.01.2023 23:00;25;8;17;Sonnig;6;6;0;Stadt Konstanz, Amt fuer Stadtplanung und Umwelt
02.01.2023 00:00;13;6;7;Sonnig;6;5;0;Stadt Konstanz, Amt fuer Stadtplanung und Umwelt
02.01.2023 01:00;6;3;3;Sonnig;5;5;0;Stadt Konstanz, Amt fuer Stadtplanung und Umwelt
02.01.2023 02:00;3;1;2;Sonnig;5;5;0;Stadt Konstanz, Amt fuer Stadtplanung und Umwelt
02.01.2023 03:00;7;1;6;Sonnig;5;5;0;Stadt Konstanz, Amt fuer Stadtplanung und Umwelt
02.01.2023 04:00;8;6;2;Sonnig;5;4;0;Stadt Konstanz, Amt fuer Stadtplanung und Umwelt
02.01.2023 05:00;30;16;14;Sonnig;5;4;0;Stadt Konstanz, Amt fuer Stadtplanung und Umwelt
02.01.2023 06:00;83;48;35;Sonnig;5;4;0;Stadt Konstanz, Amt fuer Stadtplanung und Umwelt
02.01.2023 07:00;172;84;88;Sonnig;5;4;0;Stadt Konstanz, Amt fuer Stadtplanung und Umwelt
02.01.2023 08:00;232;133;99;Sonnig;5;5;0;Stadt Konstanz, Amt fuer Stadtplanung und Umwelt
02.01.2023 09:00;285;182;103;Sonnig;5;5;0;Stadt Konstanz, Amt fuer Stadtplanung und Umwelt
02.01.2023 10:00;281;163;118;Sonnig;7;7;0;Stadt Konstanz, Amt fuer Stadtplanung und Umwelt
02.01.2023 11:00;324;152;172;Sonnig;9;9;0;Stadt Konstanz, Amt fuer Stadtplanung und Umwelt
02.01.2023 12:00;376;190;186;Sonnig;11;10;0;Stadt Konstanz, Amt fuer Stadtplanung und Umwelt
02.01.2023 13:00;353;163;190;Sonnig;10;10;0;Stadt Konstanz, Amt fuer Stadtplanung und Umwelt
02.01.2023 14:00;421;221;200;Sonnig;10;10;0;Stadt Konstanz, Amt fuer Stadtplanung und Umwelt
02.01.2023 15:00;443;206;237;Sonnig;10;10;0;Stadt Konstanz, Amt fuer Stadtplanung und Umwelt
02.01.2023 16:00;451;203;248;Sonnig;9;9;0;Stadt Konstanz, Amt fuer Stadtplanung und Umwelt
02.01.2023 17:00;449;206;243;Sonnig;8;8;0;Stadt Konstanz, Amt fuer Stadtplanung und Umwelt
02.01.2023 18:00;279;115;164;Sonnig;7;7;0;Stadt Konstanz, Amt fuer Stadtplanung und Umwelt
02.01.2023 19:00;223;102;121;Sonnig;7;7;0;Stadt Konstanz, Amt fuer Stadtplanung und Umwelt
02.01.2023 20:00;132;63;69;Bedeckt;7;6;0;Stadt Konstanz, Amt fuer Stadtplanung und Umwelt
02.01.2023 21:00;122;40;82;Bedeckt;7;6;0;Stadt Konstanz, Amt fuer Stadtplanung und Umwelt
02.01.2023 22:00;53;23;30;Bedeckt;7;7;0;Stadt Konstanz, Amt fuer Stadtplanung und Umwelt
02.01.2023 23:00;53;36;17;Stellenweiser Regenfall;8;7;0;Stadt Konstanz, Amt fuer Stadtplanung und Umwelt
03.01.2023 00:00;41;9;32;Stellenweiser Regenfall;8;7;0.1;Stadt Konstanz, Amt fuer Stadtplanung und Umwelt
03.01.2023 01:00;10;4;6;Stellenweiser Regenfall;8;7;0;Stadt Konstanz, Amt fuer Stadtplanung und Umwelt
03.01.2023 02:00;7;3;4;Nieselregen;8;6;0.2;Stadt Konstanz, Amt fuer Stadtplanung und Umwelt
03.01.2023 03:00;11;8;3;Nieselregen;7;6;0.3;Stadt Konstanz, Amt fuer Stadtplanung und Umwelt
03.01.2023 04:00;6;5;1;Nieselregen;7;6;0.2;Stadt Konstanz, Amt fuer Stadtplanung und Umwelt
03.01.2023 05:00;34;23;11;Nieselregen;7;6;0.1;Stadt Konstanz, Amt fuer Stadtplanung und Umwelt
03.01.2023 06:00;86;54;32;Nieselregen;7;6;0.1;Stadt Konstanz, Amt fuer Stadtplanung und Umwelt
03.01.2023 07:00;192;127;65;Nieselregen;7;6;0.1;Stadt Konstanz, Amt fuer Stadtplanung und Umwelt
03.01.2023 08:00;261;135;126;Bewoelkt;7;6;0;Stadt Konstanz, Amt fuer Stadtplanung und Umwelt
03.01.2023 09:00;220;133;87;Bewoelkt;7;7;0;Stadt Konstanz, Amt fuer Stadtplanung und Umwelt
03.01.2023 10:00;220;136;84;Bewoelkt;8;8;0;Stadt Konstanz, Amt fuer Stadtplanung und Umwelt
03.01.2023 11:00;240;129;111;Leicht bewoelkt;9;9;0;Stadt Konstanz, Amt fuer Stadtplanung und Umwelt
03.01.2023 12:00;278;129;149;Leicht bewoelkt;9;9;0;Stadt Konstanz, Amt fuer Stadtplanung und Umwelt
03.01.2023 13:00;270;122;148;Leicht bewoelkt;10;10;0;Stadt Konstanz, Amt fuer Stadtplanung und Umwelt
03.01.2023 14:00;264;137;127;Sonnig;10;10;0;Stadt Konstanz, Amt fuer Stadtplanung und Umwelt
03.01.2023 15:00;316;131;185;Sonnig;10;10;0;Stadt Konstanz, Amt fuer Stadtplanung und Umwelt
03.01.2023 16:00;410;184;226;Sonnig;9;9;0;Stadt Konstanz, Amt fuer Stadtplanung und Umwelt
03.01.2023 17:00;412;184;228;Sonnig;7;7;0;Stadt Konstanz, Amt fuer Stadtplanung und Umwelt
03.01.2023 18:00;323;121;202;Sonnig;6;6;0;Stadt Konstanz, Amt fuer Stadtplanung und Umwelt
03.01.2023 19:00;201;90;111;Sonnig;5;5;0;Stadt Konstanz, Amt fuer Stadtplanung und Umwelt
03.01.2023 20:00;172;84;88;Sonnig;4;4;0;Stadt Konstanz, Amt fuer Stadtplanung und Umwelt
03.01.2023 21:00;118;52;66;Sonnig;3;3;0;Stadt Konstanz, Amt fuer Stadtplanung und Umwelt
03.01.2023 22:00;64;27;37;Sonnig;3;3;0;Stadt Konstanz, Amt fuer Stadtplanung und Umwelt
03.01.2023 23:00;60;25;35;Leichter Nebel;3;3;0;Stadt Konstanz, Amt fuer Stadtplanung und Umwelt
04.01.2023 00:00;38;12;26;Leichter Nebel;3;3;0;Stadt Konstanz, Amt fuer Stadtplanung und Umwelt
04.01.2023 01:00;19;2;17;Leichter Nebel;3;3;0;Stadt Konstanz, Amt fuer Stadtplanung und Umwelt
04.01.2023 02:00;7;0;7;Leichter Nebel;3;3;0;Stadt Konstanz, Amt fuer Stadtplanung und Umwelt
04.01.2023 03:00;7;3;4;Leichter Nebel;3;3;0;Stadt Konstanz, Amt fuer Stadtplanung und Umwelt
04.01.2023 04:00;5;3;2;Leichter Nebel;2;2;0;Stadt Konstanz, Amt fuer Stadtplanung und Umwelt
04.01.2023 05:00;31;21;10;Leichter Nebel;2;2;0;Stadt Konstanz, Amt fuer Stadtplanung und Umwelt
04.01.2023 06:00;115;69;46;Leichter Nebel;2;2;0;Stadt Konstanz, Amt fuer Stadtplanung und Umwelt
04.01.2023 07:00;223;129;94;Leichter Nebel;2;1;0;Stadt Konstanz, Amt fuer Stadtplanung und Umwelt
04.01.2023 08:00;298;169;129;Sonnig;2;1;0;Stadt Konstanz, Amt fuer Stadtplanung und Umwelt
04.01.2023 09:00;309;183;126;Sonnig;2;1;0;Stadt Konstanz, Amt fuer Stadtplanung und Umwelt
04.01.2023 10:00;307;180;127;Sonnig;4;3;0;Stadt Konstanz, Amt fuer Stadtplanung und Umwelt
04.01.2023 11:00;317;166;151;Sonnig;7;5;0;Stadt Konstanz, Amt fuer Stadtplanung und Umwelt
04.01.2023 12:00;363;176;187;Sonnig;9;8;0;Stadt Konstanz, Amt fuer Stadtplanung und Umwelt
04.01.2023 13:00;342;168;174;Sonnig;9;7;0;Stadt Konstanz, Amt fuer Stadtplanung und Umwelt
04.01.2023 14:00;390;209;181;Leicht bewoelkt;9;7;0;Stadt Konstanz, Amt fuer Stadtplanung und Umwelt
04.01.2023 15:00;417;192;225;Leicht bewoelkt;9;7;0;Stadt Konstanz, Amt fuer Stadtplanung und Umwelt
04.01.2023 16:00;487;209;278;Leicht bewoelkt;8;6;0;Stadt Konstanz, Amt fuer Stadtplanung und Umwelt
04.01.2023 17:00;501;234;267;Bewoelkt;8;6;0;Stadt Konstanz, Amt fuer Stadtplanung und Umwelt
04.01.2023 18:00;429;179;250;Bewoelkt;7;5;0;Stadt Konstanz, Amt fuer Stadtplanung und Umwelt
04.01.2023 19:00;258;129;129;Bewoelkt;7;5;0;Stadt Konstanz, Amt fuer Stadtplanung und Umwelt
04.01.2023 20:00;180;85;95;Sonnig;7;5;0;Stadt Konstanz, Amt fuer Stadtplanung und Umwelt
04.01.2023 21:00;132;56;76;Sonnig;7;4;0;Stadt Konstanz, Amt fuer Stadtplanung und Umwelt
04.01.2023 22:00;110;47;63;Sonnig;7;5;0;Stadt Konstanz, Amt fuer Stadtplanung und Umwelt
04.01.2023 23:00;86;37;49;Bedeckt;7;5;0;Stadt Konstanz, Amt fuer Stadtplanung und Umwelt
05.01.2023 00:00;35;11;24;Bedeckt;8;5;0;Stadt Konstanz, Amt fuer Stadtplanung und Umwelt
05.01.2023 01:00;21;8;13;Bedeckt;8;5;0;Stadt Konstanz, Amt fuer Stadtplanung und Umwelt
05.01.2023 02:00;17;8;9;Bewoelkt;7;5;0;Stadt Konstanz, Amt fuer Stadtplanung und Umwelt
05.01.2023 03:00;6;3;3;Bewoelkt;7;5;0;Stadt Konstanz, Amt fuer Stadtplanung und Umwelt
05.01.2023 04:00;13;8;5;Bewoelkt;8;5;0;Stadt Konstanz, Amt fuer Stadtplanung und Umwelt
05.01.2023 05:00;23;18;5;Bewoelkt;8;5;0;Stadt Konstanz, Amt fuer Stadtplanung und Umwelt
05.01.2023 06:00;110;66;44;Bewoelkt;8;6;0;Stadt Konstanz, Amt fuer Stadtplanung und Umwelt
05.01.2023 07:00;232;142;90;Bewoelkt;8;5;0;Stadt Konstanz, Amt fuer Stadtplanung und Umwelt
05.01.2023 08:00;300;162;138;Nieselregen;8;5;0.1;Stadt Konstanz, Amt fuer Stadtplanung und Umwelt
05.01.2023 09:00;285;173;112;Nieselregen;7;5;0.2;Stadt Konstanz, Amt fuer Stadtplanung und Umwelt
05.01.2023 10:00;307;189;118;Nieselregen;8;5;0.1;Stadt Konstanz, Amt fuer Stadtplanung und Umwelt
05.01.2023 11:00;320;167;153;Nieselregen;8;6;0.2;Stadt Konstanz, Amt fuer Stadtplanung und Umwelt
05.01.2023 12:00;404;198;206;Nieselregen;8;6;0.2;Stadt Konstanz, Amt fuer Stadtplanung und Umwelt
05.01.2023 13:00;424;204;220;Nieselregen;8;7;0.1;Stadt Konstanz, Amt fuer Stadtplanung und Umwelt
05.01.2023 14:00;399;175;224;Bewoelkt;9;7;0;Stadt Konstanz, Amt fuer Stadtplanung und Umwelt
05.01.2023 15:00;451;201;250;Bewoelkt;9;8;0;Stadt Konstanz, Amt fuer Stadtplanung und Umwelt
05.01.2023 16:00;492;230;262;Bewoelkt;9;7;0;Stadt Konstanz, Amt fuer Stadtplanung und Umwelt
05.01.2023 17:00;476;206;270;Leicht bewoelkt;8;7;0;Stadt Konstanz, Amt fuer Stadtplanung und Umwelt
05.01.2023 18:00;415;169;246;Leicht bewoelkt;8;6;0;Stadt Konstanz, Amt fuer Stadtplanung und Umwelt
05.01.2023 19:00;283;133;150;Leicht bewoelkt;7;7;0;Stadt Konstanz, Amt fuer Stadtplanung und Umwelt
05.01.2023 20:00;201;95;106;Leicht bewoelkt;7;7;0;Stadt Konstanz, Amt fuer Stadtplanung und Umwelt
05.01.2023 21:00;126;56;70;Leicht bewoelkt;7;7;0;Stadt Konstanz, Amt fuer Stadtplanung und Umwelt
05.01.2023 22:00;132;52;80;Leicht bewoelkt;7;7;0;Stadt Konstanz, Amt fuer Stadtplanung und Umwelt
05.01.2023 23:00;109;37;72;Sonnig;7;7;0;Stadt Konstanz, Amt fuer Stadtplanung und Umwelt
06.01.2023 00:00;67;19;48;Sonnig;7;7;0;Stadt Konstanz, Amt fuer Stadtplanung und Umwelt
06.01.2023 01:00;41;17;24;Sonnig;7;6;0;Stadt Konstanz, Amt fuer Stadtplanung und Umwelt
06.01.2023 02:00;19;5;14;Leicht bewoelkt;6;6;0;Stadt Konstanz, Amt fuer Stadtplanung und Umwelt
06.01.2023 03:00;7;1;6;Leicht bewoelkt;5;5;0;Stadt Konstanz, Amt fuer Stadtplanung und Umwelt
06.01.2023 04:00;13;9;4;Leicht bewoelkt;5;5;0;Stadt Konstanz, Amt fuer Stadtplanung und Umwelt
06.01.2023 05:00;17;11;6;Sonnig;5;5;0;Stadt Konstanz, Amt fuer Stadtplanung und Umwelt
06.01.2023 06:00;43;34;9;Sonnig;5;5;0;Stadt Konstanz, Amt fuer Stadtplanung und Umwelt
06.01.2023 07:00;63;47;16;Sonnig;4;4;0;Stadt Konstanz, Amt fuer Stadtplanung und Umwelt
06.01.2023 08:00;70;41;29;Sonnig;4;4;0;Stadt Konstanz, Amt fuer Stadtplanung und Umwelt
06.01.2023 09:00;108;65;43;Sonnig;4;4;0;Stadt Konstanz, Amt fuer Stadtplanung und Umwelt
06.01.2023 10:00;149;83;66;Sonnig;6;5;0;Stadt Konstanz, Amt fuer Stadtplanung und Umwelt
06.01.2023 11:00;188;101;87;Bewoelkt;7;7;0;Stadt Konstanz, Amt fuer Stadtplanung und Umwelt
06.01.2023 12:00;218;105;113;Bewoelkt;9;8;0;Stadt Konstanz, Amt fuer Stadtplanung und Umwelt
06.01.2023 13:00;213;110;103;Bewoelkt;9;8;0;Stadt Konstanz, Amt fuer Stadtplanung und Umwelt
06.01.2023 14:00;285;120;165;Leicht bewoelkt;10;9;0;Stadt Konstanz, Amt fuer Stadtplanung und Umwelt
06.01.2023 15:00;245;126;119;Leicht bewoelkt;10;9;0;Stadt Konstanz, Amt fuer Stadtplanung und Umwelt
06.01.2023 16:00;305;138;167;Leicht bewoelkt;9;8;0;Stadt Konstanz, Amt fuer Stadtplanung und Umwelt
06.01.2023 17:00;263;122;141;Leicht bewoelkt;8;7;0;Stadt Konstanz, Amt fuer Stadtplanung und Umwelt
06.01.2023 18:00;237;135;102;Leicht bewoelkt;7;7;0;Stadt Konstanz, Amt fuer Stadtplanung und Umwelt
06.01.2023 19:00;231;129;102;Leicht bewoelkt;7;6;0;Stadt Konstanz, Amt fuer Stadtplanung und Umwelt
06.01.2023 20:00;150;80;70;Leicht bewoelkt;6;6;0;Stadt Konstanz, Amt fuer Stadtplanung und Umwelt
06.01.2023 21:00;153;87;66;Leicht bewoelkt;6;6;0;Stadt Konstanz, Amt fuer Stadtplanung und Umwelt
06.01.2023 22:00;104;47;57;Leicht bewoelkt;5;5;0;Stadt Konstanz, Amt fuer Stadtplanung und Umwelt
06.01.2023 23:00;99;23;76;Sonnig;5;5;0;Stadt Konstanz, Amt fuer Stadtplanung und Umwelt
07.01.2023 00:00;99;30;69;Sonnig;5;5;0;Stadt Konstanz, Amt fuer Stadtplanung und Umwelt
07.01.2023 01:00;38;18;20;Sonnig;4;4;0;Stadt Konstanz, Amt fuer Stadtplanung und Umwelt
07.01.2023 02:00;28;7;21;Sonnig;4;4;0;Stadt Konstanz, Amt fuer Stadtplanung und Umwelt
07.01.2023 03:00;24;6;18;Sonnig;4;4;0;Stadt Konstanz, Amt fuer Stadtplanung und Umwelt
07.01.2023 04:00;19;10;9;Sonnig;4;4;0;Stadt Konstanz, Amt fuer Stadtplanung und Umwelt
07.01.2023 05:00;36;27;9;Leicht bewoelkt;3;3;0;Stadt Konstanz, Amt fuer Stadtplanung und Umwelt
07.01.2023 06:00;32;16;16;Leicht bewoelkt;3;3;0;Stadt Konstanz, Amt fuer Stadtplanung und Umwelt
07.01.2023 07:00;67;38;29;Leicht bewoelkt;3;3;0;Stadt Konstanz, Amt fuer Stadtplanung und Umwelt
07.01.2023 08:00;119;67;52;Bedeckt;3;3;0;Stadt Konstanz, Amt fuer Stadtplanung und Umwelt
07.01.2023 09:00;252;141;111;Bedeckt;3;3;0;Stadt Konstanz, Amt fuer Stadtplanung und Umwelt
07.01.2023 10:00;311;178;133;Bedeckt;5;5;0;Stadt Konstanz, Amt fuer Stadtplanung und Umwelt
07.01.2023 11:00;360;197;163;Leicht bewoelkt;7;7;0;Stadt Konstanz, Amt fuer Stadtplanung und Umwelt
07.01.2023 12:00;393;204;189;Leicht bewoelkt;9;9;0;Stadt Konstanz, Amt fuer Stadtplanung und Umwelt
07.01.2023 13:00;445;217;228;Leicht bewoelkt;9;9;0;Stadt Konstanz, Amt fuer Stadtplanung und Umwelt
07.01.2023 14:00;508;242;266;Bedeckt;9;9;0;Stadt Konstanz, Amt fuer Stadtplanung und Umwelt
07.01.2023 15:00;497;253;244;Bedeckt;9;9;0;Stadt Konstanz, Amt fuer Stadtplanung und Umwelt
07.01.2023 16:00;443;199;244;Bedeckt;7;7;0;Stadt Konstanz, Amt fuer Stadtplanung und Umwelt
07.01.2023 17:00;401;188;213;Bewoelkt;6;6;0;Stadt Konstanz, Amt fuer Stadtplanung und Umwelt
07.01.2023 18:00;352;155;197;Bewoelkt;4;4;0;Stadt Konstanz, Amt fuer Stadtplanung und Umwelt
07.01.2023 19:00;254;127;127;Bewoelkt;4;3;0;Stadt Konstanz, Amt fuer Stadtplanung und Umwelt
07.01.2023 20:00;176;81;95;Sonnig;3;3;0;Stadt Konstanz, Amt fuer Stadtplanung und Umwelt
07.01.2023 21:00;142;76;66;Sonnig;3;2;0;Stadt Konstanz, Amt fuer Stadtplanung und Umwelt
07.01.2023 22:00;133;65;68;Sonnig;3;2;0;Stadt Konstanz, Amt fuer Stadtplanung und Umwelt
07.01.2023 23:00;118;38;80;Bewoelkt;3;1;0;Stadt Konstanz, Amt fuer Stadtplanung und Umwelt
08.01.2023 00:00;109;34;75;Bewoelkt;3;1;0;Stadt Konstanz, Amt fuer Stadtplanung und Umwelt
08.01.2023 01:00;89;19;70;Bewoelkt;3;1;0;Stadt Konstanz, Amt fuer Stadtplanung und Umwelt
08.01.2023 02:00;57;16;41;Sonnig;3;1;0;Stadt Konstanz, Amt fuer Stadtplanung und Umwelt
08.01.2023 03:00;40;19;21;Sonnig;3;2;0;Stadt Konstanz, Amt fuer Stadtplanung und Umwelt
08.01.2023 04:00;15;9;6;Sonnig;2;2;0;Stadt Konstanz, Amt fuer Stadtplanung und Umwelt
08.01.2023 05:00;24;13;11;Leicht bewoelkt;2;2;0;Stadt Konstanz, Amt fuer Stadtplanung und Umwelt
08.01.2023 06:00;22;13;9;Leicht bewoelkt;2;2;0;Stadt Konstanz, Amt fuer Stadtplanung und Umwelt
08.01.2023 07:00;19;11;8;Leicht bewoelkt;2;2;0;Stadt Konstanz, Amt fuer Stadtplanung und Umwelt
08.01.2023 08:00;52;22;30;Bedeckt;2;2;0;Stadt Konstanz, Amt fuer Stadtplanung und Umwelt
08.01.2023 09:00;116;58;58;Bedeckt;2;2;0;Stadt Konstanz, Amt fuer Stadtplanung und Umwelt
08.01.2023 10:00;123;72;51;Bedeckt;4;4;0;Stadt Konstanz, Amt fuer Stadtplanung und Umwelt
08.01.2023 11:00;122;58;64;Bedeckt;6;5;0;Stadt Konstanz, Amt fuer Stadtplanung und Umwelt
08.01.2023 12:00;146;72;74;Bedeckt;7;7;0;Stadt Konstanz, Amt fuer Stadtplanung und Umwelt
08.01.2023 13:00;152;71;81;Bedeckt;7;7;0;Stadt Konstanz, Amt fuer Stadtplanung und Umwelt
08.01.2023 14:00;161;81;80;Sonnig;7;7;0;Stadt Konstanz, Amt fuer Stadtplanung und Umwelt
08.01.2023 15:00;158;78;80;Sonnig;7;7;0;Stadt Konstanz, Amt fuer Stadtplanung und Umwelt
08.01.2023 16:00;224;113;111;Sonnig;6;5;0;Stadt Konstanz, Amt fuer Stadtplanung und Umwelt
08.01.2023 17:00;208;105;103;Bedeckt;5;4;0;Stadt Konstanz, Amt fuer Stadtplanung und Umwelt
08.01.2023 18:00;143;68;75;Bedeckt;4;3;0;Stadt Konstanz, Amt fuer Stadtplanung und Umwelt
08.01.2023 19:00;147;79;68;Bedeckt;4;2;0;Stadt Konstanz, Amt fuer Stadtplanung und Umwelt
08.01.2023 20:00;114;64;50;Stellenweiser Regenfall;4;2;0;Stadt Konstanz, Amt fuer Stadtplanung und Umwelt
08.01.2023 21:00;90;46;44;Stellenweiser Regenfall;4;2;0;Stadt Konstanz, Amt fuer Stadtplanung und Umwelt
08.01.2023 22:00;44;23;21;Stellenweiser Regenfall;4;2;0;Stadt Konstanz, Amt fuer Stadtplanung und Umwelt
08.01.2023 23:00;33;13;20;Nieselregen;5;3;0.1;Stadt Konstanz, Amt fuer Stadtplanung und Umwelt
09.01.2023 00:00;23;5;18;Nieselregen;5;4;0.1;Stadt Konstanz, Amt fuer Stadtplanung und Umwelt
09.01.2023 01:00;11;2;9;Nieselregen;5;3;0;Stadt Konstanz, Amt fuer Stadtplanung und Umwelt
09.01.2023 02:00;3;0;3;Leichter Regenfall;5;3;0.5;Stadt Konstanz, Amt fuer Stadtplanung und Umwelt
09.01.2023 03:00;3;1;2;Leichter Regenfall;5;2;0.7;Stadt Konstanz, Amt fuer Stadtplanung und Umwelt
09.01.2023 04:00;10;5;5;Leichter Regenfall;5;2;0.4;Stadt Konstanz, Amt fuer Stadtplanung und Umwelt
09.01.2023 05:00;37;20;17;Leichter Regenfall;5;2;0.3;Stadt Konstanz, Amt fuer Stadtplanung und Umwelt
09.01.2023 06:00;154;86;68;Leichter Regenfall;5;2;0.4;Stadt Konstanz, Amt fuer Stadtplanung und Umwelt
09.01.2023 07:00;877;517;360;Leichter Regenfall;5;2;0.2;Stadt Konstanz, Amt fuer Stadtplanung und Umwelt
09.01.2023 08:00;688;384;304;Nieselregen;5;1;0.1;Stadt Konstanz, Amt fuer Stadtplanung und Umwelt
09.01.2023 09:00;625;349;276;Nieselregen;5;0;0.2;Stadt Konstanz, Amt fuer Stadtplanung und Umwelt
09.01.2023 10:00;331;167;164;Nieselregen;5;1;0.1;Stadt Konstanz, Amt fuer Stadtplanung und Umwelt
09.01.2023 11:00;448;250;198;Stellenweiser Regenfall;6;2;0.1;Stadt Konstanz, Amt fuer Stadtplanung und Umwelt
09.01.2023 12:00;490;221;269;Stellenweiser Regenfall;6;2;0.1;Stadt Konstanz, Amt fuer Stadtplanung und Umwelt
09.01.2023 13:00;705;291;414;Stellenweiser Regenfall;6;3;0.1;Stadt Konstanz, Amt fuer Stadtplanung und Umwelt
09.01.2023 14:00;475;238;237;Leicht bewoelkt;6;3;0;Stadt Konstanz, Amt fuer Stadtplanung und Umwelt
09.01.2023 15:00;823;392;431;Leicht bewoelkt;7;3;0;Stadt Konstanz, Amt fuer Stadtplanung und Umwelt
09.01.2023 16:00;699;318;381;Leicht bewoelkt;5;2;0;Stadt Konstanz, Amt fuer Stadtplanung und Umwelt
09.01.2023 17:00;795;344;451;Bewoelkt;4;1;0;Stadt Konstanz, Amt fuer Stadtplanung und Umwelt
09.01.2023 18:00;551;255;296;Bewoelkt;2;0;0;Stadt Konstanz, Amt fuer Stadtplanung und Umwelt
09.01.2023 19:00;440;208;232;Bewoelkt;3;0;0;Stadt Konstanz, Amt fuer Stadtplanung und Umwelt
09.01.2023 20:00;285;143;142;Stellenweiser Regenfall;3;0;0;Stadt Konstanz, Amt fuer Stadtplanung und Umwelt
09.01.2023 21:00;181;78;103;Stellenweiser Regenfall;4;0;0;Stadt Konstanz, Amt fuer Stadtplanung und Umwelt
09.01.2023 22:00;159;78;81;Stellenweiser Regenfall;3;-1;0;Stadt Konstanz, Amt fuer Stadtplanung und Umwelt
09.01.2023 23:00;66;37;29;Maeßige bis starke Schneefaelle;3;-2;0;Stadt Konstanz, Amt fuer Stadtplanung und Umwelt
10.01.2023 00:00;20;8;12;Maeßige bis starke Schneefaelle;3;-2;0.1;Stadt Konstanz, Amt fuer Stadtplanung und Umwelt
10.01.2023 01:00;16;9;7;Maeßige bis starke Schneefaelle;3;-2;0;Stadt Konstanz, Amt fuer Stadtplanung und Umwelt
10.01.2023 02:00;1;0;1;Bewoelkt;3;-2;0;Stadt Konstanz, Amt fuer Stadtplanung und Umwelt
10.01.2023 03:00;3;0;3;Bewoelkt;3;-2;0;Stadt Konstanz, Amt fuer Stadtplanung und Umwelt
10.01.2023 04:00;13;7;6;Bewoelkt;3;-2;0;Stadt Konstanz, Amt fuer Stadtplanung und Umwelt
10.01.2023 05:00;47;31;16;Maeßige bis starke Schneefaelle;2;-2;0.1;Stadt Konstanz, Amt fuer Stadtplanung und Umwelt
10.01.2023 06:00;156;93;63;Maeßige bis starke Schneefaelle;2;-2;0.1;Stadt Konstanz, Amt fuer Stadtplanung und Umwelt
10.01.2023 07:00;951;582;369;Maeßige bis starke Schneefaelle;2;-2;0;Stadt Konstanz, Amt fuer Stadtplanung und Umwelt
10.01.2023 08:00;733;410;323;Bedeckt;2;-2;0;Stadt Konstanz, Amt fuer Stadtplanung und Umwelt
10.01.2023 09:00;650;366;284;Bedeckt;3;-1;0;Stadt Konstanz, Amt fuer Stadtplanung und Umwelt
10.01.2023 10:00;379;213;166;Bedeckt;3;0;0;Stadt Konstanz, Amt fuer Stadtplanung und Umwelt
10.01.2023 11:00;504;259;245;Leicht bewoelkt;4;1;0;Stadt Konstanz, Amt fuer Stadtplanung und Umwelt
10.01.2023 12:00;524;218;306;Leicht bewoelkt;5;2;0;Stadt Konstanz, Amt fuer Stadtplanung und Umwelt
10.01.2023 13:00;759;317;442;Leicht bewoelkt;5;3;0;Stadt Konstanz, Amt fuer Stadtplanung und Umwelt
10.01.2023 14:00;550;268;282;Sonnig;5;3;0;Stadt Konstanz, Amt fuer Stadtplanung und Umwelt
10.01.2023 15:00;845;434;411;Sonnig;5;4;0;Stadt Konstanz, Amt fuer Stadtplanung und Umwelt
10.01.2023 16:00;831;342;489;Sonnig;4;3;0;Stadt Konstanz, Amt fuer Stadtplanung und Umwelt
10.01.2023 17:00;911;404;507;Bedeckt;3;2;0;Stadt Konstanz, Amt fuer Stadtplanung und Umwelt
10.01.2023 18:00;642;276;366;Bedeckt;2;1;0;Stadt Konstanz, Amt fuer Stadtplanung und Umwelt
10.01.2023 19:00;508;230;278;Bedeckt;2;1;0;Stadt Konstanz, Amt fuer Stadtplanung und Umwelt
10.01.2023 20:00;331;160;171;Bedeckt;2;0;0;Stadt Konstanz, Amt fuer Stadtplanung und Umwelt
10.01.2023 21:00;223;124;99;Bedeckt;3;0;0;Stadt Konstanz, Amt fuer Stadtplanung und Umwelt
10.01.2023 22:00;189;80;109;Bedeckt;2;-1;0;Stadt Konstanz, Amt fuer Stadtplanung und Umwelt
10.01.2023 23:00;104;35;69;Leicht bewoelkt;1;-2;0;Stadt Konstanz, Amt fuer Stadtplanung und Umwelt
11.01.2023 00:00;49;25;24;Leicht bewoelkt;0;-2;0;Stadt Konstanz, Amt fuer Stadtplanung und Umwelt
11.01.2023 01:00;22;13;9;Leicht bewoelkt;1;-2;0;Stadt Konstanz, Amt fuer Stadtplanung und Umwelt
11.01.2023 02:00;5;3;2;Bewoelkt;2;-1;0;Stadt Konstanz, Amt fuer Stadtplanung und Umwelt
11.01.2023 03:00;4;3;1;Bewoelkt;2;0;0;Stadt Konstanz, Amt fuer Stadtplanung und Umwelt
11.01.2023 04:00;15;10;5;Bewoelkt;2;0;0;Stadt Konstanz, Amt fuer Stadtplanung und Umwelt
11.01.2023 05:00;49;37;12;Leicht bewoelkt;2;0;0;Stadt Konstanz, Amt fuer Stadtplanung und Umwelt
11.01.2023 06:00;170;103;67;Leicht bewoelkt;2;0;0;Stadt Konstanz, Amt fuer Stadtplanung und Umwelt
11.01.2023 07:00;949;584;365;Leicht bewoelkt;2;0;0;Stadt Konstanz, Amt fuer Stadtplanung und Umwelt
11.01.2023 08:00;713;405;308;Sonnig;2;1;0;Stadt Konstanz, Amt fuer Stadtplanung und Umwelt
11.01.2023 09:00;632;347;285;Sonnig;3;1;0;Stadt Konstanz, Amt fuer Stadtplanung und Umwelt
11.01.2023 10:00;354;172;182;Sonnig;4;3;0;Stadt Konstanz, Amt fuer Stadtplanung und Umwelt
11.01.2023 11:00;475;218;257;Leicht bewoelkt;6;5;0;Stadt Konstanz, Amt fuer Stadtplanung und Umwelt
11.01.2023 12:00;534;244;290;Leicht bewoelkt;7;6;0;Stadt Konstanz, Amt fuer Stadtplanung und Umwelt
11.01.2023 13:00;797;378;419;Leicht bewoelkt;7;6;0;Stadt Konstanz, Amt fuer Stadtplanung und Umwelt
11.01.2023 14:00;460;243;217;Bedeckt;7;6;0;Stadt Konstanz, Amt fuer Stadtplanung und Umwelt
11.01.2023 15:00;659;262;397;Bedeckt;7;6;0;Stadt Konstanz, Amt fuer Stadtplanung und Umwelt
11.01.2023 16:00;652;301;351;Bedeckt;8;6;0;Stadt Konstanz, Amt fuer Stadtplanung und Umwelt
11.01.2023 17:00;797;359;438;Nieselregen;8;5;0.2;Stadt Konstanz, Amt fuer Stadtplanung und Umwelt
11.01.2023 18:00;691;307;384;Nieselregen;8;5;0.3;Stadt Konstanz, Amt fuer Stadtplanung und Umwelt
11.01.2023 19:00;495;259;236;Nieselregen;8;5;0.1;Stadt Konstanz, Amt fuer Stadtplanung und Umwelt
11.01.2023 20:00;387;170;217;Bedeckt;8;5;0;Stadt Konstanz, Amt fuer Stadtplanung und Umwelt
11.01.2023 21:00;236;107;129;Bedeckt;7;4;0;Stadt Konstanz, Amt fuer Stadtplanung und Umwelt
11.01.2023 22:00;188;83;105;Bedeckt;7;4;0;Stadt Konstanz, Amt fuer Stadtplanung und Umwelt
11.01.2023 23:00;102;42;60;Leichter Regenschauer;6;3;0.2;Stadt Konstanz, Amt fuer Stadtplanung und Umwelt
12.01.2023 00:00;42;14;28;Leichter Regenschauer;6;3;0.4;Stadt Konstanz, Amt fuer Stadtplanung und Umwelt
12.01.2023 01:00;19;8;11;Leichter Regenschauer;6;2;0.2;Stadt Konstanz, Amt fuer Stadtplanung und Umwelt
12.01.2023 02:00;6;3;3;Stellenweiser Regenfall;5;2;0;Stadt Konstanz, Amt fuer Stadtplanung und Umwelt
12.01.2023 03:00;8;3;5;Stellenweiser Regenfall;5;1;0;Stadt Konstanz, Amt fuer Stadtplanung und Umwelt
12.01.2023 04:00;23;17;6;Stellenweiser Regenfall;5;1;0;Stadt Konstanz, Amt fuer Stadtplanung und Umwelt
12.01.2023 05:00;38;31;7;Stellenweiser Regenfall;5;1;0;Stadt Konstanz, Amt fuer Stadtplanung und Umwelt
12.01.2023 06:00;146;82;64;Stellenweiser Regenfall;5;1;0;Stadt Konstanz, Amt fuer Stadtplanung und Umwelt
12.01.2023 07:00;912;545;367;Stellenweiser Regenfall;5;1;0;Stadt Konstanz, Amt fuer Stadtplanung und Umwelt
12.01.2023 08:00;710;373;337;Bedeckt;5;1;0;Stadt Konstanz, Amt fuer Stadtplanung und Umwelt
12.01.2023 09:00;692;399;293;Bedeckt;5;2;0;Stadt Konstanz, Amt fuer Stadtplanung und Umwelt
12.01.2023 10:00;370;201;169;Bedeckt;6;2;0;Stadt Konstanz, Amt fuer Stadtplanung und Umwelt
12.01.2023 11:00;483;228;255;Stellenweiser Regenfall;6;3;0;Stadt Konstanz, Amt fuer Stadtplanung und Umwelt
12.01.2023 12:00;565;238;327;Stellenweiser Regenfall;6;3;0;Stadt Konstanz, Amt fuer Stadtplanung und Umwelt
12.01.2023 13:00;802;347;455;Stellenweiser Regenfall;6;3;0;Stadt Konstanz, Amt fuer Stadtplanung und Umwelt
12.01.2023 14:00;521;251;270;Bedeckt;7;3;0;Stadt Konstanz, Amt fuer Stadtplanung und Umwelt
12.01.2023 15:00;857;414;443;Bedeckt;7;3;0;Stadt Konstanz, Amt fuer Stadtplanung und Umwelt
12.01.2023 16:00;760;366;394;Bedeckt;7;3;0;Stadt Konstanz, Amt fuer Stadtplanung und Umwelt
12.01.2023 17:00;899;394;505;Nieselregen;7;3;0.2;Stadt Konstanz, Amt fuer Stadtplanung und Umwelt
12.01.2023 18:00;692;332;360;Nieselregen;7;3;0.3;Stadt Konstanz, Amt fuer Stadtplanung und Umwelt
12.01.2023 19:00;512;241;271;Nieselregen;7;3;0.1;Stadt Konstanz, Amt fuer Stadtplanung und Umwelt
12.01.2023 20:00;339;163;176;Bedeckt;7;4;0;Stadt Konstanz, Amt fuer Stadtplanung und Umwelt
12.01.2023 21:00;256;110;146;Bedeckt;7;4;0;Stadt Konstanz, Amt fuer Stadtplanung und Umwelt
12.01.2023 22:00;202;77;125;Bedeckt;7;3;0;Stadt Konstanz, Amt fuer Stadtplanung und Umwelt
12.01.2023 23:00;147;53;94;Bedeckt;6;3;0;Stadt Konstanz, Amt fuer Stadtplanung und Umwelt
13.01.2023 00:00;56;29;27;Bedeckt;6;3;0;Stadt Konstanz, Amt fuer Stadtplanung und Umwelt
13.01.2023 01:00;29;7;22;Bedeckt;5;3;0;Stadt Konstanz, Amt fuer Stadtplanung und Umwelt
13.01.2023 02:00;8;6;2;Bedeckt;5;2;0;Stadt Konstanz, Amt fuer Stadtplanung und Umwelt
13.01.2023 03:00;8;1;7;Bedeckt;5;2;0;Stadt Konstanz, Amt fuer Stadtplanung und Umwelt
13.01.2023 04:00;10;4;6;Bedeckt;5;3;0;Stadt Konstanz, Amt fuer Stadtplanung und Umwelt
13.01.2023 05:00;29;22;7;Bewoelkt;6;3;0;Stadt Konstanz, Amt fuer Stadtplanung und Umwelt
13.01.2023 06:00;140;87;53;Bewoelkt;6;4;0;Stadt Konstanz, Amt fuer Stadtplanung und Umwelt
13.01.2023 07:00;803;494;309;Bewoelkt;6;3;0;Stadt Konstanz, Amt fuer Stadtplanung und Umwelt
13.01.2023 08:00;649;336;313;Stellenweiser Regenfall;7;3;0;Stadt Konstanz, Amt fuer Stadtplanung und Umwelt
13.01.2023 09:00;693;414;279;Stellenweiser Regenfall;7;3;0;Stadt Konstanz, Amt fuer Stadtplanung und Umwelt
13.01.2023 10:00;463;250;213;Stellenweiser Regenfall;7;3;0;Stadt Konstanz, Amt fuer Stadtplanung und Umwelt
13.01.2023 11:00;533;244;289;Nieselregen;7;4;0.1;Stadt Konstanz, Amt fuer Stadtplanung und Umwelt
13.01.2023 12:00;575;255;320;Nieselregen;7;4;0.2;Stadt Konstanz, Amt fuer Stadtplanung und Umwelt
13.01.2023 13:00;796;311;485;Nieselregen;7;4;0.1;Stadt Konstanz, Amt fuer Stadtplanung und Umwelt
13.01.2023 14:00;598;271;327;Bedeckt;7;4;0;Stadt Konstanz, Amt fuer Stadtplanung und Umwelt
13.01.2023 15:00;655;309;346;Bedeckt;8;4;0;Stadt Konstanz, Amt fuer Stadtplanung und Umwelt
13.01.2023 16:00;554;248;306;Bedeckt;7;4;0;Stadt Konstanz, Amt fuer Stadtplanung und Umwelt
13.01.2023 17:00;590;265;325;Stellenweiser Nieselregen;7;4;0.1;Stadt Konstanz, Amt fuer Stadtplanung und Umwelt
13.01.2023 18:00;437;209;228;Stellenweiser Nieselregen;7;4;0.1;Stadt Konstanz, Amt fuer Stadtplanung und Umwelt
13.01.2023 19:00;405;206;199;Stellenweiser Nieselregen;6;3;0.1;Stadt Konstanz, Amt fuer Stadtplanung und Umwelt
13.01.2023 20:00;257;136;121;Stellenweiser Regenfall;6;2;0;Stadt Konstanz, Amt fuer Stadtplanung und Umwelt
13.01.2023 21:00;209;111;98;Stellenweiser Regenfall;5;2;0;Stadt Konstanz, Amt fuer Stadtplanung und Umwelt
13.01.2023 22:00;163;60;103;Stellenweiser Regenfall;5;1;0;Stadt Konstanz, Amt fuer Stadtplanung und Umwelt
13.01.2023 23:00;131;49;82;Leichter Regenschauer;4;1;0.1;Stadt Konstanz, Amt fuer Stadtplanung und Umwelt
14.01.2023 00:00;100;36;64;Leichter Regenschauer;4;0;0.1;Stadt Konstanz, Amt fuer Stadtplanung und Umwelt
14.01.2023 01:00;71;32;39;Leichter Regenschauer;4;1;0.1;Stadt Konstanz, Amt fuer Stadtplanung und Umwelt
14.01.2023 02:00;55;19;36;Leicht bewoelkt;4;1;0;Stadt Konstanz, Amt fuer Stadtplanung und Umwelt
14.01.2023 03:00;46;23;23;Leicht bewoelkt;4;1;0;Stadt Konstanz, Amt fuer Stadtplanung und Umwelt
14.01.2023 04:00;18;9;9;Leicht bewoelkt;3;1;0;Stadt Konstanz, Amt fuer Stadtplanung und Umwelt
14.01.2023 05:00;32;20;12;Sonnig;2;0;0;Stadt Konstanz, Amt fuer Stadtplanung und Umwelt
14.01.2023 06:00;49;30;19;Sonnig;2;0;0;Stadt Konstanz, Amt fuer Stadtplanung und Umwelt
14.01.2023 07:00;73;38;35;Sonnig;2;0;0;Stadt Konstanz, Amt fuer Stadtplanung und Umwelt
14.01.2023 08:00;160;81;79;Sonnig;2;0;0;Stadt Konstanz, Amt fuer Stadtplanung und Umwelt
14.01.2023 09:00;298;165;133;Sonnig;2;1;0;Stadt Konstanz, Amt fuer Stadtplanung und Umwelt
14.01.2023 10:00;402;245;157;Sonnig;3;2;0;Stadt Konstanz, Amt fuer Stadtplanung und Umwelt
14.01.2023 11:00;433;228;205;Bedeckt;4;3;0;Stadt Konstanz, Amt fuer Stadtplanung und Umwelt
14.01.2023 12:00;479;240;239;Bedeckt;6;5;0;Stadt Konstanz, Amt fuer Stadtplanung und Umwelt
14.01.2023 13:00;485;242;243;Bedeckt;6;5;0;Stadt Konstanz, Amt fuer Stadtplanung und Umwelt
14.01.2023 14:00;507;247;260;Bedeckt;6;5;0;Stadt Konstanz, Amt fuer Stadtplanung und Umwelt
14.01.2023 15:00;539;272;267;Bedeckt;6;5;0;Stadt Konstanz, Amt fuer Stadtplanung und Umwelt
14.01.2023 16:00;505;270;235;Bedeckt;5;5;0;Stadt Konstanz, Amt fuer Stadtplanung und Umwelt
14.01.2023 17:00;438;183;255;Bedeckt;5;4;0;Stadt Konstanz, Amt fuer Stadtplanung und Umwelt
14.01.2023 18:00;373;135;238;Bedeckt;5;4;0;Stadt Konstanz, Amt fuer Stadtplanung und Umwelt
14.01.2023 19:00;292;176;116;Bedeckt;5;4;0;Stadt Konstanz, Amt fuer Stadtplanung und Umwelt
14.01.2023 20:00;250;147;103;Leicht bewoelkt;5;4;0;Stadt Konstanz, Amt fuer Stadtplanung und Umwelt
14.01.2023 21:00;210;106;104;Leicht bewoelkt;6;3;0;Stadt Konstanz, Amt fuer Stadtplanung und Umwelt
14.01.2023 22:00;152;63;89;Leicht bewoelkt;5;3;0;Stadt Konstanz, Amt fuer Stadtplanung und Umwelt
14.01.2023 23:00;141;50;91;Leicht bewoelkt;5;2;0;Stadt Konstanz, Amt fuer Stadtplanung und Umwelt
15.01.2023 00:00;150;48;102;Leicht bewoelkt;4;2;0;Stadt Konstanz, Amt fuer Stadtplanung und Umwelt
15.01.2023 01:00;106;23;83;Leicht bewoelkt;5;2;0;Stadt Konstanz, Amt fuer Stadtplanung und Umwelt
15.01.2023 02:00;78;22;56;Leicht bewoelkt;6;3;0;Stadt Konstanz, Amt fuer Stadtplanung und Umwelt
15.01.2023 03:00;61;25;36;Leicht bewoelkt;7;4;0;Stadt Konstanz, Amt fuer Stadtplanung und Umwelt
15.01.2023 04:00;28;17;11;Leicht bewoelkt;7;4;0;Stadt Konstanz, Amt fuer Stadtplanung und Umwelt
15.01.2023 05:00;10;6;4;Nieselregen;7;4;0.1;Stadt Konstanz, Amt fuer Stadtplanung und Umwelt
15.01.2023 06:00;28;19;9;Nieselregen;6;4;0.1;Stadt Konstanz, Amt fuer Stadtplanung und Umwelt
15.01.2023 07:00;40;24;16;Nieselregen;6;3;0;Stadt Konstanz, Amt fuer Stadtplanung und Umwelt
15.01.2023 08:00;58;30;28;Sonnig;5;2;0;Stadt Konstanz, Amt fuer Stadtplanung und Umwelt
15.01.2023 09:00;147;85;62;Sonnig;4;2;0;Stadt Konstanz, Amt fuer Stadtplanung und Umwelt
15.01.2023 10:00;154;91;63;Sonnig;5;3;0;Stadt Konstanz, Amt fuer Stadtplanung und Umwelt
15.01.2023 11:00;129;48;81;Bedeckt;7;3;0;Stadt Konstanz, Amt fuer Stadtplanung und Umwelt
15.01.2023 12:00;133;74;59;Bedeckt;8;4;0;Stadt Konstanz, Amt fuer Stadtplanung und Umwelt
15.01.2023 13:00;191;100;91;Bedeckt;7;3;0;Stadt Konstanz, Amt fuer Stadtplanung und Umwelt
15.01.2023 14:00;160;72;88;Leichter Eisregen;5;1;0.2;Stadt Konstanz, Amt fuer Stadtplanung und Umwelt
15.01.2023 15:00;198;101;97;Leichter Eisregen;4;0;0.3;Stadt Konstanz, Amt fuer Stadtplanung und Umwelt
15.01.2023 16:00;224;104;120;Leichter Eisregen;4;0;0.2;Stadt Konstanz, Amt fuer Stadtplanung und Umwelt
15.01.2023 17:00;301;140;161;Starker Schneefall;3;0;0.2;Stadt Konstanz, Amt fuer Stadtplanung und Umwelt
15.01.2023 18:00;219;97;122;Starker Schneefall;3;-1;0.3;Stadt Konstanz, Amt fuer Stadtplanung und Umwelt
15.01.2023 19:00;169;74;95;Starker Schneefall;3;-1;0.2;Stadt Konstanz, Amt fuer Stadtplanung und Umwelt
15.01.2023 20:00;159;68;91;Leicht bewoelkt;3;-1;0;Stadt Konstanz, Amt fuer Stadtplanung und Umwelt
15.01.2023 21:00;89;51;38;Leicht bewoelkt;2;-1;0;Stadt Konstanz, Amt fuer Stadtplanung und Umwelt
15.01.2023 22:00;82;43;39;Leicht bewoelkt;2;-1;0;Stadt Konstanz, Amt fuer Stadtplanung und Umwelt
15.01.2023 23:00;45;19;26;Sonnig;1;-1;0;Stadt Konstanz, Amt fuer Stadtplanung und Umwelt
16.01.2023 00:00;13;2;11;Sonnig;1;-1;0;Stadt Konstanz, Amt fuer Stadtplanung und Umwelt
16.01.2023 01:00;3;3;0;Sonnig;0;-1;0;Stadt Konstanz, Amt fuer Stadtplanung und Umwelt
16.01.2023 02:00;4;0;4;Sonnig;0;-1;0;Stadt Konstanz, Amt fuer Stadtplanung und Umwelt
16.01.2023 03:00;4;0;4;Sonnig;0;-1;0;Stadt Konstanz, Amt fuer Stadtplanung und Umwelt
16.01.2023 04:00;10;7;3;Sonnig;0;-2;0;Stadt Konstanz, Amt fuer Stadtplanung und Umwelt
16.01.2023 05:00;30;18;12;Sonnig;0;-2;0;Stadt Konstanz, Amt fuer Stadtplanung und Umwelt
16.01.2023 06:00;154;90;64;Sonnig;-1;-3;0;Stadt Konstanz, Amt fuer Stadtplanung und Umwelt
16.01.2023 07:00;899;524;375;Sonnig;-1;-2;0;Stadt Konstanz, Amt fuer Stadtplanung und Umwelt
16.01.2023 08:00;672;349;323;Sonnig;0;-2;0;Stadt Konstanz, Amt fuer Stadtplanung und Umwelt
16.01.2023 09:00;580;334;246;Sonnig;0;-2;0;Stadt Konstanz, Amt fuer Stadtplanung und Umwelt
16.01.2023 10:00;331;163;168;Sonnig;1;-1;0;Stadt Konstanz, Amt fuer Stadtplanung und Umwelt
16.01.2023 11:00;407;192;215;Bedeckt;2;0;0;Stadt Konstanz, Amt fuer Stadtplanung und Umwelt
16.01.2023 12:00;470;213;257;Bedeckt;3;1;0;Stadt Konstanz, Amt fuer Stadtplanung und Umwelt
16.01.2023 13:00;688;299;389;Bedeckt;3;2;0;Stadt Konstanz, Amt fuer Stadtplanung und Umwelt
16.01.2023 14:00;487;233;254;Leicht bewoelkt;3;2;0;Stadt Konstanz, Amt fuer Stadtplanung und Umwelt
16.01.2023 15:00;791;378;413;Leicht bewoelkt;3;3;0;Stadt Konstanz, Amt fuer Stadtplanung und Umwelt
16.01.2023 16:00;706;312;394;Leicht bewoelkt;3;1;0;Stadt Konstanz, Amt fuer Stadtplanung und Umwelt
16.01.2023 17:00;813;391;422;Leichter Schneefall;2;0;0;Stadt Konstanz, Amt fuer Stadtplanung und Umwelt
16.01.2023 18:00;569;262;307;Leichter Schneefall;1;-2;0;Stadt Konstanz, Amt fuer Stadtplanung und Umwelt
16.01.2023 19:00;482;231;251;Leichter Schneefall;1;-2;0;Stadt Konstanz, Amt fuer Stadtplanung und Umwelt
16.01.2023 20:00;298;149;149;Bedeckt;1;-3;0;Stadt Konstanz, Amt fuer Stadtplanung und Umwelt
16.01.2023 21:00;182;92;90;Bedeckt;1;-3;0;Stadt Konstanz, Amt fuer Stadtplanung und Umwelt
16.01.2023 22:00;147;61;86;Bedeckt;1;-3;0;Stadt Konstanz, Amt fuer Stadtplanung und Umwelt
16.01.2023 23:00;80;33;47;Leichte Schneeschauer;0;-3;0;Stadt Konstanz, Amt fuer Stadtplanung und Umwelt
17.01.2023 00:00;27;15;12;Leichte Schneeschauer;0;-3;0.1;Stadt Konstanz, Amt fuer Stadtplanung und Umwelt
17.01.2023 01:00;12;9;3;Leichte Schneeschauer;0;-3;0;Stadt Konstanz, Amt fuer Stadtplanung und Umwelt
17.01.2023 02:00;1;1;0;Sonnig;0;-4;0;Stadt Konstanz, Amt fuer Stadtplanung und Umwelt
17.01.2023 03:00;2;0;2;Sonnig;0;-4;0;Stadt Konstanz, Amt fuer Stadtplanung und Umwelt
17.01.2023 04:00;5;4;1;Sonnig;-1;-3;0;Stadt Konstanz, Amt fuer Stadtplanung und Umwelt
17.01.2023 05:00;33;27;6;Sonnig;-1;-3;0;Stadt Konstanz, Amt fuer Stadtplanung und Umwelt
17.01.2023 06:00;156;86;70;Sonnig;-1;-2;0;Stadt Konstanz, Amt fuer Stadtplanung und Umwelt
17.01.2023 07:00;858;504;354;Sonnig;-1;-3;0;Stadt Konstanz, Amt fuer Stadtplanung und Umwelt
17.01.2023 08:00;734;403;331;Leicht bewoelkt;-1;-3;0;Stadt Konstanz, Amt fuer Stadtplanung und Umwelt
17.01.2023 09:00;651;384;267;Leicht bewoelkt;-1;-3;0;Stadt Konstanz, Amt fuer Stadtplanung und Umwelt
17.01.2023 10:00;332;183;149;Leicht bewoelkt;0;-2;0;Stadt Konstanz, Amt fuer Stadtplanung und Umwelt
17.01.2023 11:00;463;241;222;Bedeckt;2;0;0;Stadt Konstanz, Amt fuer Stadtplanung und Umwelt
17.01.2023 12:00;540;239;301;Bedeckt;3;2;0;Stadt Konstanz, Amt fuer Stadtplanung und Umwelt
17.01.2023 13:00;749;324;425;Bedeckt;3;2;0;Stadt Konstanz, Amt fuer Stadtplanung und Umwelt
17.01.2023 14:00;482;250;232;Bedeckt;4;3;0;Stadt Konstanz, Amt fuer Stadtplanung und Umwelt
17.01.2023 15:00;713;357;356;Bedeckt;4;3;0;Stadt Konstanz, Amt fuer Stadtplanung und Umwelt
17.01.2023 16:00;690;291;399;Bedeckt;3;2;0;Stadt Konstanz, Amt fuer Stadtplanung und Umwelt
17.01.2023 17:00;830;386;444;Bewoelkt;2;1;0;Stadt Konstanz, Amt fuer Stadtplanung und Umwelt
17.01.2023 18:00;645;298;347;Bewoelkt;1;-1;0;Stadt Konstanz, Amt fuer Stadtplanung und Umwelt
17.01.2023 19:00;559;279;280;Bewoelkt;1;-2;0;Stadt Konstanz, Amt fuer Stadtplanung und Umwelt
17.01.2023 20:00;327;163;164;Maeßiger Schneefall;1;-2;0.1;Stadt Konstanz, Amt fuer Stadtplanung und Umwelt
17.01.2023 21:00;261;110;151;Maeßiger Schneefall;0;-3;0.1;Stadt Konstanz, Amt fuer Stadtplanung und Umwelt
17.01.2023 22:00;199;72;127;Maeßiger Schneefall;0;-4;0;Stadt Konstanz, Amt fuer Stadtplanung und Umwelt
17.01.2023 23:00;102;40;62;Starker Schneefall;0;-5;0.2;Stadt Konstanz, Amt fuer Stadtplanung und Umwelt
18.01.2023 00:00;32;17;15;Starker Schneefall;-1;-5;0.4;Stadt Konstanz, Amt fuer Stadtplanung und Umwelt
18.01.2023 01:00;25;11;14;Starker Schneefall;-1;-5;0.2;Stadt Konstanz, Amt fuer Stadtplanung und Umwelt
18.01.2023 02:00;4;0;4;Leichte Schneeschauer;-1;-5;0;Stadt Konstanz, Amt fuer Stadtplanung und Umwelt
18.01.2023 03:00;2;1;1;Leichte Schneeschauer;-1;-5;0;Stadt Konstanz, Amt fuer Stadtplanung und Umwelt
18.01.2023 04:00;8;5;3;Leichte Schneeschauer;-2;-5;0;Stadt Konstanz, Amt fuer Stadtplanung und Umwelt
18.01.2023 05:00;39;28;11;Maeßige bis starke Schneefaelle;-2;-6;0;Stadt Konstanz, Amt fuer Stadtplanung und Umwelt
18.01.2023 06:00;143;78;65;Maeßige bis starke Schneefaelle;-3;-6;0;Stadt Konstanz, Amt fuer Stadtplanung und Umwelt
18.01.2023 07:00;857;509;348;Maeßige bis starke Schneefaelle;-3;-6;0;Stadt Konstanz, Amt fuer Stadtplanung und Umwelt
18.01.2023 08:00;693;382;311;Sonnig;-3;-5;0;Stadt Konstanz, Amt fuer Stadtplanung und Umwelt
18.01.2023 09:00;528;299;229;Sonnig;-4;-5;0;Stadt Konstanz, Amt fuer Stadtplanung und Umwelt
18.01.2023 10:00;286;166;120;Sonnig;-2;-4;0;Stadt Konstanz, Amt fuer Stadtplanung und Umwelt
18.01.2023 11:00;409;197;212;Bedeckt;-1;-2;0;Stadt Konstanz, Amt fuer Stadtplanung und Umwelt
18.01.2023 12:00;496;230;266;Bedeckt;1;0;0;Stadt Konstanz, Amt fuer Stadtplanung und Umwelt
18.01.2023 13:00;772;390;382;Bedeckt;1;-1;0;Stadt Konstanz, Amt fuer Stadtplanung und Umwelt
18.01.2023 14:00;505;243;262;Maeßige bis starke Schneefaelle;1;-2;0;Stadt Konstanz, Amt fuer Stadtplanung und Umwelt
18.01.2023 15:00;678;300;378;Maeßige bis starke Schneefaelle;0;-2;0;Stadt Konstanz, Amt fuer Stadtplanung und Umwelt
18.01.2023 16:00;690;326;364;Maeßige bis starke Schneefaelle;-1;-3;0;Stadt Konstanz, Amt fuer Stadtplanung und Umwelt
18.01.2023 17:00;802;373;429;Sonnig;-2;-3;0;Stadt Konstanz, Amt fuer Stadtplanung und Umwelt
18.01.2023 18:00;644;266;378;Sonnig;-3;-4;0;Stadt Konstanz, Amt fuer Stadtplanung und Umwelt
18.01.2023 19:00;475;225;250;Sonnig;-4;-5;0;Stadt Konstanz, Amt fuer Stadtplanung und Umwelt
18.01.2023 20:00;341;167;174;Leicht bewoelkt;-5;-7;0;Stadt Konstanz, Amt fuer Stadtplanung und Umwelt
18.01.2023 21:00;260;110;150;Leicht bewoelkt;-6;-8;0;Stadt Konstanz, Amt fuer Stadtplanung und Umwelt
18.01.2023 22:00;179;75;104;Leicht bewoelkt;-6;-7;0;Stadt Konstanz, Amt fuer Stadtplanung und Umwelt
18.01.2023 23:00;147;64;83;Maeßige bis starke Schneefaelle;-5;-7;0;Stadt Konstanz, Amt fuer Stadtplanung und Umwelt
19.01.2023 00:00;61;23;38;Maeßige bis starke Schneefaelle;-5;-6;0.1;Stadt Konstanz, Amt fuer Stadtplanung und Umwelt
19.01.2023 01:00;24;11;13;Maeßige bis starke Schneefaelle;-5;-7;0;Stadt Konstanz, Amt fuer Stadtplanung und Umwelt
19.01.2023 02:00;19;10;9;Leichter Schneefall;-6;-7;0;Stadt Konstanz, Amt fuer Stadtplanung und Umwelt
19.01.2023 03:00;9;7;2;Leichter Schneefall;-7;-8;0;Stadt Konstanz, Amt fuer Stadtplanung und Umwelt
19.01.2023 04:00;13;12;1;Leichter Schneefall;-7;-8;0;Stadt Konstanz, Amt fuer Stadtplanung und Umwelt
19.01.2023 05:00;35;25;10;Leichter Schneefall;-6;-8;0;Stadt Konstanz, Amt fuer Stadtplanung und Umwelt
19.01.2023 06:00;133;66;67;Leichter Schneefall;-6;-8;0;Stadt Konstanz, Amt fuer Stadtplanung und Umwelt
19.01.2023 07:00;829;493;336;Leichter Schneefall;-6;-7;0;Stadt Konstanz, Amt fuer Stadtplanung und Umwelt
19.01.2023 08:00;668;339;329;Leicht bewoelkt;-5;-6;0;Stadt Konstanz, Amt fuer Stadtplanung und Umwelt
19.01.2023 09:00;553;310;243;Leicht bewoelkt;-4;-5;0;Stadt Konstanz, Amt fuer Stadtplanung und Umwelt
19.01.2023 10:00;318;169;149;Leicht bewoelkt;-3;-4;0;Stadt Konstanz, Amt fuer Stadtplanung und Umwelt
19.01.2023 11:00;465;230;235;Bewoelkt;-2;-4;0;Stadt Konstanz, Amt fuer Stadtplanung und Umwelt
19.01.2023 12:00;468;210;258;Bewoelkt;-1;-4;0;Stadt Konstanz, Amt fuer Stadtplanung und Umwelt
19.01.2023 13:00;784;332;452;Bewoelkt;-1;-3;0;Stadt Konstanz, Amt fuer Stadtplanung und Umwelt
19.01.2023 14:00;539;261;278;Bedeckt;0;-3;0;Stadt Konstanz, Amt fuer Stadtplanung und Umwelt
19.01.2023 15:00;786;392;394;Bedeckt;0;-3;0;Stadt Konstanz, Amt fuer Stadtplanung und Umwelt
19.01.2023 16:00;765;381;384;Bedeckt;-1;-4;0;Stadt Konstanz, Amt fuer Stadtplanung und Umwelt
19.01.2023 17:00;802;358;444;Bedeckt;-3;-4;0;Stadt Konstanz, Amt fuer Stadtplanung und Umwelt
19.01.2023 18:00;681;336;345;Bedeckt;-4;-5;0;Stadt Konstanz, Amt fuer Stadtplanung und Umwelt
19.01.2023 19:00;510;281;229;Bedeckt;-4;-5;0;Stadt Konstanz, Amt fuer Stadtplanung und Umwelt
19.01.2023 20:00;309;143;166;Bewoelkt;-5;-5;0;Stadt Konstanz, Amt fuer Stadtplanung und Umwelt
19.01.2023 21:00;256;119;137;Bewoelkt;-5;-5;0;Stadt Konstanz, Amt fuer Stadtplanung und Umwelt
19.01.2023 22:00;204;70;134;Bewoelkt;-6;-6;0;Stadt Konstanz, Amt fuer Stadtplanung und Umwelt
19.01.2023 23:00;110;31;79;Leichter Nebel;-6;-6;0;Stadt Konstanz, Amt fuer Stadtplanung und Umwelt
20.01.2023 00:00;62;22;40;Leichter Nebel;-7;-7;0;Stadt Konstanz, Amt fuer Stadtplanung und Umwelt
20.01.2023 01:00;30;11;19;Leichter Nebel;-7;-7;0;Stadt Konstanz, Amt fuer Stadtplanung und Umwelt
20.01.2023 02:00;8;2;6;Leichter Schneefall;-6;-7;0;Stadt Konstanz, Amt fuer Stadtplanung und Umwelt
20.01.2023 03:00;4;1;3;Leichter Schneefall;-6;-7;0;Stadt Konstanz, Amt fuer Stadtplanung und Umwelt
20.01.2023 04:00;9;5;4;Leichter Schneefall;-5;-7;0;Stadt Konstanz, Amt fuer Stadtplanung und Umwelt
20.01.2023 05:00;36;26;10;Maeßiger Schneefall;-5;-6;0;Stadt Konstanz, Amt fuer Stadtplanung und Umwelt
20.01.2023 06:00;122;55;67;Maeßiger Schneefall;-5;-6;0;Stadt Konstanz, Amt fuer Stadtplanung und Umwelt
20.01.2023 07:00;795;482;313;Maeßiger Schneefall;-5;-6;0;Stadt Konstanz, Amt fuer Stadtplanung und Umwelt
20.01.2023 08:00;621;338;283;Maeßiger Schneefall;-4;-5;0.1;Stadt Konstanz, Amt fuer Stadtplanung und Umwelt
20.01.2023 09:00;650;379;271;Maeßiger Schneefall;-4;-5;0.1;Stadt Konstanz, Amt fuer Stadtplanung und Umwelt
20.01.2023 10:00;334;175;159;Maeßiger Schneefall;-3;-4;0;Stadt Konstanz, Amt fuer Stadtplanung und Umwelt
20.01.2023 11:00;473;209;264;Maeßiger Schneefall;-2;-4;0.1;Stadt Konstanz, Amt fuer Stadtplanung und Umwelt
20.01.2023 12:00;578;293;285;Maeßiger Schneefall;-1;-3;0.1;Stadt Konstanz, Amt fuer Stadtplanung und Umwelt
20.01.2023 13:00;783;329;454;Maeßiger Schneefall;-1;-2;0;Stadt Konstanz, Amt fuer Stadtplanung und Umwelt
20.01.2023 14:00;562;278;284;Maeßige bis starke Schneefaelle;-1;-2;0.1;Stadt Konstanz, Amt fuer Stadtplanung und Umwelt
20.01.2023 15:00;576;297;279;Maeßige bis starke Schneefaelle;0;-1;0.1;Stadt Konstanz, Amt fuer Stadtplanung und Umwelt
20.01.2023 16:00;575;287;288;Maeßige bis starke Schneefaelle;-1;-2;0;Stadt Konstanz, Amt fuer Stadtplanung und Umwelt
20.01.2023 17:00;618;281;337;Maeßige bis starke Schneefaelle;-2;-3;0.1;Stadt Konstanz, Amt fuer Stadtplanung und Umwelt
20.01.2023 18:00;485;211;274;Maeßige bis starke Schneefaelle;-3;-5;0.1;Stadt Konstanz, Amt fuer Stadtplanung und Umwelt
20.01.2023 19:00;427;208;219;Maeßige bis starke Schneefaelle;-4;-6;0;Stadt Konstanz, Amt fuer Stadtplanung und Umwelt
20.01.2023 20:00;285;139;146;Stellenweise maeßiger Schneefall;-4;-7;0;Stadt Konstanz, Amt fuer Stadtplanung und Umwelt
20.01.2023 21:00;200;114;86;Stellenweise maeßiger Schneefall;-5;-8;0;Stadt Konstanz, Amt fuer Stadtplanung und Umwelt
20.01.2023 22:00;207;87;120;Stellenweise maeßiger Schneefall;-5;-6;0;Stadt Konstanz, Amt fuer Stadtplanung und Umwelt
20.01.2023 23:00;154;49;105;Leicht bewoelkt;-4;-5;0;Stadt Konstanz, Amt fuer Stadtplanung und Umwelt
21.01.2023 00:00;113;44;69;Leicht bewoelkt;-4;-4;0;Stadt Konstanz, Amt fuer Stadtplanung und Umwelt
21.01.2023 01:00;81;26;55;Leicht bewoelkt;-4;-5;0;Stadt Konstanz, Amt fuer Stadtplanung und Umwelt
21.01.2023 02:00;63;27;36;Bedeckt;-4;-6;0;Stadt Konstanz, Amt fuer Stadtplanung und Umwelt
21.01.2023 03:00;37;17;20;Bedeckt;-5;-7;0;Stadt Konstanz, Amt fuer Stadtplanung und Umwelt
21.01.2023 04:00;20;5;15;Bedeckt;-4;-7;0;Stadt Konstanz, Amt fuer Stadtplanung und Umwelt
21.01.2023 05:00;20;13;7;Leichter Schneefall;-4;-7;0;Stadt Konstanz, Amt fuer Stadtplanung und Umwelt
21.01.2023 06:00;36;26;10;Leichter Schneefall;-3;-7;0;Stadt Konstanz, Amt fuer Stadtplanung und Umwelt
21.01.2023 07:00;68;32;36;Leichter Schneefall;-3;-7;0;Stadt Konstanz, Amt fuer Stadtplanung und Umwelt
21.01.2023 08:00;118;65;53;Stellenweise maeßiger Schneefall;-3;-7;0;Stadt Konstanz, Amt fuer Stadtplanung und Umwelt
21.01.2023 09:00;225;115;110;Stellenweise maeßiger Schneefall;-2;-7;0;Stadt Konstanz, Amt fuer Stadtplanung und Umwelt
21.01.2023 10:00;271;170;101;Stellenweise maeßiger Schneefall;-1;-6;0;Stadt Konstanz, Amt fuer Stadtplanung und Umwelt
21.01.2023 11:00;296;161;135;Leichter Schneefall;0;-5;0;Stadt Konstanz, Amt fuer Stadtplanung und Umwelt
21.01.2023 12:00;337;177;160;Leichter Schneefall;1;-4;0;Stadt Konstanz, Amt fuer Stadtplanung und Umwelt
21.01.2023 13:00;345;181;164;Leichter Schneefall;1;-4;0;Stadt Konstanz, Amt fuer Stadtplanung und Umwelt
21.01.2023 14:00;392;197;195;Leichter Schneefall;1;-4;0;Stadt Konstanz, Amt fuer Stadtplanung und Umwelt
21.01.2023 15:00;357;164;193;Leichter Schneefall;1;-4;0;Stadt Konstanz, Amt fuer Stadtplanung und Umwelt
21.01.2023 16:00;289;116;173;Leichter Schneefall;0;-5;0;Stadt Konstanz, Amt fuer Stadtplanung und Umwelt
21.01.2023 17:00;275;133;142;Leichte Schneeschauer;0;-6;0;Stadt Konstanz, Amt fuer Stadtplanung und Umwelt
21.01.2023 18:00;326;120;206;Leichte Schneeschauer;-1;-7;0;Stadt Konstanz, Amt fuer Stadtplanung und Umwelt
21.01.2023 19:00;249;132;117;Leichte Schneeschauer;-1;-7;0;Stadt Konstanz, Amt fuer Stadtplanung und Umwelt
21.01.2023 20:00;171;99;72;Leicht bewoelkt;-2;-8;0;Stadt Konstanz, Amt fuer Stadtplanung und Umwelt
21.01.2023 21:00;156;84;72;Leicht bewoelkt;-2;-8;0;Stadt Konstanz, Amt fuer Stadtplanung und Umwelt
21.01.2023 22:00;132;62;70;Leicht bewoelkt;-2;-8;0;Stadt Konstanz, Amt fuer Stadtplanung und Umwelt
21.01.2023 23:00;105;47;58;Leichter Schneefall;-2;-7;0;Stadt Konstanz, Amt fuer Stadtplanung und Umwelt
22.01.2023 00:00;122;41;81;Leichter Schneefall;-2;-7;0;Stadt Konstanz, Amt fuer Stadtplanung und Umwelt
22.01.2023 01:00;79;21;58;Leichter Schneefall;-3;-7;0;Stadt Konstanz, Amt fuer Stadtplanung und Umwelt
22.01.2023 02:00;51;17;34;Bedeckt;-3;-7;0;Stadt Konstanz, Amt fuer Stadtplanung und Umwelt
22.01.2023 03:00;38;10;28;Bedeckt;-3;-6;0;Stadt Konstanz, Amt fuer Stadtplanung und Umwelt
22.01.2023 04:00;13;5;8;Bedeckt;-3;-6;0;Stadt Konstanz, Amt fuer Stadtplanung und Umwelt
22.01.2023 05:00;15;4;11;Maeßiger Schneefall;-3;-5;0;Stadt Konstanz, Amt fuer Stadtplanung und Umwelt
22.01.2023 06:00;23;11;12;Maeßiger Schneefall;-3;-4;0;Stadt Konstanz, Amt fuer Stadtplanung und Umwelt
22.01.2023 07:00;27;17;10;Maeßiger Schneefall;-3;-4;0;Stadt Konstanz, Amt fuer Stadtplanung und Umwelt
22.01.2023 08:00;45;18;27;Leichter Schneefall;-3;-3;0;Stadt Konstanz, Amt fuer Stadtplanung und Umwelt
22.01.2023 09:00;111;72;39;Leichter Schneefall;-3;-3;0;Stadt Konstanz, Amt fuer Stadtplanung und Umwelt
22.01.2023 10:00;131;84;47;Leichter Schneefall;-2;-2;0;Stadt Konstanz, Amt fuer Stadtplanung und Umwelt
22.01.2023 11:00;143;71;72;Maeßiger Schneefall;-1;-1;0;Stadt Konstanz, Amt fuer Stadtplanung und Umwelt
22.01.2023 12:00;169;54;115;Maeßiger Schneefall;-1;-1;0;Stadt Konstanz, Amt fuer Stadtplanung und Umwelt
22.01.2023 13:00;166;83;83;Maeßiger Schneefall;0;0;0;Stadt Konstanz, Amt fuer Stadtplanung und Umwelt
22.01.2023 14:00;184;93;91;Bewoelkt;0;0;0;Stadt Konstanz, Amt fuer Stadtplanung und Umwelt
22.01.2023 15:00;183;92;91;Bewoelkt;0;0;0;Stadt Konstanz, Amt fuer Stadtplanung und Umwelt
22.01.2023 16:00;198;94;104;Bewoelkt;-1;-1;0;Stadt Konstanz, Amt fuer Stadtplanung und Umwelt
22.01.2023 17:00;229;105;124;Leichter Schneefall;-2;-3;0;Stadt Konstanz, Amt fuer Stadtplanung und Umwelt
22.01.2023 18:00;213;90;123;Leichter Schneefall;-3;-4;0;Stadt Konstanz, Amt fuer Stadtplanung und Umwelt
22.01.2023 19:00;173;88;85;Leichter Schneefall;-3;-5;0;Stadt Konstanz, Amt fuer Stadtplanung und Umwelt
22.01.2023 20:00;137;72;65;Leichter Schneefall;-4;-5;0;Stadt Konstanz, Amt fuer Stadtplanung und Umwelt
22.01.2023 21:00;101;51;50;Leichter Schneefall;-4;-6;0;Stadt Konstanz, Amt fuer Stadtplanung und Umwelt
22.01.2023 22:00;72;29;43;Leichter Schneefall;-4;-6;0;Stadt Konstanz, Amt fuer Stadtplanung und Umwelt
22.01.2023 23:00;28;8;20;Bewoelkt;-3;-6;0;Stadt Konstanz, Amt fuer Stadtplanung und Umwelt
23.01.2023 00:00;28;8;20;Bewoelkt;-3;-5;0;Stadt Konstanz, Amt fuer Stadtplanung und Umwelt
23.01.2023 01:00;14;6;8;Bewoelkt;-3;-6;0;Stadt Konstanz, Amt fuer Stadtplanung und Umwelt
23.01.2023 02:00;2;2;0;Bedeckt;-3;-6;0;Stadt Konstanz, Amt fuer Stadtplanung und Umwelt
23.01.2023 03:00;2;1;1;Bedeckt;-4;-7;0;Stadt Konstanz, Amt fuer Stadtplanung und Umwelt
23.01.2023 04:00;8;6;2;Bedeckt;-4;-7;0;Stadt Konstanz, Amt fuer Stadtplanung und Umwelt
23.01.2023 05:00;47;26;21;Stellenweise leichter Schneefall;-4;-7;0;Stadt Konstanz, Amt fuer Stadtplanung und Umwelt
23.01.2023 06:00;128;68;60;Stellenweise leichter Schneefall;-4;-7;0;Stadt Konstanz, Amt fuer Stadtplanung und Umwelt
23.01.2023 07:00;868;506;362;Stellenweise leichter Schneefall;-4;-7;0;Stadt Konstanz, Amt fuer Stadtplanung und Umwelt
23.01.2023 08:00;628;331;297;Bewoelkt;-4;-8;0;Stadt Konstanz, Amt fuer Stadtplanung und Umwelt
23.01.2023 09:00;550;317;233;Bewoelkt;-4;-8;0;Stadt Konstanz, Amt fuer Stadtplanung und Umwelt
23.01.2023 10:00;299;153;146;Bewoelkt;-3;-7;0;Stadt Konstanz, Amt fuer Stadtplanung und Umwelt
23.01.2023 11:00;392;201;191;Bewoelkt;-2;-6;0;Stadt Konstanz, Amt fuer Stadtplanung und Umwelt
23.01.2023 12:00;462;201;261;Bewoelkt;-1;-5;0;Stadt Konstanz, Amt fuer Stadtplanung und Umwelt
23.01.2023 13:00;664;296;368;Bewoelkt;0;-5;0;Stadt Konstanz, Amt fuer Stadtplanung und Umwelt
23.01.2023 14:00;468;226;242;Bewoelkt;0;-4;0;Stadt Konstanz, Amt fuer Stadtplanung und Umwelt
23.01.2023 15:00;692;321;371;Bewoelkt;1;-4;0;Stadt Konstanz, Amt fuer Stadtplanung und Umwelt
23.01.2023 16:00;595;273;322;Bewoelkt;0;-4;0;Stadt Konstanz, Amt fuer Stadtplanung und Umwelt
23.01.2023 17:00;712;332;380;Bewoelkt;0;-4;0;Stadt Konstanz, Amt fuer Stadtplanung und Umwelt
23.01.2023 18:00;568;266;302;Bewoelkt;0;-4;0;Stadt Konstanz, Amt fuer Stadtplanung und Umwelt
23.01.2023 19:00;438;202;236;Bewoelkt;0;-5;0;Stadt Konstanz, Amt fuer Stadtplanung und Umwelt
23.01.2023 20:00;297;149;148;Leichter Schneefall;-1;-5;0;Stadt Konstanz, Amt fuer Stadtplanung und Umwelt
23.01.2023 21:00;195;91;104;Leichter Schneefall;-1;-5;0;Stadt Konstanz, Amt fuer Stadtplanung und Umwelt
23.01.2023 22:00;185;92;93;Leichter Schneefall;-1;-5;0;Stadt Konstanz, Amt fuer Stadtplanung und Umwelt
23.01.2023 23:00;86;26;60;Leichter Schneefall;-1;-5;0;Stadt Konstanz, Amt fuer Stadtplanung und Umwelt
24.01.2023 00:00;34;12;22;Leichter Schneefall;-1;-5;0;Stadt Konstanz, Amt fuer Stadtplanung und Umwelt
24.01.2023 01:00;21;5;16;Leichter Schneefall;-1;-5;0;Stadt Konstanz, Amt fuer Stadtplanung und Umwelt
24.01.2023 02:00;5;2;3;Leichter Schneefall;-1;-5;0;Stadt Konstanz, Amt fuer Stadtplanung und Umwelt
24.01.2023 03:00;4;0;4;Leichter Schneefall;-1;-5;0;Stadt Konstanz, Amt fuer Stadtplanung und Umwelt
24.01.2023 04:00;7;4;3;Leichter Schneefall;-1;-5;0;Stadt Konstanz, Amt fuer Stadtplanung und Umwelt
24.01.2023 05:00;51;36;15;Leichter Schneefall;-1;-5;0;Stadt Konstanz, Amt fuer Stadtplanung und Umwelt
24.01.2023 06:00;151;88;63;Leichter Schneefall;-1;-5;0;Stadt Konstanz, Amt fuer Stadtplanung und Umwelt
24.01.2023 07:00;870;493;377;Leichter Schneefall;-1;-5;0;Stadt Konstanz, Amt fuer Stadtplanung und Umwelt
24.01.2023 08:00;711;373;338;Leichter Schneefall;-1;-5;0;Stadt Konstanz, Amt fuer Stadtplanung und Umwelt
24.01.2023 09:00;634;361;273;Leichter Schneefall;-1;-4;0;Stadt Konstanz, Amt fuer Stadtplanung und Umwelt
24.01.2023 10:00;341;194;147;Leichter Schneefall;0;-4;0;Stadt Konstanz, Amt fuer Stadtplanung und Umwelt
24.01.2023 11:00;451;239;212;Leicht bewoelkt;0;-3;0;Stadt Konstanz, Amt fuer Stadtplanung und Umwelt
24.01.2023 12:00;607;217;390;Leicht bewoelkt;1;-2;0;Stadt Konstanz, Amt fuer Stadtplanung und Umwelt
24.01.2023 13:00;718;356;362;Leicht bewoelkt;1;-2;0;Stadt Konstanz, Amt fuer Stadtplanung und Umwelt
24.01.2023 14:00;496;235;261;Leicht bewoelkt;1;-1;0;Stadt Konstanz, Amt fuer Stadtplanung und Umwelt
24.01.2023 15:00;694;327;367;Leicht bewoelkt;2;-1;0;Stadt Konstanz, Amt fuer Stadtplanung und Umwelt
24.01.2023 16:00;713;327;386;Leicht bewoelkt;1;-1;0;Stadt Konstanz, Amt fuer Stadtplanung und Umwelt
24.01.2023 17:00;842;403;439;Bedeckt;1;-2;0;Stadt Konstanz, Amt fuer Stadtplanung und Umwelt
24.01.2023 18:00;678;288;390;Bedeckt;1;-2;0;Stadt Konstanz, Amt fuer Stadtplanung und Umwelt
24.01.2023 19:00;473;243;230;Bedeckt;0;-2;0;Stadt Konstanz, Amt fuer Stadtplanung und Umwelt
24.01.2023 20:00;347;156;191;Leichter Schneefall;0;-1;0;Stadt Konstanz, Amt fuer Stadtplanung und Umwelt
24.01.2023 21:00;218;92;126;Leichter Schneefall;0;-1;0;Stadt Konstanz, Amt fuer Stadtplanung und Umwelt
24.01.2023 22:00;178;66;112;Leichter Schneefall;0;-1;0;Stadt Konstanz, Amt fuer Stadtplanung und Umwelt
24.01.2023 23:00;95;38;57;Leichter Nebel;-1;-2;0;Stadt Konstanz, Amt fuer Stadtplanung und Umwelt
25.01.2023 00:00;49;15;34;Leichter Nebel;-1;-2;0;Stadt Konstanz, Amt fuer Stadtplanung und Umwelt
25.01.2023 01:00;20;11;9;Leichter Nebel;-1;-2;0;Stadt Konstanz, Amt fuer Stadtplanung und Umwelt
25.01.2023 02:00;12;5;7;Bedeckt;-1;-3;0;Stadt Konstanz, Amt fuer Stadtplanung und Umwelt
25.01.2023 03:00;13;1;12;Bedeckt;0;-3;0;Stadt Konstanz, Amt fuer Stadtplanung und Umwelt
25.01.2023 04:00;7;3;4;Bedeckt;0;-3;0;Stadt Konstanz, Amt fuer Stadtplanung und Umwelt
25.01.2023 05:00;49;29;20;Bedeckt;-1;-3;0;Stadt Konstanz, Amt fuer Stadtplanung und Umwelt
25.01.2023 06:00;161;89;72;Bedeckt;-1;-3;0;Stadt Konstanz, Amt fuer Stadtplanung und Umwelt
25.01.2023 07:00;860;496;364;Bedeckt;-1;-3;0;Stadt Konstanz, Amt fuer Stadtplanung und Umwelt
25.01.2023 08:00;707;376;331;Bedeckt;-1;-3;0;Stadt Konstanz, Amt fuer Stadtplanung und Umwelt
25.01.2023 09:00;586;340;246;Bedeckt;-1;-4;0;Stadt Konstanz, Amt fuer Stadtplanung und Umwelt
25.01.2023 10:00;338;199;139;Bedeckt;0;-3;0;Stadt Konstanz, Amt fuer Stadtplanung und Umwelt
25.01.2023 11:00;399;182;217;Bedeckt;1;-2;0;Stadt Konstanz, Amt fuer Stadtplanung und Umwelt
25.01.2023 12:00;489;219;270;Bedeckt;2;-1;0;Stadt Konstanz, Amt fuer Stadtplanung und Umwelt
25.01.2023 13:00;760;370;390;Bedeckt;2;-1;0;Stadt Konstanz, Amt fuer Stadtplanung und Umwelt
25.01.2023 14:00;522;247;275;Leicht bewoelkt;2;-1;0;Stadt Konstanz, Amt fuer Stadtplanung und Umwelt
25.01.2023 15:00;676;302;374;Leicht bewoelkt;3;0;0;Stadt Konstanz, Amt fuer Stadtplanung und Umwelt
25.01.2023 16:00;762;366;396;Leicht bewoelkt;1;-2;0;Stadt Konstanz, Amt fuer Stadtplanung und Umwelt
25.01.2023 17:00;753;333;420;Sonnig;0;-3;0;Stadt Konstanz, Amt fuer Stadtplanung und Umwelt
25.01.2023 18:00;612;258;354;Sonnig;-2;-4;0;Stadt Konstanz, Amt fuer Stadtplanung und Umwelt
25.01.2023 19:00;462;214;248;Sonnig;-2;-4;0;Stadt Konstanz, Amt fuer Stadtplanung und Umwelt
25.01.2023 20:00;321;148;173;Sonnig;-3;-5;0;Stadt Konstanz, Amt fuer Stadtplanung und Umwelt
25.01.2023 21:00;195;96;99;Sonnig;-3;-5;0;Stadt Konstanz, Amt fuer Stadtplanung und Umwelt
25.01.2023 22:00;198;87;111;Sonnig;-3;-4;0;Stadt Konstanz, Amt fuer Stadtplanung und Umwelt
25.01.2023 23:00;106;36;70;Bedeckt;-2;-3;0;Stadt Konstanz, Amt fuer Stadtplanung und Umwelt
26.01.2023 00:00;52;24;28;Bedeckt;-1;-3;0;Stadt Konstanz, Amt fuer Stadtplanung und Umwelt
26.01.2023 01:00;35;13;22;Bedeckt;-1;-2;0;Stadt Konstanz, Amt fuer Stadtplanung und Umwelt
26.01.2023 02:00;18;6;12;Bedeckt;-1;-1;0;Stadt Konstanz, Amt fuer Stadtplanung und Umwelt
26.01.2023 03:00;3;1;2;Bedeckt;0;0;0;Stadt Konstanz, Amt fuer Stadtplanung und Umwelt
26.01.2023 04:00;7;5;2;Bedeckt;0;0;0;Stadt Konstanz, Amt fuer Stadtplanung und Umwelt
26.01.2023 05:00;48;33;15;Bewoelkt;-1;-1;0;Stadt Konstanz, Amt fuer Stadtplanung und Umwelt
26.01.2023 06:00;142;77;65;Bewoelkt;-1;-1;0;Stadt Konstanz, Amt fuer Stadtplanung und Umwelt
26.01.2023 07:00;827;491;336;Bewoelkt;-1;-1;0;Stadt Konstanz, Amt fuer Stadtplanung und Umwelt
26.01.2023 08:00;688;356;332;Bedeckt;0;0;0;Stadt Konstanz, Amt fuer Stadtplanung und Umwelt
26.01.2023 09:00;627;380;247;Bedeckt;0;0;0;Stadt Konstanz, Amt fuer Stadtplanung und Umwelt
26.01.2023 10:00;312;163;149;Bedeckt;1;0;0;Stadt Konstanz, Amt fuer Stadtplanung und Umwelt
26.01.2023 11:00;476;243;233;Bedeckt;1;1;0;Stadt Konstanz, Amt fuer Stadtplanung und Umwelt
26.01.2023 12:00;500;208;292;Bedeckt;2;1;0;Stadt Konstanz, Amt fuer Stadtplanung und Umwelt
26.01.2023 13:00;732;301;431;Bedeckt;2;1;0;Stadt Konstanz, Amt fuer Stadtplanung und Umwelt
26.01.2023 14:00;493;228;265;Bedeckt;2;0;0;Stadt Konstanz, Amt fuer Stadtplanung und Umwelt
26.01.2023 15:00;799;391;408;Bedeckt;2;-1;0;Stadt Konstanz, Amt fuer Stadtplanung und Umwelt
26.01.2023 16:00;681;319;362;Bedeckt;1;-1;0;Stadt Konstanz, Amt fuer Stadtplanung und Umwelt
26.01.2023 17:00;864;404;460;Bewoelkt;1;-2;0;Stadt Konstanz, Amt fuer Stadtplanung und Umwelt
26.01.2023 18:00;656;293;363;Bewoelkt;0;-3;0;Stadt Konstanz, Amt fuer Stadtplanung und Umwelt
26.01.2023 19:00;490;221;269;Bewoelkt;0;-3;0;Stadt Konstanz, Amt fuer Stadtplanung und Umwelt
26.01.2023 20:00;315;135;180;Bedeckt;0;-3;0;Stadt Konstanz, Amt fuer Stadtplanung und Umwelt
26.01.2023 21:00;251;118;133;Bedeckt;0;-3;0;Stadt Konstanz, Amt fuer Stadtplanung und Umwelt
26.01.2023 22:00;172;71;101;Bedeckt;0;-3;0;Stadt Konstanz, Amt fuer Stadtplanung und Umwelt
26.01.2023 23:00;140;72;68;Leichte Schneeschauer;0;-3;0;Stadt Konstanz, Amt fuer Stadtplanung und Umwelt
27.01.2023 00:00;83;29;54;Leichte Schneeschauer;0;-3;0;Stadt Konstanz, Amt fuer Stadtplanung und Umwelt
27.01.2023 01:00;31;11;20;Leichte Schneeschauer;-1;-4;0;Stadt Konstanz, Amt fuer Stadtplanung und Umwelt
27.01.2023 02:00;14;8;6;Stellenweise leichter Schneefall;-1;-5;0;Stadt Konstanz, Amt fuer Stadtplanung und Umwelt
27.01.2023 03:00;6;1;5;Stellenweise leichter Schneefall;-2;-6;0;Stadt Konstanz, Amt fuer Stadtplanung und Umwelt
27.01.2023 04:00;8;7;1;Stellenweise leichter Schneefall;-2;-6;0;Stadt Konstanz, Amt fuer Stadtplanung und Umwelt
27.01.2023 05:00;36;26;10;Leichte Schneeschauer;-2;-7;0;Stadt Konstanz, Amt fuer Stadtplanung und Umwelt
27.01.2023 06:00;140;79;61;Leichte Schneeschauer;-3;-7;0;Stadt Konstanz, Amt fuer Stadtplanung und Umwelt
27.01.2023 07:00;770;441;329;Leichte Schneeschauer;-3;-7;0;Stadt Konstanz, Amt fuer Stadtplanung und Umwelt
27.01.2023 08:00;617;347;270;Bewoelkt;-2;-7;0;Stadt Konstanz, Amt fuer Stadtplanung und Umwelt
27.01.2023 09:00;587;332;255;Bewoelkt;-2;-7;0;Stadt Konstanz, Amt fuer Stadtplanung und Umwelt
27.01.2023 10:00;405;237;168;Bewoelkt;-1;-6;0;Stadt Konstanz, Amt fuer Stadtplanung und Umwelt
27.01.2023 11:00;466;234;232;Leichter Schneefall;-1;-5;0;Stadt Konstanz, Amt fuer Stadtplanung und Umwelt
27.01.2023 12:00;617;300;317;Leichter Schneefall;0;-4;0;Stadt Konstanz, Amt fuer Stadtplanung und Umwelt
27.01.2023 13:00;758;297;461;Leichter Schneefall;0;-4;0;Stadt Konstanz, Amt fuer Stadtplanung und Umwelt
27.01.2023 14:00;514;239;275;Bewoelkt;1;-4;0;Stadt Konstanz, Amt fuer Stadtplanung und Umwelt
27.01.2023 15:00;557;271;286;Bewoelkt;1;-4;0;Stadt Konstanz, Amt fuer Stadtplanung und Umwelt
27.01.2023 16:00;500;231;269;Bewoelkt;0;-4;0;Stadt Konstanz, Amt fuer Stadtplanung und Umwelt
27.01.2023 17:00;608;275;333;Stellenweise leichter Schneefall;-1;-5;0;Stadt Konstanz, Amt fuer Stadtplanung und Umwelt
27.01.2023 18:00;472;221;251;Stellenweise leichter Schneefall;-1;-6;0;Stadt Konstanz, Amt fuer Stadtplanung und Umwelt
27.01.2023 19:00;376;209;167;Stellenweise leichter Schneefall;-2;-7;0;Stadt Konstanz, Amt fuer Stadtplanung und Umwelt
27.01.2023 20:00;264;124;140;Leicht bewoelkt;-3;-7;0;Stadt Konstanz, Amt fuer Stadtplanung und Umwelt
27.01.2023 21:00;193;82;111;Leicht bewoelkt;-3;-8;0;Stadt Konstanz, Amt fuer Stadtplanung und Umwelt
27.01.2023 22:00;184;87;97;Leicht bewoelkt;-3;-8;0;Stadt Konstanz, Amt fuer Stadtplanung und Umwelt
27.01.2023 23:00;112;33;79;Leichter Schneefall;-3;-7;0;Stadt Konstanz, Amt fuer Stadtplanung und Umwelt
28.01.2023 00:00;100;25;75;Leichter Schneefall;-3;-7;0;Stadt Konstanz, Amt fuer Stadtplanung und Umwelt
28.01.2023 01:00;77;24;53;Leichter Schneefall;-3;-7;0;Stadt Konstanz, Amt fuer Stadtplanung und Umwelt
28.01.2023 02:00;49;19;30;Leichter Schneefall;-2;-7;0;Stadt Konstanz, Amt fuer Stadtplanung und Umwelt
28.01.2023 03:00;33;12;21;Leichter Schneefall;-2;-6;0;Stadt Konstanz, Amt fuer Stadtplanung und Umwelt
28.01.2023 04:00;22;10;12;Leichter Schneefall;-2;-6;0;Stadt Konstanz, Amt fuer Stadtplanung und Umwelt
28.01.2023 05:00;34;24;10;Leichter Schneefall;-2;-7;0;Stadt Konstanz, Amt fuer Stadtplanung und Umwelt
28.01.2023 06:00;41;25;16;Leichter Schneefall;-3;-7;0;Stadt Konstanz, Amt fuer Stadtplanung und Umwelt
28.01.2023 07:00;55;27;28;Leichter Schneefall;-3;-7;0;Stadt Konstanz, Amt fuer Stadtplanung und Umwelt
28.01.2023 08:00;151;79;72;Leicht bewoelkt;-3;-7;0;Stadt Konstanz, Amt fuer Stadtplanung und Umwelt
28.01.2023 09:00;309;173;136;Leicht bewoelkt;-3;-7;0;Stadt Konstanz, Amt fuer Stadtplanung und Umwelt
28.01.2023 10:00;376;225;151;Leicht bewoelkt;-2;-5;0;Stadt Konstanz, Amt fuer Stadtplanung und Umwelt
28.01.2023 11:00;358;184;174;Leichter Schneefall;-1;-4;0;Stadt Konstanz, Amt fuer Stadtplanung und Umwelt
28.01.2023 12:00;370;197;173;Leichter Schneefall;1;-3;0;Stadt Konstanz, Amt fuer Stadtplanung und Umwelt
28.01.2023 13:00;402;210;192;Leichter Schneefall;1;-3;0;Stadt Konstanz, Amt fuer Stadtplanung und Umwelt
28.01.2023 14:00;432;199;233;Bedeckt;1;-3;0;Stadt Konstanz, Amt fuer Stadtplanung und Umwelt
28.01.2023 15:00;367;152;215;Bedeckt;1;-3;0;Stadt Konstanz, Amt fuer Stadtplanung und Umwelt
28.01.2023 16:00;334;163;171;Bedeckt;0;-4;0;Stadt Konstanz, Amt fuer Stadtplanung und Umwelt
28.01.2023 17:00;323;133;190;Bewoelkt;-1;-5;0;Stadt Konstanz, Amt fuer Stadtplanung und Umwelt
28.01.2023 18:00;364;161;203;Bewoelkt;-2;-6;0;Stadt Konstanz, Amt fuer Stadtplanung und Umwelt
28.01.2023 19:00;272;159;113;Bewoelkt;-1;-6;0;Stadt Konstanz, Amt fuer Stadtplanung und Umwelt
28.01.2023 20:00;200;103;97;Bewoelkt;-1;-5;0;Stadt Konstanz, Amt fuer Stadtplanung und Umwelt
28.01.2023 21:00;180;93;87;Bewoelkt;-1;-5;0;Stadt Konstanz, Amt fuer Stadtplanung und Umwelt
28.01.2023 22:00;176;68;108;Bewoelkt;-3;-6;0;Stadt Konstanz, Amt fuer Stadtplanung und Umwelt
28.01.2023 23:00;123;34;89;Leicht bewoelkt;-4;-7;0;Stadt Konstanz, Amt fuer Stadtplanung und Umwelt
29.01.2023 00:00;133;38;95;Leicht bewoelkt;-5;-7;0;Stadt Konstanz, Amt fuer Stadtplanung und Umwelt
29.01.2023 01:00;73;30;43;Leicht bewoelkt;-5;-7;0;Stadt Konstanz, Amt fuer Stadtplanung und Umwelt
29.01.2023 02:00;61;21;40;Leicht bewoelkt;-5;-8;0;Stadt Konstanz, Amt fuer Stadtplanung und Umwelt
29.01.2023 03:00;40;14;26;Leicht bewoelkt;-6;-8;0;Stadt Konstanz, Amt fuer Stadtplanung und Umwelt
29.01.2023 04:00;40;28;12;Leicht bewoelkt;-6;-8;0;Stadt Konstanz, Amt fuer Stadtplanung und Umwelt
29.01.2023 05:00;22;12;10;Sonnig;-6;-8;0;Stadt Konstanz, Amt fuer Stadtplanung und Umwelt
29.01.2023 06:00;23;14;9;Sonnig;-6;-8;0;Stadt Konstanz, Amt fuer Stadtplanung und Umwelt
29.01.2023 07:00;23;13;10;Sonnig;-6;-7;0;Stadt Konstanz, Amt fuer Stadtplanung und Umwelt
29.01.2023 08:00;61;40;21;Leicht bewoelkt;-5;-6;0;Stadt Konstanz, Amt fuer Stadtplanung und Umwelt
29.01.2023 09:00;165;101;64;Leicht bewoelkt;-5;-5;0;Stadt Konstanz, Amt fuer Stadtplanung und Umwelt
29.01.2023 10:00;156;99;57;Leicht bewoelkt;-3;-4;0;Stadt Konstanz, Amt fuer Stadtplanung und Umwelt
29.01.2023 11:00;190;104;86;Bewoelkt;-2;-2;0;Stadt Konstanz, Amt fuer Stadtplanung und Umwelt
29.01.2023 12:00;211;110;101;Bewoelkt;0;-1;0;Stadt Konstanz, Amt fuer Stadtplanung und Umwelt
29.01.2023 13:00;229;110;119;Bewoelkt;1;0;0;Stadt Konstanz, Amt fuer Stadtplanung und Umwelt
29.01.2023 14:00;249;128;121;Sonnig;1;0;0;Stadt Konstanz, Amt fuer Stadtplanung und Umwelt
29.01.2023 15:00;248;121;127;Sonnig;2;1;0;Stadt Konstanz, Amt fuer Stadtplanung und Umwelt
29.01.2023 16:00;229;107;122;Sonnig;0;-1;0;Stadt Konstanz, Amt fuer Stadtplanung und Umwelt
29.01.2023 17:00;253;100;153;Sonnig;-2;-3;0;Stadt Konstanz, Amt fuer Stadtplanung und Umwelt
29.01.2023 18:00;231;88;143;Sonnig;-4;-5;0;Stadt Konstanz, Amt fuer Stadtplanung und Umwelt
29.01.2023 19:00;169;79;90;Sonnig;-5;-6;0;Stadt Konstanz, Amt fuer Stadtplanung und Umwelt
29.01.2023 20:00;131;55;76;Sonnig;-5;-7;0;Stadt Konstanz, Amt fuer Stadtplanung und Umwelt
29.01.2023 21:00;108;46;62;Sonnig;-6;-8;0;Stadt Konstanz, Amt fuer Stadtplanung und Umwelt
29.01.2023 22:00;55;24;31;Sonnig;-6;-8;0;Stadt Konstanz, Amt fuer Stadtplanung und Umwelt
29.01.2023 23:00;42;17;25;Sonnig;-6;-8;0;Stadt Konstanz, Amt fuer Stadtplanung und Umwelt
30.01.2023 00:00;25;10;15;Sonnig;-6;-8;0;Stadt Konstanz, Amt fuer Stadtplanung und Umwelt
30.01.2023 01:00;18;6;12;Sonnig;-6;-8;0;Stadt Konstanz, Amt fuer Stadtplanung und Umwelt
30.01.2023 02:00;5;0;5;Sonnig;-6;-8;0;Stadt Konstanz, Amt fuer Stadtplanung und Umwelt
30.01.2023 03:00;5;1;4;Sonnig;-5;-8;0;Stadt Konstanz, Amt fuer Stadtplanung und Umwelt
30.01.2023 04:00;11;6;5;Sonnig;-5;-8;0;Stadt Konstanz, Amt fuer Stadtplanung und Umwelt
30.01.2023 05:00;40;27;13;Bewoelkt;-4;-7;0;Stadt Konstanz, Amt fuer Stadtplanung und Umwelt
30.01.2023 06:00;143;82;61;Bewoelkt;-3;-7;0;Stadt Konstanz, Amt fuer Stadtplanung und Umwelt
30.01.2023 07:00;810;466;344;Bewoelkt;-2;-6;0;Stadt Konstanz, Amt fuer Stadtplanung und Umwelt
30.01.2023 08:00;684;380;304;Leicht bewoelkt;-2;-6;0;Stadt Konstanz, Amt fuer Stadtplanung und Umwelt
30.01.2023 09:00;527;267;260;Leicht bewoelkt;-1;-5;0;Stadt Konstanz, Amt fuer Stadtplanung und Umwelt
30.01.2023 10:00;352;210;142;Leicht bewoelkt;1;-3;0;Stadt Konstanz, Amt fuer Stadtplanung und Umwelt
30.01.2023 11:00;381;189;192;Leicht bewoelkt;2;-2;0;Stadt Konstanz, Amt fuer Stadtplanung und Umwelt
30.01.2023 12:00;548;248;300;Leicht bewoelkt;4;0;0;Stadt Konstanz, Amt fuer Stadtplanung und Umwelt
30.01.2023 13:00;646;289;357;Leicht bewoelkt;3;-1;0;Stadt Konstanz, Amt fuer Stadtplanung und Umwelt
30.01.2023 14:00;480;234;246;Starker Schneefall;3;-2;0.2;Stadt Konstanz, Amt fuer Stadtplanung und Umwelt
30.01.2023 15:00;673;343;330;Starker Schneefall;2;-3;0.2;Stadt Konstanz, Amt fuer Stadtplanung und Umwelt
30.01.2023 16:00;655;304;351;Starker Schneefall;2;-3;0.1;Stadt Konstanz, Amt fuer Stadtplanung und Umwelt
30.01.2023 17:00;730;335;395;Starker Schneefall;2;-3;0.2;Stadt Konstanz, Amt fuer Stadtplanung und Umwelt
30.01.2023 18:00;616;287;329;Starker Schneefall;2;-2;0.2;Stadt Konstanz, Amt fuer Stadtplanung und Umwelt
30.01.2023 19:00;428;224;204;Starker Schneefall;2;-3;0.1;Stadt Konstanz, Amt fuer Stadtplanung und Umwelt
30.01.2023 20:00;284;131;153;Leichte Schneeschauer;1;-3;0;Stadt Konstanz, Amt fuer Stadtplanung und Umwelt
30.01.2023 21:00;159;85;74;Leichte Schneeschauer;1;-4;0;Stadt Konstanz, Amt fuer Stadtplanung und Umwelt
30.01.2023 22:00;163;66;97;Leichte Schneeschauer;1;-4;0;Stadt Konstanz, Amt fuer Stadtplanung und Umwelt
30.01.2023 23:00;71;35;36;Leichte Schneeschauer;0;-4;0;Stadt Konstanz, Amt fuer Stadtplanung und Umwelt
31.01.2023 00:00;34;18;16;Leichte Schneeschauer;0;-4;0.1;Stadt Konstanz, Amt fuer Stadtplanung und Umwelt
31.01.2023 01:00;12;5;7;Leichte Schneeschauer;0;-4;0;Stadt Konstanz, Amt fuer Stadtplanung und Umwelt
31.01.2023 02:00;12;4;8;Maeßiger Schneefall;0;-4;0;Stadt Konstanz, Amt fuer Stadtplanung und Umwelt
31.01.2023 03:00;6;1;5;Maeßiger Schneefall;0;-4;0;Stadt Konstanz, Amt fuer Stadtplanung und Umwelt
31.01.2023 04:00;11;3;8;Maeßiger Schneefall;0;-4;0;Stadt Konstanz, Amt fuer Stadtplanung und Umwelt
31.01.2023 05:00;39;23;16;Maeßige bis starke Schneefaelle;0;-4;0.1;Stadt Konstanz, Amt fuer Stadtplanung und Umwelt
31.01.2023 06:00;148;91;57;Maeßige bis starke Schneefaelle;0;-4;0.1;Stadt Konstanz, Amt fuer Stadtplanung und Umwelt
31.01.2023 07:00;764;399;365;Maeßige bis starke Schneefaelle;0;-4;0;Stadt Konstanz, Amt fuer Stadtplanung und Umwelt
31.01.2023 08:00;739;403;336;Leicht bewoelkt;0;-3;0;Stadt Konstanz, Amt fuer Stadtplanung und Umwelt
31.01.2023 09:00;619;361;258;Leicht bewoelkt;0;-3;0;Stadt Konstanz, Amt fuer Stadtplanung und Umwelt
31.01.2023 10:00;377;222;155;Leicht bewoelkt;1;-2;0;Stadt Konstanz, Amt fuer Stadtplanung und Umwelt
31.01.2023 11:00;480;219;261;Stellenweiser Schneefall;2;-1;0;Stadt Konstanz, Amt fuer Stadtplanung und Umwelt
31.01.2023 12:00;560;233;327;Stellenweiser Schneefall;3;0;0;Stadt Konstanz, Amt fuer Stadtplanung und Umwelt
31.01.2023 13:00;683;294;389;Stellenweiser Schneefall;3;1;0;Stadt Konstanz, Amt fuer Stadtplanung und Umwelt
31.01.2023 14:00;581;297;284;Bewoelkt;3;1;0;Stadt Konstanz, Amt fuer Stadtplanung und Umwelt
31.01.2023 15:00;632;314;318;Bewoelkt;3;1;0;Stadt Konstanz, Amt fuer Stadtplanung und Umwelt
31.01.2023 16:00;692;333;359;Bewoelkt;2;0;0;Stadt Konstanz, Amt fuer Stadtplanung und Umwelt
31.01.2023 17:00;759;355;404;Sonnig;1;-1;0;Stadt Konstanz, Amt fuer Stadtplanung und Umwelt
31.01.2023 18:00;691;290;401;Sonnig;0;-2;0;Stadt Konstanz, Amt fuer Stadtplanung und Umwelt
31.01.2023 19:00;508;252;256;Sonnig;0;-3;0;Stadt Konstanz, Amt fuer Stadtplanung und Umwelt
31.01.2023 20:00;297;139;158;Leicht bewoelkt;0;-3;0;Stadt Konstanz, Amt fuer Stadtplanung und Umwelt
31.01.2023 21:00;242;105;137;Leicht bewoelkt;0;-3;0;Stadt Konstanz, Amt fuer Stadtplanung und Umwelt
31.01.2023 22:00;173;59;114;Leicht bewoelkt;0;-3;0;Stadt Konstanz, Amt fuer Stadtplanung und Umwelt
31.01.2023 23:00;77;34;43;Leicht bewoelkt;0;-3;0;Stadt Konstanz, Amt fuer Stadtplanung und Umwelt
01.02.2023 00:00;49;32;17;Leicht bewoelkt;0;-4;0;Stadt Konstanz, Amt fuer Stadtplanung und Umwelt
01.02.2023 01:00;27;13;14;Leicht bewoelkt;0;-4;0;Stadt Konstanz, Amt fuer Stadtplanung und Umwelt
01.02.2023 02:00;12;5;7;Bewoelkt;0;-4;0;Stadt Konstanz, Amt fuer Stadtplanung und Umwelt
01.02.2023 03:00;3;1;2;Bewoelkt;0;-4;0;Stadt Konstanz, Amt fuer Stadtplanung und Umwelt
01.02.2023 04:00;8;3;5;Bewoelkt;0;-4;0;Stadt Konstanz, Amt fuer Stadtplanung und Umwelt
01.02.2023 05:00;52;31;21;Leicht bewoelkt;1;-3;0;Stadt Konstanz, Amt fuer Stadtplanung und Umwelt
01.02.2023 06:00;146;83;63;Leicht bewoelkt;1;-3;0;Stadt Konstanz, Amt fuer Stadtplanung und Umwelt
01.02.2023 07:00;848;492;356;Leicht bewoelkt;1;-3;0;Stadt Konstanz, Amt fuer Stadtplanung und Umwelt
01.02.2023 08:00;643;364;279;Bewoelkt;2;-2;0;Stadt Konstanz, Amt fuer Stadtplanung und Umwelt
01.02.2023 09:00;601;347;254;Bewoelkt;2;-2;0;Stadt Konstanz, Amt fuer Stadtplanung und Umwelt
01.02.2023 10:00;394;207;187;Bewoelkt;2;-2;0;Stadt Konstanz, Amt fuer Stadtplanung und Umwelt
01.02.2023 11:00;399;189;210;Maeßiger Schneefall;2;-2;0.2;Stadt Konstanz, Amt fuer Stadtplanung und Umwelt
01.02.2023 12:00;501;220;281;Maeßiger Schneefall;2;-2;0.2;Stadt Konstanz, Amt fuer Stadtplanung und Umwelt
01.02.2023 13:00;718;340;378;Maeßiger Schneefall;3;-2;0.1;Stadt Konstanz, Amt fuer Stadtplanung und Umwelt
01.02.2023 14:00;515;244;271;Starker Schneefall;3;-2;0.2;Stadt Konstanz, Amt fuer Stadtplanung und Umwelt
01.02.2023 15:00;606;262;344;Starker Schneefall;3;-2;0.2;Stadt Konstanz, Amt fuer Stadtplanung und Umwelt
01.02.2023 16:00;659;318;341;Starker Schneefall;3;-2;0.1;Stadt Konstanz, Amt fuer Stadtplanung und Umwelt
01.02.2023 17:00;719;310;409;Starker Schneefall;3;-2;0.1;Stadt Konstanz, Amt fuer Stadtplanung und Umwelt
01.02.2023 18:00;654;275;379;Starker Schneefall;3;-3;0.2;Stadt Konstanz, Amt fuer Stadtplanung und Umwelt
01.02.2023 19:00;442;203;239;Starker Schneefall;2;-3;0.1;Stadt Konstanz, Amt fuer Stadtplanung und Umwelt
01.02.2023 20:00;324;163;161;Schneesturm;2;-3;0.8;Stadt Konstanz, Amt fuer Stadtplanung und Umwelt
01.02.2023 21:00;229;123;106;Schneesturm;2;-3;1.1;Stadt Konstanz, Amt fuer Stadtplanung und Umwelt
01.02.2023 22:00;198;81;117;Schneesturm;2;-3;0.5;Stadt Konstanz, Amt fuer Stadtplanung und Umwelt
01.02.2023 23:00;101;38;63;Bedeckt;2;-2;0;Stadt Konstanz, Amt fuer Stadtplanung und Umwelt
02.02.2023 00:00;53;25;28;Bedeckt;2;-2;0;Stadt Konstanz, Amt fuer Stadtplanung und Umwelt
02.02.2023 01:00;20;8;12;Bedeckt;2;-2;0;Stadt Konstanz, Amt fuer Stadtplanung und Umwelt
02.02.2023 02:00;10;4;6;Bedeckt;2;-2;0;Stadt Konstanz, Amt fuer Stadtplanung und Umwelt
02.02.2023 03:00;7;4;3;Bedeckt;2;-2;0;Stadt Konstanz, Amt fuer Stadtplanung und Umwelt
02.02.2023 04:00;6;4;2;Bedeckt;2;-2;0;Stadt Konstanz, Amt fuer Stadtplanung und Umwelt
02.02.2023 05:00;47;27;20;Bedeckt;2;-2;0;Stadt Konstanz, Amt fuer Stadtplanung und Umwelt
02.02.2023 06:00;169;96;73;Bedeckt;2;-2;0;Stadt Konstanz, Amt fuer Stadtplanung und Umwelt
02.02.2023 07:00;763;439;324;Bedeckt;3;-2;0;Stadt Konstanz, Amt fuer Stadtplanung und Umwelt
02.02.2023 08:00;707;388;319;Bedeckt;3;-2;0;Stadt Konstanz, Amt fuer Stadtplanung und Umwelt
02.02.2023 09:00;546;282;264;Bedeckt;3;-2;0;Stadt Konstanz, Amt fuer Stadtplanung und Umwelt
02.02.2023 10:00;372;213;159;Bedeckt;3;-1;0;Stadt Konstanz, Amt fuer Stadtplanung und Umwelt
02.02.2023 11:00;484;222;262;Stellenweiser Regenfall;4;-1;0;Stadt Konstanz, Amt fuer Stadtplanung und Umwelt
02.02.2023 12:00;488;217;271;Stellenweiser Regenfall;4;0;0;Stadt Konstanz, Amt fuer Stadtplanung und Umwelt
02.02.2023 13:00;697;284;413;Stellenweiser Regenfall;4;0;0;Stadt Konstanz, Amt fuer Stadtplanung und Umwelt
02.02.2023 14:00;527;249;278;Bedeckt;5;0;0;Stadt Konstanz, Amt fuer Stadtplanung und Umwelt
02.02.2023 15:00;773;392;381;Bedeckt;5;1;0;Stadt Konstanz, Amt fuer Stadtplanung und Umwelt
02.02.2023 16:00;659;299;360;Bedeckt;5;1;0;Stadt Konstanz, Amt fuer Stadtplanung und Umwelt
02.02.2023 17:00;767;369;398;Stellenweiser Regenfall;5;1;0;Stadt Konstanz, Amt fuer Stadtplanung und Umwelt
02.02.2023 18:00;632;284;348;Stellenweiser Regenfall;5;1;0;Stadt Konstanz, Amt fuer Stadtplanung und Umwelt
02.02.2023 19:00;500;268;232;Stellenweiser Regenfall;4;0;0;Stadt Konstanz, Amt fuer Stadtplanung und Umwelt
02.02.2023 20:00;285;136;149;Nieselregen;4;0;0.1;Stadt Konstanz, Amt fuer Stadtplanung und Umwelt
02.02.2023 21:00;248;126;122;Nieselregen;3;-1;0.1;Stadt Konstanz, Amt fuer Stadtplanung und Umwelt
02.02.2023 22:00;173;63;110;Nieselregen;3;-1;0;Stadt Konstanz, Amt fuer Stadtplanung und Umwelt
02.02.2023 23:00;110;53;57;Leicht bewoelkt;3;-1;0;Stadt Konstanz, Amt fuer Stadtplanung und Umwelt
03.02.2023 00:00;59;20;39;Leicht bewoelkt;2;-1;0;Stadt Konstanz, Amt fuer Stadtplanung und Umwelt
03.02.2023 01:00;32;14;18;Leicht bewoelkt;2;-1;0;Stadt Konstanz, Amt fuer Stadtplanung und Umwelt
03.02.2023 02:00;21;3;18;Bewoelkt;2;-1;0;Stadt Konstanz, Amt fuer Stadtplanung und Umwelt
03.02.2023 03:00;7;1;6;Bewoelkt;2;-1;0;Stadt Konstanz, Amt fuer Stadtplanung und Umwelt
03.02.2023 04:00;9;3;6;Bewoelkt;1;-1;0;Stadt Konstanz, Amt fuer Stadtplanung und Umwelt
03.02.2023 05:00;37;19;18;Bewoelkt;1;-1;0;Stadt Konstanz, Amt fuer Stadtplanung und Umwelt
03.02.2023 06:00;143;80;63;Bewoelkt;1;-2;0;Stadt Konstanz, Amt fuer Stadtplanung und Umwelt
03.02.2023 07:00;778;451;327;Bewoelkt;1;-1;0;Stadt Konstanz, Amt fuer Stadtplanung und Umwelt
03.02.2023 08:00;649;372;277;Leicht bewoelkt;2;0;0;Stadt Konstanz, Amt fuer Stadtplanung und Umwelt
03.02.2023 09:00;542;304;238;Leicht bewoelkt;2;0;0;Stadt Konstanz, Amt fuer Stadtplanung und Umwelt
03.02.2023 10:00;433;249;184;Leicht bewoelkt;4;2;0;Stadt Konstanz, Amt fuer Stadtplanung und Umwelt
03.02.2023 11:00;543;271;272;Leicht bewoelkt;5;3;0;Stadt Konstanz, Amt fuer Stadtplanung und Umwelt
03.02.2023 12:00;650;300;350;Leicht bewoelkt;7;5;0;Stadt Konstanz, Amt fuer Stadtplanung und Umwelt
03.02.2023 13:00;720;284;436;Leicht bewoelkt;7;5;0;Stadt Konstanz, Amt fuer Stadtplanung und Umwelt
03.02.2023 14:00;598;300;298;Leicht bewoelkt;8;5;0;Stadt Konstanz, Amt fuer Stadtplanung und Umwelt
03.02.2023 15:00;552;271;281;Leicht bewoelkt;8;6;0;Stadt Konstanz, Amt fuer Stadtplanung und Umwelt
03.02.2023 16:00;548;251;297;Leicht bewoelkt;8;5;0;Stadt Konstanz, Amt fuer Stadtplanung und Umwelt
03.02.2023 17:00;615;285;330;Sonnig;7;4;0;Stadt Konstanz, Amt fuer Stadtplanung und Umwelt
03.02.2023 18:00;532;241;291;Sonnig;6;4;0;Stadt Konstanz, Amt fuer Stadtplanung und Umwelt
03.02.2023 19:00;412;196;216;Sonnig;6;3;0;Stadt Konstanz, Amt fuer Stadtplanung und Umwelt
03.02.2023 20:00;285;152;133;Bedeckt;6;3;0;Stadt Konstanz, Amt fuer Stadtplanung und Umwelt
03.02.2023 21:00;190;98;92;Bedeckt;5;2;0;Stadt Konstanz, Amt fuer Stadtplanung und Umwelt
03.02.2023 22:00;172;82;90;Bedeckt;5;2;0;Stadt Konstanz, Amt fuer Stadtplanung und Umwelt
03.02.2023 23:00;135;59;76;Bedeckt;4;2;0;Stadt Konstanz, Amt fuer Stadtplanung und Umwelt
04.02.2023 00:00;84;38;46;Bedeckt;4;2;0;Stadt Konstanz, Amt fuer Stadtplanung und Umwelt
04.02.2023 01:00;78;14;64;Bedeckt;4;2;0;Stadt Konstanz, Amt fuer Stadtplanung und Umwelt
04.02.2023 02:00;30;15;15;Bedeckt;4;2;0;Stadt Konstanz, Amt fuer Stadtplanung und Umwelt
04.02.2023 03:00;36;12;24;Bedeckt;4;2;0;Stadt Konstanz, Amt fuer Stadtplanung und Umwelt
04.02.2023 04:00;24;12;12;Bedeckt;4;2;0;Stadt Konstanz, Amt fuer Stadtplanung und Umwelt
04.02.2023 05:00;28;19;9;Bedeckt;4;2;0;Stadt Konstanz, Amt fuer Stadtplanung und Umwelt
04.02.2023 06:00;43;27;16;Bedeckt;4;2;0;Stadt Konstanz, Amt fuer Stadtplanung und Umwelt
04.02.2023 07:00;77;43;34;Bedeckt;4;2;0;Stadt Konstanz, Amt fuer Stadtplanung und Umwelt
04.02.2023 08:00;132;66;66;Bedeckt;4;3;0;Stadt Konstanz, Amt fuer Stadtplanung und Umwelt
04.02.2023 09:00;204;123;81;Bedeckt;4;3;0;Stadt Konstanz, Amt fuer Stadtplanung und Umwelt
04.02.2023 10:00;244;129;115;Bedeckt;4;4;0;Stadt Konstanz, Amt fuer Stadtplanung und Umwelt
04.02.2023 11:00;312;169;143;Bedeckt;5;4;0;Stadt Konstanz, Amt fuer Stadtplanung und Umwelt
04.02.2023 12:00;329;166;163;Bedeckt;5;5;0;Stadt Konstanz, Amt fuer Stadtplanung und Umwelt
04.02.2023 13:00;410;200;210;Bedeckt;5;5;0;Stadt Konstanz, Amt fuer Stadtplanung und Umwelt
04.02.2023 14:00;402;213;189;Bedeckt;5;5;0;Stadt Konstanz, Amt fuer Stadtplanung und Umwelt
04.02.2023 15:00;418;229;189;Bedeckt;5;5;0;Stadt Konstanz, Amt fuer Stadtplanung und Umwelt
04.02.2023 16:00;422;191;231;Bedeckt;5;5;0;Stadt Konstanz, Amt fuer Stadtplanung und Umwelt
04.02.2023 17:00;373;162;211;Stellenweiser Regenfall;5;5;0;Stadt Konstanz, Amt fuer Stadtplanung und Umwelt
04.02.2023 18:00;359;181;178;Stellenweiser Regenfall;5;5;0;Stadt Konstanz, Amt fuer Stadtplanung und Umwelt
04.02.2023 19:00;296;131;165;Stellenweiser Regenfall;5;5;0;Stadt Konstanz, Amt fuer Stadtplanung und Umwelt
04.02.2023 20:00;193;92;101;Leichter Nebel;5;5;0;Stadt Konstanz, Amt fuer Stadtplanung und Umwelt
04.02.2023 21:00;130;65;65;Leichter Nebel;5;5;0;Stadt Konstanz, Amt fuer Stadtplanung und Umwelt
04.02.2023 22:00;100;40;60;Leichter Nebel;4;4;0;Stadt Konstanz, Amt fuer Stadtplanung und Umwelt
04.02.2023 23:00;109;44;65;Bedeckt;3;3;0;Stadt Konstanz, Amt fuer Stadtplanung und Umwelt
05.02.2023 00:00;129;53;76;Bedeckt;2;2;0;Stadt Konstanz, Amt fuer Stadtplanung und Umwelt
05.02.2023 01:00;60;24;36;Bedeckt;2;2;0;Stadt Konstanz, Amt fuer Stadtplanung und Umwelt
05.02.2023 02:00;59;24;35;Bewoelkt;2;1;0;Stadt Konstanz, Amt fuer Stadtplanung und Umwelt
05.02.2023 03:00;49;4;45;Bewoelkt;1;1;0;Stadt Konstanz, Amt fuer Stadtplanung und Umwelt
05.02.2023 04:00;17;6;11;Bewoelkt;1;1;0;Stadt Konstanz, Amt fuer Stadtplanung und Umwelt
05.02.2023 05:00;17;11;6;Bewoelkt;1;1;0;Stadt Konstanz, Amt fuer Stadtplanung und Umwelt
05.02.2023 06:00;31;21;10;Bewoelkt;0;0;0;Stadt Konstanz, Amt fuer Stadtplanung und Umwelt
05.02.2023 07:00;28;10;18;Bewoelkt;1;1;0;Stadt Konstanz, Amt fuer Stadtplanung und Umwelt
05.02.2023 08:00;80;39;41;Bewoelkt;2;1;0;Stadt Konstanz, Amt fuer Stadtplanung und Umwelt
05.02.2023 09:00;145;87;58;Bewoelkt;2;2;0;Stadt Konstanz, Amt fuer Stadtplanung und Umwelt
05.02.2023 10:00;178;108;70;Bewoelkt;3;2;0;Stadt Konstanz, Amt fuer Stadtplanung und Umwelt
05.02.2023 11:00;184;95;89;Bewoelkt;4;3;0;Stadt Konstanz, Amt fuer Stadtplanung und Umwelt
05.02.2023 12:00;219;93;126;Bewoelkt;6;4;0;Stadt Konstanz, Amt fuer Stadtplanung und Umwelt
05.02.2023 13:00;232;113;119;Bewoelkt;6;4;0;Stadt Konstanz, Amt fuer Stadtplanung und Umwelt
05.02.2023 14:00;180;88;92;Bedeckt;6;3;0;Stadt Konstanz, Amt fuer Stadtplanung und Umwelt
05.02.2023 15:00;164;87;77;Bedeckt;6;3;0;Stadt Konstanz, Amt fuer Stadtplanung und Umwelt
05.02.2023 16:00;153;73;80;Bedeckt;5;2;0;Stadt Konstanz, Amt fuer Stadtplanung und Umwelt
05.02.2023 17:00;161;70;91;Starker Schneefall;4;0;0.3;Stadt Konstanz, Amt fuer Stadtplanung und Umwelt
05.02.2023 18:00;163;75;88;Starker Schneefall;3;-1;0.4;Stadt Konstanz, Amt fuer Stadtplanung und Umwelt
05.02.2023 19:00;169;79;90;Starker Schneefall;2;-1;0.2;Stadt Konstanz, Amt fuer Stadtplanung und Umwelt
05.02.2023 20:00;105;46;59;Bedeckt;2;-1;0;Stadt Konstanz, Amt fuer Stadtplanung und Umwelt
05.02.2023 21:00;87;44;43;Bedeckt;1;-1;0;Stadt Konstanz, Amt fuer Stadtplanung und Umwelt
05.02.2023 22:00;83;38;45;Bedeckt;1;-2;0;Stadt Konstanz, Amt fuer Stadtplanung und Umwelt
05.02.2023 23:00;37;16;21;Maeßige bis starke Schneefaelle;0;-2;0.1;Stadt Konstanz, Amt fuer Stadtplanung und Umwelt
06.02.2023 00:00;17;7;10;Maeßige bis starke Schneefaelle;0;-3;0.2;Stadt Konstanz, Amt fuer Stadtplanung und Umwelt
06.02.2023 01:00;9;7;2;Maeßige bis starke Schneefaelle;0;-3;0.1;Stadt Konstanz, Amt fuer Stadtplanung und Umwelt
06.02.2023 02:00;2;0;2;Stellenweise leichter Schneefall;-1;-4;0;Stadt Konstanz, Amt fuer Stadtplanung und Umwelt
06.02.2023 03:00;2;0;2;Stellenweise leichter Schneefall;-1;-5;0;Stadt Konstanz, Amt fuer Stadtplanung und Umwelt
06.02.2023 04:00;10;7;3;Stellenweise leichter Schneefall;-1;-5;0;Stadt Konstanz, Amt fuer Stadtplanung und Umwelt
06.02.2023 05:00;41;29;12;Leichte Schneeschauer;-2;-5;0;Stadt Konstanz, Amt fuer Stadtplanung und Umwelt
06.02.2023 06:00;150;82;68;Leichte Schneeschauer;-2;-6;0;Stadt Konstanz, Amt fuer Stadtplanung und Umwelt
06.02.2023 07:00;796;471;325;Leichte Schneeschauer;-1;-5;0;Stadt Konstanz, Amt fuer Stadtplanung und Umwelt
06.02.2023 08:00;717;389;328;Leicht bewoelkt;-1;-5;0;Stadt Konstanz, Amt fuer Stadtplanung und Umwelt
06.02.2023 09:00;467;260;207;Leicht bewoelkt;-1;-4;0;Stadt Konstanz, Amt fuer Stadtplanung und Umwelt
06.02.2023 10:00;333;175;158;Leicht bewoelkt;0;-3;0;Stadt Konstanz, Amt fuer Stadtplanung und Umwelt
06.02.2023 11:00;445;208;237;Sonnig;1;-2;0;Stadt Konstanz, Amt fuer Stadtplanung und Umwelt
06.02.2023 12:00;485;195;290;Sonnig;2;-1;0;Stadt Konstanz, Amt fuer Stadtplanung und Umwelt
06.02.2023 13:00;697;314;383;Sonnig;3;-1;0;Stadt Konstanz, Amt fuer Stadtplanung und Umwelt
06.02.2023 14:00;485;248;237;Leicht bewoelkt;3;0;0;Stadt Konstanz, Amt fuer Stadtplanung und Umwelt
06.02.2023 15:00;783;392;391;Leicht bewoelkt;4;0;0;Stadt Konstanz, Amt fuer Stadtplanung und Umwelt
06.02.2023 16:00;676;327;349;Leicht bewoelkt;3;-1;0;Stadt Konstanz, Amt fuer Stadtplanung und Umwelt
06.02.2023 17:00;787;352;435;Leicht bewoelkt;2;-2;0;Stadt Konstanz, Amt fuer Stadtplanung und Umwelt
06.02.2023 18:00;654;272;382;Leicht bewoelkt;1;-3;0;Stadt Konstanz, Amt fuer Stadtplanung und Umwelt
06.02.2023 19:00;467;207;260;Leicht bewoelkt;1;-4;0;Stadt Konstanz, Amt fuer Stadtplanung und Umwelt
06.02.2023 20:00;305;157;148;Bedeckt;0;-4;0;Stadt Konstanz, Amt fuer Stadtplanung und Umwelt
06.02.2023 21:00;153;78;75;Bedeckt;-1;-5;0;Stadt Konstanz, Amt fuer Stadtplanung und Umwelt
06.02.2023 22:00;168;79;89;Bedeckt;-2;-6;0;Stadt Konstanz, Amt fuer Stadtplanung und Umwelt
06.02.2023 23:00;77;32;45;Sonnig;-2;-7;0;Stadt Konstanz, Amt fuer Stadtplanung und Umwelt
07.02.2023 00:00;46;28;18;Sonnig;-3;-8;0;Stadt Konstanz, Amt fuer Stadtplanung und Umwelt
07.02.2023 01:00;10;6;4;Sonnig;-4;-8;0;Stadt Konstanz, Amt fuer Stadtplanung und Umwelt
07.02.2023 02:00;10;4;6;Sonnig;-5;-9;0;Stadt Konstanz, Amt fuer Stadtplanung und Umwelt
07.02.2023 03:00;7;2;5;Sonnig;-5;-9;0;Stadt Konstanz, Amt fuer Stadtplanung und Umwelt
07.02.2023 04:00;6;4;2;Sonnig;-5;-8;0;Stadt Konstanz, Amt fuer Stadtplanung und Umwelt
07.02.2023 05:00;40;23;17;Sonnig;-5;-7;0;Stadt Konstanz, Amt fuer Stadtplanung und Umwelt
07.02.2023 06:00;151;79;72;Sonnig;-6;-7;0;Stadt Konstanz, Amt fuer Stadtplanung und Umwelt
07.02.2023 07:00;751;433;318;Sonnig;-5;-6;0;Stadt Konstanz, Amt fuer Stadtplanung und Umwelt
07.02.2023 08:00;674;346;328;Sonnig;-4;-6;0;Stadt Konstanz, Amt fuer Stadtplanung und Umwelt
07.02.2023 09:00;517;264;253;Sonnig;-4;-6;0;Stadt Konstanz, Amt fuer Stadtplanung und Umwelt
07.02.2023 10:00;348;199;149;Sonnig;-2;-4;0;Stadt Konstanz, Amt fuer Stadtplanung und Umwelt
07.02.2023 11:00;449;220;229;Sonnig;0;-2;0;Stadt Konstanz, Amt fuer Stadtplanung und Umwelt
07.02.2023 12:00;529;242;287;Sonnig;1;1;0;Stadt Konstanz, Amt fuer Stadtplanung und Umwelt
07.02.2023 13:00;635;275;360;Sonnig;2;0;0;Stadt Konstanz, Amt fuer Stadtplanung und Umwelt
07.02.2023 14:00;537;251;286;Sonnig;2;0;0;Stadt Konstanz, Amt fuer Stadtplanung und Umwelt
07.02.2023 15:00;756;385;371;Sonnig;2;0;0;Stadt Konstanz, Amt fuer Stadtplanung und Umwelt
07.02.2023 16:00;713;367;346;Sonnig;1;-2;0;Stadt Konstanz, Amt fuer Stadtplanung und Umwelt
07.02.2023 17:00;833;358;475;Bedeckt;-1;-3;0;Stadt Konstanz, Amt fuer Stadtplanung und Umwelt
07.02.2023 18:00;714;312;402;Bedeckt;-2;-5;0;Stadt Konstanz, Amt fuer Stadtplanung und Umwelt
07.02.2023 19:00;449;248;201;Bedeckt;-2;-6;0;Stadt Konstanz, Amt fuer Stadtplanung und Umwelt
07.02.2023 20:00;330;158;172;Sonnig;-2;-6;0;Stadt Konstanz, Amt fuer Stadtplanung und Umwelt
07.02.2023 21:00;207;75;132;Sonnig;-3;-6;0;Stadt Konstanz, Amt fuer Stadtplanung und Umwelt
07.02.2023 22:00;175;90;85;Sonnig;-3;-7;0;Stadt Konstanz, Amt fuer Stadtplanung und Umwelt
07.02.2023 23:00;84;36;48;Sonnig;-3;-8;0;Stadt Konstanz, Amt fuer Stadtplanung und Umwelt
08.02.2023 00:00;56;27;29;Sonnig;-4;-9;0;Stadt Konstanz, Amt fuer Stadtplanung und Umwelt
08.02.2023 01:00;28;20;8;Sonnig;-4;-9;0;Stadt Konstanz, Amt fuer Stadtplanung und Umwelt
08.02.2023 02:00;6;3;3;Sonnig;-4;-9;0;Stadt Konstanz, Amt fuer Stadtplanung und Umwelt
08.02.2023 03:00;2;0;2;Sonnig;-4;-10;0;Stadt Konstanz, Amt fuer Stadtplanung und Umwelt
08.02.2023 04:00;7;5;2;Sonnig;-5;-10;0;Stadt Konstanz, Amt fuer Stadtplanung und Umwelt
08.02.2023 05:00;35;25;10;Sonnig;-5;-10;0;Stadt Konstanz, Amt fuer Stadtplanung und Umwelt
08.02.2023 06:00;128;68;60;Sonnig;-5;-11;0;Stadt Konstanz, Amt fuer Stadtplanung und Umwelt
08.02.2023 07:00;748;421;327;Sonnig;-5;-10;0;Stadt Konstanz, Amt fuer Stadtplanung und Umwelt
08.02.2023 08:00;712;382;330;Sonnig;-5;-10;0;Stadt Konstanz, Amt fuer Stadtplanung und Umwelt
08.02.2023 09:00;499;274;225;Sonnig;-4;-10;0;Stadt Konstanz, Amt fuer Stadtplanung und Umwelt
08.02.2023 10:00;379;212;167;Sonnig;-3;-9;0;Stadt Konstanz, Amt fuer Stadtplanung und Umwelt
08.02.2023 11:00;399;196;203;Leicht bewoelkt;-2;-8;0;Stadt Konstanz, Amt fuer Stadtplanung und Umwelt
08.02.2023 12:00;546;250;296;Leicht bewoelkt;-1;-6;0;Stadt Konstanz, Amt fuer Stadtplanung und Umwelt
08.02.2023 13:00;747;360;387;Leicht bewoelkt;0;-5;0;Stadt Konstanz, Amt fuer Stadtplanung und Umwelt
08.02.2023 14:00;533;268;265;Sonnig;1;-4;0;Stadt Konstanz, Amt fuer Stadtplanung und Umwelt
08.02.2023 15:00;690;275;415;Sonnig;1;-2;0;Stadt Konstanz, Amt fuer Stadtplanung und Umwelt
08.02.2023 16:00;730;329;401;Sonnig;0;-3;0;Stadt Konstanz, Amt fuer Stadtplanung und Umwelt
08.02.2023 17:00;806;355;451;Sonnig;-1;-4;0;Stadt Konstanz, Amt fuer Stadtplanung und Umwelt
08.02.2023 18:00;620;277;343;Sonnig;-2;-4;0;Stadt Konstanz, Amt fuer Stadtplanung und Umwelt
08.02.2023 19:00;445;226;219;Sonnig;-2;-5;0;Stadt Konstanz, Amt fuer Stadtplanung und Umwelt
08.02.2023 20:00;330;162;168;Sonnig;-3;-5;0;Stadt Konstanz, Amt fuer Stadtplanung und Umwelt
08.02.2023 21:00;199;93;106;Sonnig;-4;-5;0;Stadt Konstanz, Amt fuer Stadtplanung und Umwelt
08.02.2023 22:00;167;82;85;Sonnig;-4;-5;0;Stadt Konstanz, Amt fuer Stadtplanung und Umwelt
08.02.2023 23:00;102;33;69;Sonnig;-4;-5;0;Stadt Konstanz, Amt fuer Stadtplanung und Umwelt
09.02.2023 00:00;49;15;34;Sonnig;-4;-4;0;Stadt Konstanz, Amt fuer Stadtplanung und Umwelt
09.02.2023 01:00;27;8;19;Sonnig;-4;-5;0;Stadt Konstanz, Amt fuer Stadtplanung und Umwelt
09.02.2023 02:00;9;3;6;Sonnig;-5;-6;0;Stadt Konstanz, Amt fuer Stadtplanung und Umwelt
09.02.2023 03:00;3;1;2;Sonnig;-5;-7;0;Stadt Konstanz, Amt fuer Stadtplanung und Umwelt
09.02.2023 04:00;9;6;3;Sonnig;-5;-7;0;Stadt Konstanz, Amt fuer Stadtplanung und Umwelt
09.02.2023 05:00;34;27;7;Sonnig;-5;-8;0;Stadt Konstanz, Amt fuer Stadtplanung und Umwelt
09.02.2023 06:00;132;69;63;Sonnig;-5;-8;0;Stadt Konstanz, Amt fuer Stadtplanung und Umwelt
09.02.2023 07:00;779;441;338;Sonnig;-5;-8;0;Stadt Konstanz, Amt fuer Stadtplanung und Umwelt
09.02.2023 08:00;706;360;346;Sonnig;-4;-7;0;Stadt Konstanz, Amt fuer Stadtplanung und Umwelt
09.02.2023 09:00;516;283;233;Sonnig;-3;-6;0;Stadt Konstanz, Amt fuer Stadtplanung und Umwelt
09.02.2023 10:00;351;175;176;Sonnig;-2;-4;0;Stadt Konstanz, Amt fuer Stadtplanung und Umwelt
09.02.2023 11:00;450;217;233;Sonnig;0;-2;0;Stadt Konstanz, Amt fuer Stadtplanung und Umwelt
09.02.2023 12:00;497;237;260;Sonnig;2;0;0;Stadt Konstanz, Amt fuer Stadtplanung und Umwelt
09.02.2023 13:00;703;299;404;Sonnig;3;1;0;Stadt Konstanz, Amt fuer Stadtplanung und Umwelt
09.02.2023 14:00;577;264;313;Sonnig;4;2;0;Stadt Konstanz, Amt fuer Stadtplanung und Umwelt
09.02.2023 15:00;769;386;383;Sonnig;5;4;0;Stadt Konstanz, Amt fuer Stadtplanung und Umwelt
09.02.2023 16:00;695;333;362;Sonnig;3;2;0;Stadt Konstanz, Amt fuer Stadtplanung und Umwelt
09.02.2023 17:00;781;345;436;Sonnig;1;-1;0;Stadt Konstanz, Amt fuer Stadtplanung und Umwelt
09.02.2023 18:00;654;300;354;Sonnig;-1;-3;0;Stadt Konstanz, Amt fuer Stadtplanung und Umwelt
09.02.2023 19:00;482;242;240;Sonnig;-2;-4;0;Stadt Konstanz, Amt fuer Stadtplanung und Umwelt
09.02.2023 20:00;298;133;165;Sonnig;-3;-5;0;Stadt Konstanz, Amt fuer Stadtplanung und Umwelt
09.02.2023 21:00;213;94;119;Sonnig;-3;-6;0;Stadt Konstanz, Amt fuer Stadtplanung und Umwelt
09.02.2023 22:00;168;74;94;Sonnig;-4;-6;0;Stadt Konstanz, Amt fuer Stadtplanung und Umwelt
09.02.2023 23:00;130;50;80;Sonnig;-4;-7;0;Stadt Konstanz, Amt fuer Stadtplanung und Umwelt
10.02.2023 00:00;49;20;29;Sonnig;-4;-7;0;Stadt Konstanz, Amt fuer Stadtplanung und Umwelt
10.02.2023 01:00;46;9;37;Sonnig;-4;-7;0;Stadt Konstanz, Amt fuer Stadtplanung und Umwelt
10.02.2023 02:00;8;1;7;Sonnig;-5;-7;0;Stadt Konstanz, Amt fuer Stadtplanung und Umwelt
10.02.2023 03:00;4;1;3;Sonnig;-5;-7;0;Stadt Konstanz, Amt fuer Stadtplanung und Umwelt
10.02.2023 04:00;4;2;2;Sonnig;-5;-7;0;Stadt Konstanz, Amt fuer Stadtplanung und Umwelt
10.02.2023 05:00;36;32;4;Sonnig;-5;-7;0;Stadt Konstanz, Amt fuer Stadtplanung und Umwelt
10.02.2023 06:00;128;65;63;Sonnig;-5;-8;0;Stadt Konstanz, Amt fuer Stadtplanung und Umwelt
10.02.2023 07:00;713;399;314;Sonnig;-4;-7;0;Stadt Konstanz, Amt fuer Stadtplanung und Umwelt
10.02.2023 08:00;613;340;273;Sonnig;-3;-6;0;Stadt Konstanz, Amt fuer Stadtplanung und Umwelt
10.02.2023 09:00;571;303;268;Sonnig;-3;-5;0;Stadt Konstanz, Amt fuer Stadtplanung und Umwelt
10.02.2023 10:00;370;210;160;Sonnig;0;-2;0;Stadt Konstanz, Amt fuer Stadtplanung und Umwelt
10.02.2023 11:00;498;268;230;Sonnig;2;1;0;Stadt Konstanz, Amt fuer Stadtplanung und Umwelt
10.02.2023 12:00;654;309;345;Sonnig;4;4;0;Stadt Konstanz, Amt fuer Stadtplanung und Umwelt
10.02.2023 13:00;803;323;480;Sonnig;4;4;0;Stadt Konstanz, Amt fuer Stadtplanung und Umwelt
10.02.2023 14:00;680;304;376;Sonnig;4;4;0;Stadt Konstanz, Amt fuer Stadtplanung und Umwelt
10.02.2023 15:00;607;311;296;Sonnig;5;5;0;Stadt Konstanz, Amt fuer Stadtplanung und Umwelt
10.02.2023 16:00;640;290;350;Sonnig;3;2;0;Stadt Konstanz, Amt fuer Stadtplanung und Umwelt
10.02.2023 17:00;640;310;330;Leicht bewoelkt;1;0;0;Stadt Konstanz, Amt fuer Stadtplanung und Umwelt
10.02.2023 18:00;579;301;278;Leicht bewoelkt;-1;-2;0;Stadt Konstanz, Amt fuer Stadtplanung und Umwelt
10.02.2023 19:00;436;239;197;Leicht bewoelkt;-1;-2;0;Stadt Konstanz, Amt fuer Stadtplanung und Umwelt
10.02.2023 20:00;264;129;135;Leicht bewoelkt;-2;-2;0;Stadt Konstanz, Amt fuer Stadtplanung und Umwelt
10.02.2023 21:00;244;95;149;Leicht bewoelkt;-2;-2;0;Stadt Konstanz, Amt fuer Stadtplanung und Umwelt
10.02.2023 22:00;220;77;143;Leicht bewoelkt;-2;-3;0;Stadt Konstanz, Amt fuer Stadtplanung und Umwelt
10.02.2023 23:00;177;45;132;Sonnig;-3;-4;0;Stadt Konstanz, Amt fuer Stadtplanung und Umwelt
11.02.2023 00:00;115;42;73;Sonnig;-3;-5;0;Stadt Konstanz, Amt fuer Stadtplanung und Umwelt
11.02.2023 01:00;77;28;49;Sonnig;-3;-5;0;Stadt Konstanz, Amt fuer Stadtplanung und Umwelt
11.02.2023 02:00;75;41;34;Sonnig;-3;-5;0;Stadt Konstanz, Amt fuer Stadtplanung und Umwelt
11.02.2023 03:00;54;25;29;Sonnig;-3;-5;0;Stadt Konstanz, Amt fuer Stadtplanung und Umwelt
11.02.2023 04:00;18;12;6;Sonnig;-3;-4;0;Stadt Konstanz, Amt fuer Stadtplanung und Umwelt
11.02.2023 05:00;28;13;15;Sonnig;-2;-3;0;Stadt Konstanz, Amt fuer Stadtplanung und Umwelt
11.02.2023 06:00;36;20;16;Sonnig;-2;-2;0;Stadt Konstanz, Amt fuer Stadtplanung und Umwelt
11.02.2023 07:00;55;30;25;Sonnig;-1;-1;0;Stadt Konstanz, Amt fuer Stadtplanung und Umwelt
11.02.2023 08:00;148;70;78;Leicht bewoelkt;0;0;0;Stadt Konstanz, Amt fuer Stadtplanung und Umwelt
11.02.2023 09:00;262;145;117;Leicht bewoelkt;0;0;0;Stadt Konstanz, Amt fuer Stadtplanung und Umwelt
11.02.2023 10:00;333;188;145;Leicht bewoelkt;2;2;0;Stadt Konstanz, Amt fuer Stadtplanung und Umwelt
11.02.2023 11:00;394;209;185;Sonnig;3;3;0;Stadt Konstanz, Amt fuer Stadtplanung und Umwelt
11.02.2023 12:00;368;209;159;Sonnig;5;5;0;Stadt Konstanz, Amt fuer Stadtplanung und Umwelt
11.02.2023 13:00;421;230;191;Sonnig;6;6;0;Stadt Konstanz, Amt fuer Stadtplanung und Umwelt
11.02.2023 14:00;475;241;234;Sonnig;7;7;0;Stadt Konstanz, Amt fuer Stadtplanung und Umwelt
11.02.2023 15:00;476;212;264;Sonnig;8;8;0;Stadt Konstanz, Amt fuer Stadtplanung und Umwelt
11.02.2023 16:00;399;173;226;Sonnig;6;6;0;Stadt Konstanz, Amt fuer Stadtplanung und Umwelt
11.02.2023 17:00;380;167;213;Sonnig;4;4;0;Stadt Konstanz, Amt fuer Stadtplanung und Umwelt
11.02.2023 18:00;417;168;249;Sonnig;2;2;0;Stadt Konstanz, Amt fuer Stadtplanung und Umwelt
11.02.2023 19:00;291;149;142;Sonnig;1;1;0;Stadt Konstanz, Amt fuer Stadtplanung und Umwelt
11.02.2023 20:00;210;102;108;Sonnig;0;0;0;Stadt Konstanz, Amt fuer Stadtplanung und Umwelt
11.02.2023 21:00;190;97;93;Sonnig;-1;-1;0;Stadt Konstanz, Amt fuer Stadtplanung und Umwelt
11.02.2023 22:00;170;59;111;Sonnig;-1;-1;0;Stadt Konstanz, Amt fuer Stadtplanung und Umwelt
11.02.2023 23:00;136;60;76;Sonnig;-1;-2;0;Stadt Konstanz, Amt fuer Stadtplanung und Umwelt
12.02.2023 00:00;119;27;92;Sonnig;-1;-2;0;Stadt Konstanz, Amt fuer Stadtplanung und Umwelt
12.02.2023 01:00;81;23;58;Sonnig;-1;-2;0;Stadt Konstanz, Amt fuer Stadtplanung und Umwelt
12.02.2023 02:00;64;24;40;Sonnig;-1;-2;0;Stadt Konstanz, Amt fuer Stadtplanung und Umwelt
12.02.2023 03:00;28;13;15;Sonnig;-1;-2;0;Stadt Konstanz, Amt fuer Stadtplanung und Umwelt
12.02.2023 04:00;11;8;3;Sonnig;-2;-3;0;Stadt Konstanz, Amt fuer Stadtplanung und Umwelt
12.02.2023 05:00;15;7;8;Sonnig;-2;-3;0;Stadt Konstanz, Amt fuer Stadtplanung und Umwelt
12.02.2023 06:00;23;16;7;Sonnig;-2;-3;0;Stadt Konstanz, Amt fuer Stadtplanung und Umwelt
12.02.2023 07:00;17;10;7;Sonnig;-1;-3;0;Stadt Konstanz, Amt fuer Stadtplanung und Umwelt
12.02.2023 08:00;65;30;35;Sonnig;0;-2;0;Stadt Konstanz, Amt fuer Stadtplanung und Umwelt
12.02.2023 09:00;147;77;70;Sonnig;1;-1;0;Stadt Konstanz, Amt fuer Stadtplanung und Umwelt
12.02.2023 10:00;172;97;75;Sonnig;3;1;0;Stadt Konstanz, Amt fuer Stadtplanung und Umwelt
12.02.2023 11:00;216;121;95;Sonnig;5;3;0;Stadt Konstanz, Amt fuer Stadtplanung und Umwelt
12.02.2023 12:00;257;117;140;Sonnig;7;5;0;Stadt Konstanz, Amt fuer Stadtplanung und Umwelt
12.02.2023 13:00;332;158;174;Sonnig;7;6;0;Stadt Konstanz, Amt fuer Stadtplanung und Umwelt
12.02.2023 14:00;375;201;174;Sonnig;8;6;0;Stadt Konstanz, Amt fuer Stadtplanung und Umwelt
12.02.2023 15:00;353;157;196;Sonnig;9;7;0;Stadt Konstanz, Amt fuer Stadtplanung und Umwelt
12.02.2023 16:00;352;181;171;Sonnig;7;5;0;Stadt Konstanz, Amt fuer Stadtplanung und Umwelt
12.02.2023 17:00;361;143;218;Sonnig;5;3;0;Stadt Konstanz, Amt fuer Stadtplanung und Umwelt
12.02.2023 18:00;257;121;136;Sonnig;4;2;0;Stadt Konstanz, Amt fuer Stadtplanung und Umwelt
12.02.2023 19:00;214;110;104;Sonnig;2;1;0;Stadt Konstanz, Amt fuer Stadtplanung und Umwelt
12.02.2023 20:00;132;70;62;Sonnig;1;0;0;Stadt Konstanz, Amt fuer Stadtplanung und Umwelt
12.02.2023 21:00;115;41;74;Sonnig;-1;-1;0;Stadt Konstanz, Amt fuer Stadtplanung und Umwelt
12.02.2023 22:00;103;52;51;Sonnig;-1;-1;0;Stadt Konstanz, Amt fuer Stadtplanung und Umwelt
12.02.2023 23:00;43;22;21;Sonnig;-1;-2;0;Stadt Konstanz, Amt fuer Stadtplanung und Umwelt
13.02.2023 00:00;29;12;17;Sonnig;-2;-2;0;Stadt Konstanz, Amt fuer Stadtplanung und Umwelt
13.02.2023 01:00;13;8;5;Sonnig;-2;-2;0;Stadt Konstanz, Amt fuer Stadtplanung und Umwelt
13.02.2023 02:00;6;5;1;Leichter Nebel;-2;-2;0;Stadt Konstanz, Amt fuer Stadtplanung und Umwelt
13.02.2023 03:00;11;7;4;Leichter Nebel;-2;-2;0;Stadt Konstanz, Amt fuer Stadtplanung und Umwelt
13.02.2023 04:00;26;14;12;Leichter Nebel;-2;-2;0;Stadt Konstanz, Amt fuer Stadtplanung und Umwelt
13.02.2023 05:00;36;25;11;Leicht bewoelkt;-3;-3;0;Stadt Konstanz, Amt fuer Stadtplanung und Umwelt
13.02.2023 06:00;157;82;75;Leicht bewoelkt;-3;-3;0;Stadt Konstanz, Amt fuer Stadtplanung und Umwelt
13.02.2023 07:00;722;413;309;Leicht bewoelkt;-2;-2;0;Stadt Konstanz, Amt fuer Stadtplanung und Umwelt
13.02.2023 08:00;654;345;309;Leicht bewoelkt;-1;-1;0;Stadt Konstanz, Amt fuer Stadtplanung und Umwelt
13.02.2023 09:00;538;311;227;Leicht bewoelkt;0;0;0;Stadt Konstanz, Amt fuer Stadtplanung und Umwelt
13.02.2023 10:00;348;193;155;Leicht bewoelkt;3;3;0;Stadt Konstanz, Amt fuer Stadtplanung und Umwelt
13.02.2023 11:00;398;199;199;Sonnig;5;5;0;Stadt Konstanz, Amt fuer Stadtplanung und Umwelt
13.02.2023 12:00;465;218;247;Sonnig;8;8;0;Stadt Konstanz, Amt fuer Stadtplanung und Umwelt
13.02.2023 13:00;685;299;386;Sonnig;9;9;0;Stadt Konstanz, Amt fuer Stadtplanung und Umwelt
13.02.2023 14:00;519;256;263;Sonnig;9;9;0;Stadt Konstanz, Amt fuer Stadtplanung und Umwelt
13.02.2023 15:00;678;334;344;Sonnig;10;10;0;Stadt Konstanz, Amt fuer Stadtplanung und Umwelt
13.02.2023 16:00;767;385;382;Sonnig;8;8;0;Stadt Konstanz, Amt fuer Stadtplanung und Umwelt
13.02.2023 17:00;833;412;421;Sonnig;6;6;0;Stadt Konstanz, Amt fuer Stadtplanung und Umwelt
13.02.2023 18:00;669;281;388;Sonnig;4;4;0;Stadt Konstanz, Amt fuer Stadtplanung und Umwelt
13.02.2023 19:00;492;226;266;Sonnig;3;3;0;Stadt Konstanz, Amt fuer Stadtplanung und Umwelt
13.02.2023 20:00;285;132;153;Sonnig;2;2;0;Stadt Konstanz, Amt fuer Stadtplanung und Umwelt
13.02.2023 21:00;164;69;95;Sonnig;0;0;0;Stadt Konstanz, Amt fuer Stadtplanung und Umwelt
13.02.2023 22:00;158;75;83;Sonnig;0;0;0;Stadt Konstanz, Amt fuer Stadtplanung und Umwelt
13.02.2023 23:00;73;42;31;Sonnig;0;0;0;Stadt Konstanz, Amt fuer Stadtplanung und Umwelt
14.02.2023 00:00;39;15;24;Sonnig;0;0;0;Stadt Konstanz, Amt fuer Stadtplanung und Umwelt
14.02.2023 01:00;19;6;13;Sonnig;-1;-1;0;Stadt Konstanz, Amt fuer Stadtplanung und Umwelt
14.02.2023 02:00;8;2;6;Sonnig;-1;-1;0;Stadt Konstanz, Amt fuer Stadtplanung und Umwelt
14.02.2023 03:00;7;2;5;Sonnig;-1;-1;0;Stadt Konstanz, Amt fuer Stadtplanung und Umwelt
14.02.2023 04:00;11;6;5;Sonnig;-1;-1;0;Stadt Konstanz, Amt fuer Stadtplanung und Umwelt
14.02.2023 05:00;44;31;13;Sonnig;-1;-1;0;Stadt Konstanz, Amt fuer Stadtplanung und Umwelt
14.02.2023 06:00;170;104;66;Sonnig;-1;-1;0;Stadt Konstanz, Amt fuer Stadtplanung und Umwelt
14.02.2023 07:00;730;407;323;Sonnig;0;0;0;Stadt Konstanz, Amt fuer Stadtplanung und Umwelt
14.02.2023 08:00;669;357;312;Sonnig;0;0;0;Stadt Konstanz, Amt fuer Stadtplanung und Umwelt
14.02.2023 09:00;610;332;278;Sonnig;1;1;0;Stadt Konstanz, Amt fuer Stadtplanung und Umwelt
14.02.2023 10:00;405;217;188;Sonnig;4;4;0;Stadt Konstanz, Amt fuer Stadtplanung und Umwelt
14.02.2023 11:00;425;231;194;Sonnig;7;7;0;Stadt Konstanz, Amt fuer Stadtplanung und Umwelt
14.02.2023 12:00;584;253;331;Sonnig;10;10;0;Stadt Konstanz, Amt fuer Stadtplanung und Umwelt
14.02.2023 13:00;634;277;357;Sonnig;10;10;0;Stadt Konstanz, Amt fuer Stadtplanung und Umwelt
14.02.2023 14:00;529;261;268;Sonnig;11;11;0;Stadt Konstanz, Amt fuer Stadtplanung und Umwelt
14.02.2023 15:00;712;367;345;Sonnig;12;12;0;Stadt Konstanz, Amt fuer Stadtplanung und Umwelt
14.02.2023 16:00;717;360;357;Sonnig;10;10;0;Stadt Konstanz, Amt fuer Stadtplanung und Umwelt
14.02.2023 17:00;861;402;459;Sonnig;8;8;0;Stadt Konstanz, Amt fuer Stadtplanung und Umwelt
14.02.2023 18:00;688;279;409;Sonnig;6;6;0;Stadt Konstanz, Amt fuer Stadtplanung und Umwelt
14.02.2023 19:00;515;229;286;Sonnig;5;4;0;Stadt Konstanz, Amt fuer Stadtplanung und Umwelt
14.02.2023 20:00;327;155;172;Sonnig;3;2;0;Stadt Konstanz, Amt fuer Stadtplanung und Umwelt
14.02.2023 21:00;201;90;111;Sonnig;1;0;0;Stadt Konstanz, Amt fuer Stadtplanung und Umwelt
14.02.2023 22:00;183;79;104;Sonnig;1;0;0;Stadt Konstanz, Amt fuer Stadtplanung und Umwelt
14.02.2023 23:00;142;54;88;Sonnig;1;0;0;Stadt Konstanz, Amt fuer Stadtplanung und Umwelt
15.02.2023 00:00;46;23;23;Sonnig;1;1;0;Stadt Konstanz, Amt fuer Stadtplanung und Umwelt
15.02.2023 01:00;33;12;21;Sonnig;0;0;0;Stadt Konstanz, Amt fuer Stadtplanung und Umwelt
15.02.2023 02:00;6;4;2;Sonnig;0;0;0;Stadt Konstanz, Amt fuer Stadtplanung und Umwelt
15.02.2023 03:00;2;0;2;Sonnig;0;0;0;Stadt Konstanz, Amt fuer Stadtplanung und Umwelt
15.02.2023 04:00;14;9;5;Sonnig;-1;-1;0;Stadt Konstanz, Amt fuer Stadtplanung und Umwelt
15.02.2023 05:00;48;38;10;Sonnig;-1;-1;0;Stadt Konstanz, Amt fuer Stadtplanung und Umwelt
15.02.2023 06:00;152;79;73;Sonnig;-1;-1;0;Stadt Konstanz, Amt fuer Stadtplanung und Umwelt
15.02.2023 07:00;756;421;335;Sonnig;0;0;0;Stadt Konstanz, Amt fuer Stadtplanung und Umwelt
15.02.2023 08:00;664;369;295;Sonnig;1;1;0;Stadt Konstanz, Amt fuer Stadtplanung und Umwelt
15.02.2023 09:00;535;288;247;Sonnig;2;2;0;Stadt Konstanz, Amt fuer Stadtplanung und Umwelt
15.02.2023 10:00;354;191;163;Sonnig;5;5;0;Stadt Konstanz, Amt fuer Stadtplanung und Umwelt
15.02.2023 11:00;424;200;224;Sonnig;8;8;0;Stadt Konstanz, Amt fuer Stadtplanung und Umwelt
15.02.2023 12:00;555;241;314;Sonnig;11;11;0;Stadt Konstanz, Amt fuer Stadtplanung und Umwelt
15.02.2023 13:00;749;356;393;Sonnig;12;12;0;Stadt Konstanz, Amt fuer Stadtplanung und Umwelt
15.02.2023 14:00;526;239;287;Sonnig;13;13;0;Stadt Konstanz, Amt fuer Stadtplanung und Umwelt
15.02.2023 15:00;646;299;347;Sonnig;14;15;0;Stadt Konstanz, Amt fuer Stadtplanung und Umwelt
15.02.2023 16:00;741;369;372;Sonnig;12;12;0;Stadt Konstanz, Amt fuer Stadtplanung und Umwelt
15.02.2023 17:00;770;366;404;Sonnig;10;10;0;Stadt Konstanz, Amt fuer Stadtplanung und Umwelt
15.02.2023 18:00;649;293;356;Sonnig;8;8;0;Stadt Konstanz, Amt fuer Stadtplanung und Umwelt
15.02.2023 19:00;554;333;221;Sonnig;6;6;0;Stadt Konstanz, Amt fuer Stadtplanung und Umwelt
15.02.2023 20:00;326;176;150;Sonnig;4;4;0;Stadt Konstanz, Amt fuer Stadtplanung und Umwelt
15.02.2023 21:00;356;95;261;Sonnig;3;3;0;Stadt Konstanz, Amt fuer Stadtplanung und Umwelt
15.02.2023 22:00;149;59;90;Sonnig;2;2;0;Stadt Konstanz, Amt fuer Stadtplanung und Umwelt
15.02.2023 23:00;129;42;87;Sonnig;2;2;0;Stadt Konstanz, Amt fuer Stadtplanung und Umwelt
16.02.2023 00:00;53;15;38;Sonnig;2;2;0;Stadt Konstanz, Amt fuer Stadtplanung und Umwelt
16.02.2023 01:00;37;13;24;Sonnig;1;1;0;Stadt Konstanz, Amt fuer Stadtplanung und Umwelt
16.02.2023 02:00;7;5;2;Bedeckt;1;1;0;Stadt Konstanz, Amt fuer Stadtplanung und Umwelt
16.02.2023 03:00;4;0;4;Bedeckt;1;1;0;Stadt Konstanz, Amt fuer Stadtplanung und Umwelt
16.02.2023 04:00;10;5;5;Bedeckt;1;1;0;Stadt Konstanz, Amt fuer Stadtplanung und Umwelt
16.02.2023 05:00;60;45;15;Bedeckt;1;0;0;Stadt Konstanz, Amt fuer Stadtplanung und Umwelt
16.02.2023 06:00;161;92;69;Bedeckt;0;0;0;Stadt Konstanz, Amt fuer Stadtplanung und Umwelt
16.02.2023 07:00;568;319;249;Bedeckt;1;0;0;Stadt Konstanz, Amt fuer Stadtplanung und Umwelt
16.02.2023 08:00;454;232;222;Sonnig;2;1;0;Stadt Konstanz, Amt fuer Stadtplanung und Umwelt
16.02.2023 09:00;446;188;258;Sonnig;2;2;0;Stadt Konstanz, Amt fuer Stadtplanung und Umwelt
16.02.2023 10:00;402;256;146;Sonnig;5;4;0;Stadt Konstanz, Amt fuer Stadtplanung und Umwelt
16.02.2023 11:00;450;271;179;Sonnig;7;6;0;Stadt Konstanz, Amt fuer Stadtplanung und Umwelt
16.02.2023 12:00;429;266;163;Sonnig;10;8;0;Stadt Konstanz, Amt fuer Stadtplanung und Umwelt
16.02.2023 13:00;405;245;160;Sonnig;11;9;0;Stadt Konstanz, Amt fuer Stadtplanung und Umwelt
16.02.2023 14:00;461;263;198;Sonnig;11;10;0;Stadt Konstanz, Amt fuer Stadtplanung und Umwelt
16.02.2023 15:00;416;207;209;Sonnig;12;11;0;Stadt Konstanz, Amt fuer Stadtplanung und Umwelt
16.02.2023 16:00;474;215;259;Sonnig;10;9;0;Stadt Konstanz, Amt fuer Stadtplanung und Umwelt
16.02.2023 17:00;469;209;260;Sonnig;7;6;0;Stadt Konstanz, Amt fuer Stadtplanung und Umwelt
16.02.2023 18:00;479;305;174;Sonnig;5;3;0;Stadt Konstanz, Amt fuer Stadtplanung und Umwelt
16.02.2023 19:00;261;142;119;Sonnig;4;3;0;Stadt Konstanz, Amt fuer Stadtplanung und Umwelt
16.02.2023 20:00;331;91;240;Sonnig;4;3;0;Stadt Konstanz, Amt fuer Stadtplanung und Umwelt
16.02.2023 21:00;203;56;147;Sonnig;3;2;0;Stadt Konstanz, Amt fuer Stadtplanung und Umwelt
16.02.2023 22:00;180;44;136;Sonnig;3;2;0;Stadt Konstanz, Amt fuer Stadtplanung und Umwelt
16.02.2023 23:00;164;19;145;Sonnig;2;1;0;Stadt Konstanz, Amt fuer Stadtplanung und Umwelt
17.02.2023 00:00;122;21;101;Sonnig;1;1;0;Stadt Konstanz, Amt fuer Stadtplanung und Umwelt
17.02.2023 01:00;72;6;66;Sonnig;1;0;0;Stadt Konstanz, Amt fuer Stadtplanung und Umwelt
17.02.2023 02:00;37;3;34;Sonnig;1;0;0;Stadt Konstanz, Amt fuer Stadtplanung und Umwelt
17.02.2023 03:00;16;3;13;Sonnig;1;0;0;Stadt Konstanz, Amt fuer Stadtplanung und Umwelt
17.02.2023 04:00;16;8;8;Sonnig;1;-1;0;Stadt Konstanz, Amt fuer Stadtplanung und Umwelt
17.02.2023 05:00;39;22;17;Leicht bewoelkt;0;-1;0;Stadt Konstanz, Amt fuer Stadtplanung und Umwelt
17.02.2023 06:00;98;61;37;Leicht bewoelkt;0;-1;0;Stadt Konstanz, Amt fuer Stadtplanung und Umwelt
17.02.2023 07:00;205;81;124;Leicht bewoelkt;1;0;0;Stadt Konstanz, Amt fuer Stadtplanung und Umwelt
17.02.2023 08:00;306;173;133;Leicht bewoelkt;2;1;0;Stadt Konstanz, Amt fuer Stadtplanung und Umwelt
17.02.2023 09:00;310;174;136;Leicht bewoelkt;3;2;0;Stadt Konstanz, Amt fuer Stadtplanung und Umwelt
17.02.2023 10:00;295;166;129;Leicht bewoelkt;5;4;0;Stadt Konstanz, Amt fuer Stadtplanung und Umwelt
17.02.2023 11:00;351;170;181;Sonnig;8;7;0;Stadt Konstanz, Amt fuer Stadtplanung und Umwelt
17.02.2023 12:00;375;160;215;Sonnig;10;9;0;Stadt Konstanz, Amt fuer Stadtplanung und Umwelt
17.02.2023 13:00;437;212;225;Sonnig;11;10;0;Stadt Konstanz, Amt fuer Stadtplanung und Umwelt
17.02.2023 14:00;419;218;201;Leicht bewoelkt;12;10;0;Stadt Konstanz, Amt fuer Stadtplanung und Umwelt
17.02.2023 15:00;400;205;195;Leicht bewoelkt;13;11;0;Stadt Konstanz, Amt fuer Stadtplanung und Umwelt
17.02.2023 16:00;435;199;236;Leicht bewoelkt;11;9;0;Stadt Konstanz, Amt fuer Stadtplanung und Umwelt
17.02.2023 17:00;420;188;232;Bewoelkt;9;7;0;Stadt Konstanz, Amt fuer Stadtplanung und Umwelt
17.02.2023 18:00;433;195;238;Bewoelkt;7;6;0;Stadt Konstanz, Amt fuer Stadtplanung und Umwelt
17.02.2023 19:00;307;143;164;Bewoelkt;7;5;0;Stadt Konstanz, Amt fuer Stadtplanung und Umwelt
17.02.2023 20:00;212;114;98;Leicht bewoelkt;7;5;0;Stadt Konstanz, Amt fuer Stadtplanung und Umwelt
17.02.2023 21:00;144;81;63;Leicht bewoelkt;7;5;0;Stadt Konstanz, Amt fuer Stadtplanung und Umwelt
17.02.2023 22:00;120;60;60;Leicht bewoelkt;6;4;0;Stadt Konstanz, Amt fuer Stadtplanung und Umwelt
17.02.2023 23:00;82;37;45;Leichter Nebel;5;4;0;Stadt Konstanz, Amt fuer Stadtplanung und Umwelt
18.02.2023 00:00;77;17;60;Leichter Nebel;5;3;0;Stadt Konstanz, Amt fuer Stadtplanung und Umwelt
18.02.2023 01:00;45;9;36;Leichter Nebel;5;4;0;Stadt Konstanz, Amt fuer Stadtplanung und Umwelt
18.02.2023 02:00;29;12;17;Leichter Nebel;5;4;0;Stadt Konstanz, Amt fuer Stadtplanung und Umwelt
18.02.2023 03:00;14;1;13;Leichter Nebel;6;5;0;Stadt Konstanz, Amt fuer Stadtplanung und Umwelt
18.02.2023 04:00;13;8;5;Leichter Nebel;6;5;0;Stadt Konstanz, Amt fuer Stadtplanung und Umwelt
18.02.2023 05:00;22;16;6;Leichter Nebel;6;5;0;Stadt Konstanz, Amt fuer Stadtplanung und Umwelt
18.02.2023 06:00;38;20;18;Leichter Nebel;6;5;0;Stadt Konstanz, Amt fuer Stadtplanung und Umwelt
18.02.2023 07:00;64;37;27;Leichter Nebel;6;5;0;Stadt Konstanz, Amt fuer Stadtplanung und Umwelt
18.02.2023 08:00;144;72;72;Leicht bewoelkt;6;6;0;Stadt Konstanz, Amt fuer Stadtplanung und Umwelt
18.02.2023 09:00;292;161;131;Leicht bewoelkt;7;6;0;Stadt Konstanz, Amt fuer Stadtplanung und Umwelt
18.02.2023 10:00;340;167;173;Leicht bewoelkt;8;7;0;Stadt Konstanz, Amt fuer Stadtplanung und Umwelt
18.02.2023 11:00;389;207;182;Leicht bewoelkt;10;9;0;Stadt Konstanz, Amt fuer Stadtplanung und Umwelt
18.02.2023 12:00;367;182;185;Leicht bewoelkt;12;10;0;Stadt Konstanz, Amt fuer Stadtplanung und Umwelt
18.02.2023 13:00;339;169;170;Leicht bewoelkt;12;11;0;Stadt Konstanz, Amt fuer Stadtplanung und Umwelt
18.02.2023 14:00;401;190;211;Leicht bewoelkt;13;11;0;Stadt Konstanz, Amt fuer Stadtplanung und Umwelt
18.02.2023 15:00;354;157;197;Leicht bewoelkt;13;12;0;Stadt Konstanz, Amt fuer Stadtplanung und Umwelt
18.02.2023 16:00;381;172;209;Leicht bewoelkt;13;11;0;Stadt Konstanz, Amt fuer Stadtplanung und Umwelt
18.02.2023 17:00;374;180;194;Sonnig;12;10;0;Stadt Konstanz, Amt fuer Stadtplanung und Umwelt
18.02.2023 18:00;354;171;183;Sonnig;12;9;0;Stadt Konstanz, Amt fuer Stadtplanung und Umwelt
18.02.2023 19:00;289;181;108;Sonnig;11;8;0;Stadt Konstanz, Amt fuer Stadtplanung und Umwelt
18.02.2023 20:00;200;135;65;Sonnig;10;8;0;Stadt Konstanz, Amt fuer Stadtplanung und Umwelt
18.02.2023 21:00;151;96;55;Sonnig;9;7;0;Stadt Konstanz, Amt fuer Stadtplanung und Umwelt
18.02.2023 22:00;121;48;73;Sonnig;9;6;0;Stadt Konstanz, Amt fuer Stadtplanung und Umwelt
18.02.2023 23:00;132;37;95;Bedeckt;8;6;0;Stadt Konstanz, Amt fuer Stadtplanung und Umwelt
19.02.2023 00:00;128;27;101;Bedeckt;8;6;0;Stadt Konstanz, Amt fuer Stadtplanung und Umwelt
19.02.2023 01:00;101;21;80;Bedeckt;8;5;0;Stadt Konstanz, Amt fuer Stadtplanung und Umwelt
19.02.2023 02:00;100;20;80;Leicht bewoelkt;8;5;0;Stadt Konstanz, Amt fuer Stadtplanung und Umwelt
19.02.2023 03:00;64;11;53;Leicht bewoelkt;8;5;0;Stadt Konstanz, Amt fuer Stadtplanung und Umwelt
19.02.2023 04:00;24;14;10;Leicht bewoelkt;8;4;0;Stadt Konstanz, Amt fuer Stadtplanung und Umwelt
19.02.2023 05:00;22;12;10;Leicht bewoelkt;8;4;0;Stadt Konstanz, Amt fuer Stadtplanung und Umwelt
19.02.2023 06:00;23;12;11;Leicht bewoelkt;8;4;0;Stadt Konstanz, Amt fuer Stadtplanung und Umwelt
19.02.2023 07:00;27;19;8;Leicht bewoelkt;8;4;0;Stadt Konstanz, Amt fuer Stadtplanung und Umwelt
19.02.2023 08:00;55;28;27;Bewoelkt;8;5;0;Stadt Konstanz, Amt fuer Stadtplanung und Umwelt
19.02.2023 09:00;151;78;73;Bewoelkt;8;5;0;Stadt Konstanz, Amt fuer Stadtplanung und Umwelt
19.02.2023 10:00;138;76;62;Bewoelkt;9;6;0;Stadt Konstanz, Amt fuer Stadtplanung und Umwelt
19.02.2023 11:00;215;117;98;Leicht bewoelkt;10;7;0;Stadt Konstanz, Amt fuer Stadtplanung und Umwelt
19.02.2023 12:00;554;453;101;Leicht bewoelkt;11;9;0;Stadt Konstanz, Amt fuer Stadtplanung und Umwelt
19.02.2023 13:00;453;366;87;Leicht bewoelkt;11;9;0;Stadt Konstanz, Amt fuer Stadtplanung und Umwelt
19.02.2023 14:00;249;119;130;Leicht bewoelkt;11;9;0;Stadt Konstanz, Amt fuer Stadtplanung und Umwelt
19.02.2023 15:00;389;112;277;Leicht bewoelkt;11;9;0;Stadt Konstanz, Amt fuer Stadtplanung und Umwelt
19.02.2023 16:00;473;119;354;Leicht bewoelkt;10;8;0;Stadt Konstanz, Amt fuer Stadtplanung und Umwelt
19.02.2023 17:00;280;94;186;Sonnig;8;7;0;Stadt Konstanz, Amt fuer Stadtplanung und Umwelt
19.02.2023 18:00;236;90;146;Sonnig;7;6;0;Stadt Konstanz, Amt fuer Stadtplanung und Umwelt
19.02.2023 19:00;189;77;112;Sonnig;6;5;0;Stadt Konstanz, Amt fuer Stadtplanung und Umwelt
19.02.2023 20:00;114;63;51;Sonnig;5;5;0;Stadt Konstanz, Amt fuer Stadtplanung und Umwelt
19.02.2023 21:00;97;43;54;Sonnig;5;5;0;Stadt Konstanz, Amt fuer Stadtplanung und Umwelt
19.02.2023 22:00;69;24;45;Sonnig;4;4;0;Stadt Konstanz, Amt fuer Stadtplanung und Umwelt
19.02.2023 23:00;52;18;34;Leichter Nebel;4;4;0;Stadt Konstanz, Amt fuer Stadtplanung und Umwelt
20.02.2023 00:00;35;14;21;Leichter Nebel;4;4;0;Stadt Konstanz, Amt fuer Stadtplanung und Umwelt
20.02.2023 01:00;32;11;21;Leichter Nebel;3;3;0;Stadt Konstanz, Amt fuer Stadtplanung und Umwelt
20.02.2023 02:00;5;4;1;Leichter Nebel;3;3;0;Stadt Konstanz, Amt fuer Stadtplanung und Umwelt
20.02.2023 03:00;5;2;3;Leichter Nebel;3;3;0;Stadt Konstanz, Amt fuer Stadtplanung und Umwelt
20.02.2023 04:00;12;10;2;Leichter Nebel;2;2;0;Stadt Konstanz, Amt fuer Stadtplanung und Umwelt
20.02.2023 05:00;42;26;16;Leichter Nebel;2;2;0;Stadt Konstanz, Amt fuer Stadtplanung und Umwelt
20.02.2023 06:00;107;58;49;Leichter Nebel;2;2;0;Stadt Konstanz, Amt fuer Stadtplanung und Umwelt
20.02.2023 07:00;296;163;133;Leichter Nebel;3;3;0;Stadt Konstanz, Amt fuer Stadtplanung und Umwelt
20.02.2023 08:00;346;176;170;Sonnig;3;3;0;Stadt Konstanz, Amt fuer Stadtplanung und Umwelt
20.02.2023 09:00;270;142;128;Sonnig;4;4;0;Stadt Konstanz, Amt fuer Stadtplanung und Umwelt
20.02.2023 10:00;255;142;113;Sonnig;7;7;0;Stadt Konstanz, Amt fuer Stadtplanung und Umwelt
20.02.2023 11:00;305;147;158;Sonnig;9;9;0;Stadt Konstanz, Amt fuer Stadtplanung und Umwelt
20.02.2023 12:00;417;185;232;Sonnig;11;11;0;Stadt Konstanz, Amt fuer Stadtplanung und Umwelt
20.02.2023 13:00;533;314;219;Sonnig;12;12;0;Stadt Konstanz, Amt fuer Stadtplanung und Umwelt
20.02.2023 14:00;415;192;223;Bedeckt;13;13;0;Stadt Konstanz, Amt fuer Stadtplanung und Umwelt
20.02.2023 15:00;486;239;247;Bedeckt;13;13;0;Stadt Konstanz, Amt fuer Stadtplanung und Umwelt
20.02.2023 16:00;582;284;298;Bedeckt;11;11;0;Stadt Konstanz, Amt fuer Stadtplanung und Umwelt
20.02.2023 17:00;559;236;323;Sonnig;10;10;0;Stadt Konstanz, Amt fuer Stadtplanung und Umwelt
20.02.2023 18:00;448;226;222;Sonnig;8;8;0;Stadt Konstanz, Amt fuer Stadtplanung und Umwelt
20.02.2023 19:00;303;166;137;Sonnig;7;7;0;Stadt Konstanz, Amt fuer Stadtplanung und Umwelt
20.02.2023 20:00;214;130;84;Bedeckt;6;6;0;Stadt Konstanz, Amt fuer Stadtplanung und Umwelt
20.02.2023 21:00;140;66;74;Bedeckt;5;5;0;Stadt Konstanz, Amt fuer Stadtplanung und Umwelt
20.02.2023 22:00;105;50;55;Bedeckt;5;5;0;Stadt Konstanz, Amt fuer Stadtplanung und Umwelt
20.02.2023 23:00;64;21;43;Bedeckt;5;5;0;Stadt Konstanz, Amt fuer Stadtplanung und Umwelt
21.02.2023 00:00;61;8;53;Bedeckt;5;5;0;Stadt Konstanz, Amt fuer Stadtplanung und Umwelt
21.02.2023 01:00;34;10;24;Bedeckt;4;4;0;Stadt Konstanz, Amt fuer Stadtplanung und Umwelt
21.02.2023 02:00;14;1;13;Sonnig;4;4;0;Stadt Konstanz, Amt fuer Stadtplanung und Umwelt
21.02.2023 03:00;13;1;12;Sonnig;3;3;0;Stadt Konstanz, Amt fuer Stadtplanung und Umwelt
21.02.2023 04:00;17;7;10;Sonnig;3;3;0;Stadt Konstanz, Amt fuer Stadtplanung und Umwelt
21.02.2023 05:00;50;34;16;Sonnig;2;2;0;Stadt Konstanz, Amt fuer Stadtplanung und Umwelt
21.02.2023 06:00;134;74;60;Sonnig;2;2;0;Stadt Konstanz, Amt fuer Stadtplanung und Umwelt
21.02.2023 07:00;326;179;147;Sonnig;3;3;0;Stadt Konstanz, Amt fuer Stadtplanung und Umwelt
21.02.2023 08:00;474;238;236;Sonnig;4;4;0;Stadt Konstanz, Amt fuer Stadtplanung und Umwelt
21.02.2023 09:00;352;201;151;Sonnig;5;5;0;Stadt Konstanz, Amt fuer Stadtplanung und Umwelt
21.02.2023 10:00;337;193;144;Sonnig;8;8;0;Stadt Konstanz, Amt fuer Stadtplanung und Umwelt
21.02.2023 11:00;345;179;166;Sonnig;11;11;0;Stadt Konstanz, Amt fuer Stadtplanung und Umwelt
21.02.2023 12:00;424;186;238;Sonnig;13;13;0;Stadt Konstanz, Amt fuer Stadtplanung und Umwelt
21.02.2023 13:00;442;211;231;Sonnig;14;14;0;Stadt Konstanz, Amt fuer Stadtplanung und Umwelt
21.02.2023 14:00;498;268;230;Sonnig;14;14;0;Stadt Konstanz, Amt fuer Stadtplanung und Umwelt
21.02.2023 15:00;546;258;288;Sonnig;15;15;0;Stadt Konstanz, Amt fuer Stadtplanung und Umwelt
21.02.2023 16:00;634;331;303;Sonnig;12;12;0;Stadt Konstanz, Amt fuer Stadtplanung und Umwelt
21.02.2023 17:00;699;332;367;Sonnig;10;10;0;Stadt Konstanz, Amt fuer Stadtplanung und Umwelt
21.02.2023 18:00;609;333;276;Sonnig;8;8;0;Stadt Konstanz, Amt fuer Stadtplanung und Umwelt
21.02.2023 19:00;457;158;299;Sonnig;7;7;0;Stadt Konstanz, Amt fuer Stadtplanung und Umwelt
21.02.2023 20:00;263;93;170;Sonnig;6;6;0;Stadt Konstanz, Amt fuer Stadtplanung und Umwelt
21.02.2023 21:00;164;60;104;Sonnig;5;5;0;Stadt Konstanz, Amt fuer Stadtplanung und Umwelt
21.02.2023 22:00;136;63;73;Sonnig;5;4;0;Stadt Konstanz, Amt fuer Stadtplanung und Umwelt
21.02.2023 23:00;64;28;36;Sonnig;4;4;0;Stadt Konstanz, Amt fuer Stadtplanung und Umwelt
22.02.2023 00:00;29;14;15;Sonnig;4;4;0;Stadt Konstanz, Amt fuer Stadtplanung und Umwelt
22.02.2023 01:00;30;10;20;Sonnig;3;3;0;Stadt Konstanz, Amt fuer Stadtplanung und Umwelt
22.02.2023 02:00;8;4;4;Sonnig;3;3;0;Stadt Konstanz, Amt fuer Stadtplanung und Umwelt
22.02.2023 03:00;3;2;1;Sonnig;3;3;0;Stadt Konstanz, Amt fuer Stadtplanung und Umwelt
22.02.2023 04:00;12;8;4;Sonnig;2;2;0;Stadt Konstanz, Amt fuer Stadtplanung und Umwelt
22.02.2023 05:00;47;31;16;Sonnig;2;2;0;Stadt Konstanz, Amt fuer Stadtplanung und Umwelt
22.02.2023 06:00;142;83;59;Sonnig;2;2;0;Stadt Konstanz, Amt fuer Stadtplanung und Umwelt
22.02.2023 07:00;327;167;160;Sonnig;3;3;0;Stadt Konstanz, Amt fuer Stadtplanung und Umwelt
22.02.2023 08:00;542;285;257;Bedeckt;4;4;0;Stadt Konstanz, Amt fuer Stadtplanung und Umwelt
22.02.2023 09:00;378;211;167;Bedeckt;5;5;0;Stadt Konstanz, Amt fuer Stadtplanung und Umwelt
22.02.2023 10:00;337;208;129;Bedeckt;7;6;0;Stadt Konstanz, Amt fuer Stadtplanung und Umwelt
22.02.2023 11:00;363;169;194;Bewoelkt;8;8;0;Stadt Konstanz, Amt fuer Stadtplanung und Umwelt
22.02.2023 12:00;435;177;258;Bewoelkt;10;10;0;Stadt Konstanz, Amt fuer Stadtplanung und Umwelt
22.02.2023 13:00;487;243;244;Bewoelkt;11;10;0;Stadt Konstanz, Amt fuer Stadtplanung und Umwelt
22.02.2023 14:00;486;260;226;Bewoelkt;11;11;0;Stadt Konstanz, Amt fuer Stadtplanung und Umwelt
22.02.2023 15:00;516;254;262;Bewoelkt;12;11;0;Stadt Konstanz, Amt fuer Stadtplanung und Umwelt
22.02.2023 16:00;622;297;325;Bewoelkt;11;10;0;Stadt Konstanz, Amt fuer Stadtplanung und Umwelt
22.02.2023 17:00;690;307;383;Leicht bewoelkt;10;9;0;Stadt Konstanz, Amt fuer Stadtplanung und Umwelt
22.02.2023 18:00;633;301;332;Leicht bewoelkt;8;8;0;Stadt Konstanz, Amt fuer Stadtplanung und Umwelt
22.02.2023 19:00;352;184;168;Leicht bewoelkt;8;8;0;Stadt Konstanz, Amt fuer Stadtplanung und Umwelt
22.02.2023 20:00;277;116;161;Stellenweiser Regenfall;7;7;0;Stadt Konstanz, Amt fuer Stadtplanung und Umwelt
22.02.2023 21:00;191;75;116;Stellenweiser Regenfall;6;6;0;Stadt Konstanz, Amt fuer Stadtplanung und Umwelt
22.02.2023 22:00;163;82;81;Stellenweiser Regenfall;6;6;0;Stadt Konstanz, Amt fuer Stadtplanung und Umwelt
22.02.2023 23:00;86;32;54;Nieselregen;6;6;0.1;Stadt Konstanz, Amt fuer Stadtplanung und Umwelt
23.02.2023 00:00;39;15;24;Nieselregen;6;5;0.1;Stadt Konstanz, Amt fuer Stadtplanung und Umwelt
23.02.2023 01:00;28;2;26;Nieselregen;6;6;0;Stadt Konstanz, Amt fuer Stadtplanung und Umwelt
23.02.2023 02:00;8;4;4;Leichter Nebel;6;6;0;Stadt Konstanz, Amt fuer Stadtplanung und Umwelt
23.02.2023 03:00;5;1;4;Leichter Nebel;6;6;0;Stadt Konstanz, Amt fuer Stadtplanung und Umwelt
23.02.2023 04:00;10;5;5;Leichter Nebel;6;6;0;Stadt Konstanz, Amt fuer Stadtplanung und Umwelt
23.02.2023 05:00;47;34;13;Leichter Nebel;5;5;0;Stadt Konstanz, Amt fuer Stadtplanung und Umwelt
23.02.2023 06:00;131;67;64;Leichter Nebel;5;5;0;Stadt Konstanz, Amt fuer Stadtplanung und Umwelt
23.02.2023 07:00;369;193;176;Leichter Nebel;6;6;0;Stadt Konstanz, Amt fuer Stadtplanung und Umwelt
23.02.2023 08:00;485;242;243;Bewoelkt;7;7;0;Stadt Konstanz, Amt fuer Stadtplanung und Umwelt
23.02.2023 09:00;369;203;166;Bewoelkt;8;8;0;Stadt Konstanz, Amt fuer Stadtplanung und Umwelt
23.02.2023 10:00;304;161;143;Bewoelkt;9;9;0;Stadt Konstanz, Amt fuer Stadtplanung und Umwelt
23.02.2023 11:00;339;174;165;Leicht bewoelkt;10;11;0;Stadt Konstanz, Amt fuer Stadtplanung und Umwelt
23.02.2023 12:00;395;166;229;Leicht bewoelkt;12;12;0;Stadt Konstanz, Amt fuer Stadtplanung und Umwelt
23.02.2023 13:00;447;200;247;Leicht bewoelkt;12;13;0;Stadt Konstanz, Amt fuer Stadtplanung und Umwelt
23.02.2023 14:00;499;262;237;Leicht bewoelkt;13;13;0;Stadt Konstanz, Amt fuer Stadtplanung und Umwelt
23.02.2023 15:00;507;248;259;Leicht bewoelkt;13;14;0;Stadt Konstanz, Amt fuer Stadtplanung und Umwelt
23.02.2023 16:00;679;327;352;Leicht bewoelkt;12;12;0;Stadt Konstanz, Amt fuer Stadtplanung und Umwelt
23.02.2023 17:00;701;326;375;Sonnig;10;11;0;Stadt Konstanz, Amt fuer Stadtplanung und Umwelt
23.02.2023 18:00;584;247;337;Sonnig;9;9;0;Stadt Konstanz, Amt fuer Stadtplanung und Umwelt
23.02.2023 19:00;423;192;231;Sonnig;8;8;0;Stadt Konstanz, Amt fuer Stadtplanung und Umwelt
23.02.2023 20:00;255;119;136;Leicht bewoelkt;7;7;0;Stadt Konstanz, Amt fuer Stadtplanung und Umwelt
23.02.2023 21:00;155;81;74;Leicht bewoelkt;7;6;0;Stadt Konstanz, Amt fuer Stadtplanung und Umwelt
23.02.2023 22:00;144;58;86;Leicht bewoelkt;6;5;0;Stadt Konstanz, Amt fuer Stadtplanung und Umwelt
23.02.2023 23:00;92;40;52;Sonnig;5;5;0;Stadt Konstanz, Amt fuer Stadtplanung und Umwelt
24.02.2023 00:00;55;20;35;Sonnig;5;5;0;Stadt Konstanz, Amt fuer Stadtplanung und Umwelt
24.02.2023 01:00;17;9;8;Sonnig;5;4;0;Stadt Konstanz, Amt fuer Stadtplanung und Umwelt
24.02.2023 02:00;15;11;4;Leichter Nebel;4;4;0;Stadt Konstanz, Amt fuer Stadtplanung und Umwelt
24.02.2023 03:00;1;0;1;Leichter Nebel;4;4;0;Stadt Konstanz, Amt fuer Stadtplanung und Umwelt
24.02.2023 04:00;10;7;3;Leichter Nebel;4;4;0;Stadt Konstanz, Amt fuer Stadtplanung und Umwelt
24.02.2023 05:00;47;26;21;Leichter Nebel;3;3;0;Stadt Konstanz, Amt fuer Stadtplanung und Umwelt
24.02.2023 06:00;141;77;64;Leichter Nebel;3;3;0;Stadt Konstanz, Amt fuer Stadtplanung und Umwelt
24.02.2023 07:00;313;158;155;Leichter Nebel;4;4;0;Stadt Konstanz, Amt fuer Stadtplanung und Umwelt
24.02.2023 08:00;456;232;224;Bewoelkt;5;5;0;Stadt Konstanz, Amt fuer Stadtplanung und Umwelt
24.02.2023 09:00;382;234;148;Bewoelkt;6;6;0;Stadt Konstanz, Amt fuer Stadtplanung und Umwelt
24.02.2023 10:00;375;211;164;Bewoelkt;7;7;0;Stadt Konstanz, Amt fuer Stadtplanung und Umwelt
24.02.2023 11:00;435;207;228;Leicht bewoelkt;9;8;0;Stadt Konstanz, Amt fuer Stadtplanung und Umwelt
24.02.2023 12:00;480;176;304;Leicht bewoelkt;10;10;0;Stadt Konstanz, Amt fuer Stadtplanung und Umwelt
24.02.2023 13:00;506;229;277;Leicht bewoelkt;11;10;0;Stadt Konstanz, Amt fuer Stadtplanung und Umwelt
24.02.2023 14:00;546;282;264;Stellenweise Gewitter und Niederschlaege;12;11;0;Stadt Konstanz, Amt fuer Stadtplanung und Umwelt
24.02.2023 15:00;542;271;271;Stellenweise Gewitter und Niederschlaege;13;11;0;Stadt Konstanz, Amt fuer Stadtplanung und Umwelt
24.02.2023 16:00;538;267;271;Stellenweise Gewitter und Niederschlaege;12;10;0;Stadt Konstanz, Amt fuer Stadtplanung und Umwelt
24.02.2023 17:00;536;245;291;Leichter Regenschauer;10;9;0.1;Stadt Konstanz, Amt fuer Stadtplanung und Umwelt
24.02.2023 18:00;386;175;211;Leichter Regenschauer;9;8;0.1;Stadt Konstanz, Amt fuer Stadtplanung und Umwelt
24.02.2023 19:00;291;137;154;Leichter Regenschauer;9;7;0;Stadt Konstanz, Amt fuer Stadtplanung und Umwelt
24.02.2023 20:00;241;117;124;Bedeckt;8;6;0;Stadt Konstanz, Amt fuer Stadtplanung und Umwelt
24.02.2023 21:00;174;89;85;Bedeckt;8;6;0;Stadt Konstanz, Amt fuer Stadtplanung und Umwelt
24.02.2023 22:00;125;54;71;Bedeckt;7;4;0;Stadt Konstanz, Amt fuer Stadtplanung und Umwelt
24.02.2023 23:00;98;28;70;Leichter Regenschauer;6;3;0.3;Stadt Konstanz, Amt fuer Stadtplanung und Umwelt
25.02.2023 00:00;84;31;53;Leichter Regenschauer;5;2;0.5;Stadt Konstanz, Amt fuer Stadtplanung und Umwelt
25.02.2023 01:00;69;18;51;Leichter Regenschauer;5;2;0.3;Stadt Konstanz, Amt fuer Stadtplanung und Umwelt
25.02.2023 02:00;41;7;34;Bedeckt;4;2;0;Stadt Konstanz, Amt fuer Stadtplanung und Umwelt
25.02.2023 03:00;22;6;16;Bedeckt;4;2;0;Stadt Konstanz, Amt fuer Stadtplanung und Umwelt
25.02.2023 04:00;24;8;16;Bedeckt;4;1;0;Stadt Konstanz, Amt fuer Stadtplanung und Umwelt
25.02.2023 05:00;34;17;17;Bewoelkt;3;1;0;Stadt Konstanz, Amt fuer Stadtplanung und Umwelt
25.02.2023 06:00;29;15;14;Bewoelkt;3;0;0;Stadt Konstanz, Amt fuer Stadtplanung und Umwelt
25.02.2023 07:00;53;28;25;Bewoelkt;3;1;0;Stadt Konstanz, Amt fuer Stadtplanung und Umwelt
25.02.2023 08:00;132;64;68;Leicht bewoelkt;3;1;0;Stadt Konstanz, Amt fuer Stadtplanung und Umwelt
25.02.2023 09:00;260;164;96;Leicht bewoelkt;3;1;0;Stadt Konstanz, Amt fuer Stadtplanung und Umwelt
25.02.2023 10:00;290;138;152;Leicht bewoelkt;4;2;0;Stadt Konstanz, Amt fuer Stadtplanung und Umwelt
25.02.2023 11:00;311;175;136;Leicht bewoelkt;4;4;0;Stadt Konstanz, Amt fuer Stadtplanung und Umwelt
25.02.2023 12:00;335;189;146;Leicht bewoelkt;5;5;0;Stadt Konstanz, Amt fuer Stadtplanung und Umwelt
25.02.2023 13:00;366;170;196;Leicht bewoelkt;6;5;0;Stadt Konstanz, Amt fuer Stadtplanung und Umwelt
25.02.2023 14:00;355;169;186;Leicht bewoelkt;6;5;0;Stadt Konstanz, Amt fuer Stadtplanung und Umwelt
25.02.2023 15:00;368;177;191;Leicht bewoelkt;7;6;0;Stadt Konstanz, Amt fuer Stadtplanung und Umwelt
25.02.2023 16:00;342;154;188;Leicht bewoelkt;6;4;0;Stadt Konstanz, Amt fuer Stadtplanung und Umwelt
25.02.2023 17:00;314;165;149;Leicht bewoelkt;5;2;0;Stadt Konstanz, Amt fuer Stadtplanung und Umwelt
25.02.2023 18:00;332;141;191;Leicht bewoelkt;3;0;0;Stadt Konstanz, Amt fuer Stadtplanung und Umwelt
25.02.2023 19:00;245;133;112;Leicht bewoelkt;2;-1;0;Stadt Konstanz, Amt fuer Stadtplanung und Umwelt
25.02.2023 20:00;197;98;99;Leicht bewoelkt;1;-1;0;Stadt Konstanz, Amt fuer Stadtplanung und Umwelt
25.02.2023 21:00;156;80;76;Leicht bewoelkt;0;-2;0;Stadt Konstanz, Amt fuer Stadtplanung und Umwelt
25.02.2023 22:00;95;31;64;Leicht bewoelkt;0;-3;0;Stadt Konstanz, Amt fuer Stadtplanung und Umwelt
25.02.2023 23:00;113;40;73;Leicht bewoelkt;-1;-3;0;Stadt Konstanz, Amt fuer Stadtplanung und Umwelt
26.02.2023 00:00;73;28;45;Leicht bewoelkt;-1;-3;0;Stadt Konstanz, Amt fuer Stadtplanung und Umwelt
26.02.2023 01:00;46;11;35;Leicht bewoelkt;-1;-4;0;Stadt Konstanz, Amt fuer Stadtplanung und Umwelt
26.02.2023 02:00;37;15;22;Leicht bewoelkt;-1;-4;0;Stadt Konstanz, Amt fuer Stadtplanung und Umwelt
26.02.2023 03:00;22;16;6;Leicht bewoelkt;-1;-5;0;Stadt Konstanz, Amt fuer Stadtplanung und Umwelt
26.02.2023 04:00;26;16;10;Leicht bewoelkt;-1;-5;0;Stadt Konstanz, Amt fuer Stadtplanung und Umwelt
26.02.2023 05:00;30;16;14;Bewoelkt;-2;-6;0;Stadt Konstanz, Amt fuer Stadtplanung und Umwelt
26.02.2023 06:00;26;15;11;Bewoelkt;-2;-7;0;Stadt Konstanz, Amt fuer Stadtplanung und Umwelt
26.02.2023 07:00;24;12;12;Bewoelkt;-2;-7;0;Stadt Konstanz, Amt fuer Stadtplanung und Umwelt
26.02.2023 08:00;51;22;29;Leichte Schneeschauer;-2;-7;0;Stadt Konstanz, Amt fuer Stadtplanung und Umwelt
26.02.2023 09:00;114;75;39;Leichte Schneeschauer;-1;-7;0;Stadt Konstanz, Amt fuer Stadtplanung und Umwelt
26.02.2023 10:00;108;52;56;Leichte Schneeschauer;0;-6;0;Stadt Konstanz, Amt fuer Stadtplanung und Umwelt
26.02.2023 11:00;126;59;67;Leichte Schneeschauer;1;-5;0;Stadt Konstanz, Amt fuer Stadtplanung und Umwelt
26.02.2023 12:00;192;87;105;Leichte Schneeschauer;2;-4;0;Stadt Konstanz, Amt fuer Stadtplanung und Umwelt
26.02.2023 13:00;156;78;78;Leichte Schneeschauer;2;-3;0;Stadt Konstanz, Amt fuer Stadtplanung und Umwelt
26.02.2023 14:00;165;72;93;Leicht bewoelkt;3;-3;0;Stadt Konstanz, Amt fuer Stadtplanung und Umwelt
26.02.2023 15:00;189;92;97;Leicht bewoelkt;3;-3;0;Stadt Konstanz, Amt fuer Stadtplanung und Umwelt
26.02.2023 16:00;151;65;86;Leicht bewoelkt;2;-3;0;Stadt Konstanz, Amt fuer Stadtplanung und Umwelt
26.02.2023 17:00;187;102;85;Schneeverwehungen;1;-4;0;Stadt Konstanz, Amt fuer Stadtplanung und Umwelt
26.02.2023 18:00;164;96;68;Schneeverwehungen;1;-5;0;Stadt Konstanz, Amt fuer Stadtplanung und Umwelt
26.02.2023 19:00;131;59;72;Schneeverwehungen;0;-6;0;Stadt Konstanz, Amt fuer Stadtplanung und Umwelt
26.02.2023 20:00;99;39;60;Bedeckt;0;-7;0;Stadt Konstanz, Amt fuer Stadtplanung und Umwelt
26.02.2023 21:00;79;40;39;Bedeckt;-1;-8;0;Stadt Konstanz, Amt fuer Stadtplanung und Umwelt
26.02.2023 22:00;56;27;29;Bedeckt;-1;-8;0;Stadt Konstanz, Amt fuer Stadtplanung und Umwelt
26.02.2023 23:00;23;11;12;Sonnig;-2;-9;0;Stadt Konstanz, Amt fuer Stadtplanung und Umwelt
27.02.2023 00:00;5;2;3;Sonnig;-2;-9;0;Stadt Konstanz, Amt fuer Stadtplanung und Umwelt
27.02.2023 01:00;2;2;0;Sonnig;-2;-9;0;Stadt Konstanz, Amt fuer Stadtplanung und Umwelt
27.02.2023 02:00;2;0;2;Leicht bewoelkt;-3;-10;0;Stadt Konstanz, Amt fuer Stadtplanung und Umwelt
27.02.2023 03:00;2;0;2;Leicht bewoelkt;-3;-10;0;Stadt Konstanz, Amt fuer Stadtplanung und Umwelt
27.02.2023 04:00;11;7;4;Leicht bewoelkt;-3;-10;0;Stadt Konstanz, Amt fuer Stadtplanung und Umwelt
27.02.2023 05:00;41;27;14;Bewoelkt;-2;-9;0;Stadt Konstanz, Amt fuer Stadtplanung und Umwelt
27.02.2023 06:00;139;86;53;Bewoelkt;-2;-9;0;Stadt Konstanz, Amt fuer Stadtplanung und Umwelt
27.02.2023 07:00;706;394;312;Bewoelkt;-2;-9;0;Stadt Konstanz, Amt fuer Stadtplanung und Umwelt
27.02.2023 08:00;553;290;263;Bedeckt;-2;-8;0;Stadt Konstanz, Amt fuer Stadtplanung und Umwelt
27.02.2023 09:00;422;240;182;Bedeckt;-1;-8;0;Stadt Konstanz, Amt fuer Stadtplanung und Umwelt
27.02.2023 10:00;297;133;164;Bedeckt;0;-7;0;Stadt Konstanz, Amt fuer Stadtplanung und Umwelt
27.02.2023 11:00;328;157;171;Leichter Schneefall;1;-5;0;Stadt Konstanz, Amt fuer Stadtplanung und Umwelt
27.02.2023 12:00;400;179;221;Leichter Schneefall;2;-4;0;Stadt Konstanz, Amt fuer Stadtplanung und Umwelt
27.02.2023 13:00;541;235;306;Leichter Schneefall;2;-4;0;Stadt Konstanz, Amt fuer Stadtplanung und Umwelt
27.02.2023 14:00;459;229;230;Bedeckt;2;-3;0;Stadt Konstanz, Amt fuer Stadtplanung und Umwelt
27.02.2023 15:00;607;307;300;Bedeckt;3;-3;0;Stadt Konstanz, Amt fuer Stadtplanung und Umwelt
27.02.2023 16:00;518;258;260;Bedeckt;2;-3;0;Stadt Konstanz, Amt fuer Stadtplanung und Umwelt
27.02.2023 17:00;613;275;338;Leicht bewoelkt;1;-4;0;Stadt Konstanz, Amt fuer Stadtplanung und Umwelt
27.02.2023 18:00;499;233;266;Leicht bewoelkt;1;-5;0;Stadt Konstanz, Amt fuer Stadtplanung und Umwelt
27.02.2023 19:00;398;206;192;Leicht bewoelkt;0;-5;0;Stadt Konstanz, Amt fuer Stadtplanung und Umwelt
27.02.2023 20:00;225;112;113;Sonnig;0;-6;0;Stadt Konstanz, Amt fuer Stadtplanung und Umwelt
27.02.2023 21:00;125;57;68;Sonnig;-1;-7;0;Stadt Konstanz, Amt fuer Stadtplanung und Umwelt
27.02.2023 22:00;102;37;65;Sonnig;-1;-7;0;Stadt Konstanz, Amt fuer Stadtplanung und Umwelt
27.02.2023 23:00;46;19;27;Sonnig;-2;-7;0;Stadt Konstanz, Amt fuer Stadtplanung und Umwelt
28.02.2023 00:00;39;16;23;Sonnig;-2;-8;0;Stadt Konstanz, Amt fuer Stadtplanung und Umwelt
28.02.2023 01:00;14;7;7;Sonnig;-2;-8;0;Stadt Konstanz, Amt fuer Stadtplanung und Umwelt
28.02.2023 02:00;5;3;2;Leicht bewoelkt;-3;-8;0;Stadt Konstanz, Amt fuer Stadtplanung und Umwelt
28.02.2023 03:00;1;0;1;Leicht bewoelkt;-3;-8;0;Stadt Konstanz, Amt fuer Stadtplanung und Umwelt
28.02.2023 04:00;7;3;4;Leicht bewoelkt;-3;-8;0;Stadt Konstanz, Amt fuer Stadtplanung und Umwelt
28.02.2023 05:00;47;33;14;Bewoelkt;-3;-8;0;Stadt Konstanz, Amt fuer Stadtplanung und Umwelt
28.02.2023 06:00;135;76;59;Bewoelkt;-4;-8;0;Stadt Konstanz, Amt fuer Stadtplanung und Umwelt
28.02.2023 07:00;678;391;287;Bewoelkt;-3;-8;0;Stadt Konstanz, Amt fuer Stadtplanung und Umwelt
28.02.2023 08:00;607;320;287;Bedeckt;-2;-7;0;Stadt Konstanz, Amt fuer Stadtplanung und Umwelt
28.02.2023 09:00;503;304;199;Bedeckt;-2;-7;0;Stadt Konstanz, Amt fuer Stadtplanung und Umwelt
28.02.2023 10:00;320;157;163;Bedeckt;0;-4;0;Stadt Konstanz, Amt fuer Stadtplanung und Umwelt
28.02.2023 11:00;363;180;183;Sonnig;3;-1;0;Stadt Konstanz, Amt fuer Stadtplanung und Umwelt
28.02.2023 12:00;499;198;301;Sonnig;5;2;0;Stadt Konstanz, Amt fuer Stadtplanung und Umwelt
28.02.2023 13:00;574;249;325;Sonnig;6;2;0;Stadt Konstanz, Amt fuer Stadtplanung und Umwelt
28.02.2023 14:00;494;263;231;Sonnig;6;3;0;Stadt Konstanz, Amt fuer Stadtplanung und Umwelt
28.02.2023 15:00;605;320;285;Sonnig;7;4;0;Stadt Konstanz, Amt fuer Stadtplanung und Umwelt
28.02.2023 16:00;603;284;319;Sonnig;5;2;0;Stadt Konstanz, Amt fuer Stadtplanung und Umwelt
28.02.2023 17:00;695;315;380;Sonnig;4;0;0;Stadt Konstanz, Amt fuer Stadtplanung und Umwelt
28.02.2023 18:00;586;252;334;Sonnig;2;-2;0;Stadt Konstanz, Amt fuer Stadtplanung und Umwelt
28.02.2023 19:00;400;192;208;Sonnig;1;-3;0;Stadt Konstanz, Amt fuer Stadtplanung und Umwelt
28.02.2023 20:00;262;137;125;Sonnig;-1;-5;0;Stadt Konstanz, Amt fuer Stadtplanung und Umwelt
28.02.2023 21:00;175;75;100;Sonnig;-3;-6;0;Stadt Konstanz, Amt fuer Stadtplanung und Umwelt
28.02.2023 22:00;155;70;85;Sonnig;-3;-6;0;Stadt Konstanz, Amt fuer Stadtplanung und Umwelt
28.02.2023 23:00;87;39;48;Sonnig;-3;-6;0;Stadt Konstanz, Amt fuer Stadtplanung und Umwelt
01.03.2023 00:00;44;20;24;Sonnig;-3;-7;0;Stadt Konstanz, Amt fuer Stadtplanung und Umwelt
01.03.2023 01:00;15;8;7;Sonnig;-3;-7;0;Stadt Konstanz, Amt fuer Stadtplanung und Umwelt
01.03.2023 02:00;5;0;5;Leicht bewoelkt;-3;-7;0;Stadt Konstanz, Amt fuer Stadtplanung und Umwelt
01.03.2023 03:00;2;0;2;Leicht bewoelkt;-4;-7;0;Stadt Konstanz, Amt fuer Stadtplanung und Umwelt
01.03.2023 04:00;10;4;6;Leicht bewoelkt;-4;-7;0;Stadt Konstanz, Amt fuer Stadtplanung und Umwelt
01.03.2023 05:00;41;27;14;Bedeckt;-3;-7;0;Stadt Konstanz, Amt fuer Stadtplanung und Umwelt
01.03.2023 06:00;148;83;65;Bedeckt;-3;-8;0;Stadt Konstanz, Amt fuer Stadtplanung und Umwelt
01.03.2023 07:00;707;404;303;Bedeckt;-3;-7;0;Stadt Konstanz, Amt fuer Stadtplanung und Umwelt
01.03.2023 08:00;613;330;283;Bedeckt;-2;-6;0;Stadt Konstanz, Amt fuer Stadtplanung und Umwelt
01.03.2023 09:00;526;304;222;Bedeckt;-1;-5;0;Stadt Konstanz, Amt fuer Stadtplanung und Umwelt
01.03.2023 10:00;327;167;160;Bedeckt;1;-4;0;Stadt Konstanz, Amt fuer Stadtplanung und Umwelt
01.03.2023 11:00;333;149;184;Leicht bewoelkt;2;-2;0;Stadt Konstanz, Amt fuer Stadtplanung und Umwelt
01.03.2023 12:00;448;188;260;Leicht bewoelkt;4;0;0;Stadt Konstanz, Amt fuer Stadtplanung und Umwelt
01.03.2023 13:00;713;334;379;Leicht bewoelkt;5;1;0;Stadt Konstanz, Amt fuer Stadtplanung und Umwelt
01.03.2023 14:00;459;235;224;Sonnig;6;3;0;Stadt Konstanz, Amt fuer Stadtplanung und Umwelt
01.03.2023 15:00;666;299;367;Sonnig;7;4;0;Stadt Konstanz, Amt fuer Stadtplanung und Umwelt
01.03.2023 16:00;638;289;349;Sonnig;6;2;0;Stadt Konstanz, Amt fuer Stadtplanung und Umwelt
01.03.2023 17:00;699;305;394;Bewoelkt;4;1;0;Stadt Konstanz, Amt fuer Stadtplanung und Umwelt
01.03.2023 18:00;603;260;343;Bewoelkt;2;-1;0;Stadt Konstanz, Amt fuer Stadtplanung und Umwelt
01.03.2023 19:00;378;163;215;Bewoelkt;1;-3;0;Stadt Konstanz, Amt fuer Stadtplanung und Umwelt
01.03.2023 20:00;276;151;125;Bewoelkt;-1;-4;0;Stadt Konstanz, Amt fuer Stadtplanung und Umwelt
01.03.2023 21:00;193;107;86;Bewoelkt;-2;-5;0;Stadt Konstanz, Amt fuer Stadtplanung und Umwelt
01.03.2023 22:00;147;71;76;Bewoelkt;-2;-5;0;Stadt Konstanz, Amt fuer Stadtplanung und Umwelt
01.03.2023 23:00;72;32;40;Bewoelkt;-2;-5;0;Stadt Konstanz, Amt fuer Stadtplanung und Umwelt
02.03.2023 00:00;31;8;23;Bewoelkt;-1;-4;0;Stadt Konstanz, Amt fuer Stadtplanung und Umwelt
02.03.2023 01:00;24;12;12;Bewoelkt;-1;-4;0;Stadt Konstanz, Amt fuer Stadtplanung und Umwelt
02.03.2023 02:00;5;2;3;Bedeckt;0;-3;0;Stadt Konstanz, Amt fuer Stadtplanung und Umwelt
02.03.2023 03:00;6;4;2;Bedeckt;0;-3;0;Stadt Konstanz, Amt fuer Stadtplanung und Umwelt
02.03.2023 04:00;9;4;5;Bedeckt;0;-3;0;Stadt Konstanz, Amt fuer Stadtplanung und Umwelt
02.03.2023 05:00;42;24;18;Bedeckt;0;-2;0;Stadt Konstanz, Amt fuer Stadtplanung und Umwelt
02.03.2023 06:00;144;82;62;Bedeckt;-1;-2;0;Stadt Konstanz, Amt fuer Stadtplanung und Umwelt
02.03.2023 07:00;777;475;302;Bedeckt;0;-1;0;Stadt Konstanz, Amt fuer Stadtplanung und Umwelt
02.03.2023 08:00;597;318;279;Bedeckt;0;0;0;Stadt Konstanz, Amt fuer Stadtplanung und Umwelt
02.03.2023 09:00;467;282;185;Bedeckt;1;1;0;Stadt Konstanz, Amt fuer Stadtplanung und Umwelt
02.03.2023 10:00;331;166;165;Bedeckt;2;2;0;Stadt Konstanz, Amt fuer Stadtplanung und Umwelt
02.03.2023 11:00;381;176;205;Bewoelkt;3;3;0;Stadt Konstanz, Amt fuer Stadtplanung und Umwelt
02.03.2023 12:00;454;177;277;Bewoelkt;4;4;0;Stadt Konstanz, Amt fuer Stadtplanung und Umwelt
02.03.2023 13:00;614;252;362;Bewoelkt;4;4;0;Stadt Konstanz, Amt fuer Stadtplanung und Umwelt
02.03.2023 14:00;457;228;229;Bedeckt;5;4;0;Stadt Konstanz, Amt fuer Stadtplanung und Umwelt
02.03.2023 15:00;730;348;382;Bedeckt;5;4;0;Stadt Konstanz, Amt fuer Stadtplanung und Umwelt
02.03.2023 16:00;690;333;357;Bedeckt;5;3;0;Stadt Konstanz, Amt fuer Stadtplanung und Umwelt
02.03.2023 17:00;725;304;421;Bedeckt;4;2;0;Stadt Konstanz, Amt fuer Stadtplanung und Umwelt
02.03.2023 18:00;599;284;315;Bedeckt;3;1;0;Stadt Konstanz, Amt fuer Stadtplanung und Umwelt
02.03.2023 19:00;435;214;221;Bedeckt;3;2;0;Stadt Konstanz, Amt fuer Stadtplanung und Umwelt
02.03.2023 20:00;257;122;135;Bedeckt;2;2;0;Stadt Konstanz, Amt fuer Stadtplanung und Umwelt
02.03.2023 21:00;202;101;101;Bedeckt;2;2;0;Stadt Konstanz, Amt fuer Stadtplanung und Umwelt
02.03.2023 22:00;170;90;80;Bedeckt;2;2;0;Stadt Konstanz, Amt fuer Stadtplanung und Umwelt
02.03.2023 23:00;95;35;60;Bedeckt;2;2;0;Stadt Konstanz, Amt fuer Stadtplanung und Umwelt
03.03.2023 00:00;47;19;28;Bedeckt;2;2;0;Stadt Konstanz, Amt fuer Stadtplanung und Umwelt
03.03.2023 01:00;38;10;28;Bedeckt;2;2;0;Stadt Konstanz, Amt fuer Stadtplanung und Umwelt
03.03.2023 02:00;14;7;7;Bewoelkt;2;2;0;Stadt Konstanz, Amt fuer Stadtplanung und Umwelt
03.03.2023 03:00;3;1;2;Bewoelkt;2;2;0;Stadt Konstanz, Amt fuer Stadtplanung und Umwelt
03.03.2023 04:00;14;8;6;Bewoelkt;2;2;0;Stadt Konstanz, Amt fuer Stadtplanung und Umwelt
03.03.2023 05:00;39;27;12;Bewoelkt;2;2;0;Stadt Konstanz, Amt fuer Stadtplanung und Umwelt
03.03.2023 06:00;153;85;68;Bewoelkt;2;2;0;Stadt Konstanz, Amt fuer Stadtplanung und Umwelt
03.03.2023 07:00;846;503;343;Bewoelkt;2;2;0;Stadt Konstanz, Amt fuer Stadtplanung und Umwelt
03.03.2023 08:00;625;346;279;Bewoelkt;2;2;0;Stadt Konstanz, Amt fuer Stadtplanung und Umwelt
03.03.2023 09:00;560;342;218;Bewoelkt;3;3;0;Stadt Konstanz, Amt fuer Stadtplanung und Umwelt
03.03.2023 10:00;445;225;220;Bewoelkt;4;3;0;Stadt Konstanz, Amt fuer Stadtplanung und Umwelt
03.03.2023 11:00;487;231;256;Bewoelkt;5;4;0;Stadt Konstanz, Amt fuer Stadtplanung und Umwelt
03.03.2023 12:00;697;315;382;Bewoelkt;6;5;0;Stadt Konstanz, Amt fuer Stadtplanung und Umwelt
03.03.2023 13:00;827;301;526;Bewoelkt;6;5;0;Stadt Konstanz, Amt fuer Stadtplanung und Umwelt
03.03.2023 14:00;684;354;330;Bedeckt;7;6;0;Stadt Konstanz, Amt fuer Stadtplanung und Umwelt
03.03.2023 15:00;636;324;312;Bedeckt;7;6;0;Stadt Konstanz, Amt fuer Stadtplanung und Umwelt
03.03.2023 16:00;651;334;317;Bedeckt;6;5;0;Stadt Konstanz, Amt fuer Stadtplanung und Umwelt
03.03.2023 17:00;664;318;346;Bedeckt;5;4;0;Stadt Konstanz, Amt fuer Stadtplanung und Umwelt
03.03.2023 18:00;580;240;340;Bedeckt;5;4;0;Stadt Konstanz, Amt fuer Stadtplanung und Umwelt
03.03.2023 19:00;530;270;260;Bedeckt;4;3;0;Stadt Konstanz, Amt fuer Stadtplanung und Umwelt
03.03.2023 20:00;279;144;135;Bewoelkt;3;2;0;Stadt Konstanz, Amt fuer Stadtplanung und Umwelt
03.03.2023 21:00;248;125;123;Bewoelkt;3;1;0;Stadt Konstanz, Amt fuer Stadtplanung und Umwelt
03.03.2023 22:00;222;82;140;Bewoelkt;2;1;0;Stadt Konstanz, Amt fuer Stadtplanung und Umwelt
03.03.2023 23:00;149;44;105;Bewoelkt;2;1;0;Stadt Konstanz, Amt fuer Stadtplanung und Umwelt
04.03.2023 00:00;118;46;72;Bewoelkt;2;1;0;Stadt Konstanz, Amt fuer Stadtplanung und Umwelt
04.03.2023 01:00;77;30;47;Bewoelkt;2;1;0;Stadt Konstanz, Amt fuer Stadtplanung und Umwelt
04.03.2023 02:00;52;22;30;Leicht bewoelkt;1;0;0;Stadt Konstanz, Amt fuer Stadtplanung und Umwelt
04.03.2023 03:00;26;7;19;Leicht bewoelkt;1;-1;0;Stadt Konstanz, Amt fuer Stadtplanung und Umwelt
04.03.2023 04:00;22;11;11;Leicht bewoelkt;0;-1;0;Stadt Konstanz, Amt fuer Stadtplanung und Umwelt
04.03.2023 05:00;32;13;19;Sonnig;0;-2;0;Stadt Konstanz, Amt fuer Stadtplanung und Umwelt
04.03.2023 06:00;31;17;14;Sonnig;-1;-2;0;Stadt Konstanz, Amt fuer Stadtplanung und Umwelt
04.03.2023 07:00;72;36;36;Sonnig;1;0;0;Stadt Konstanz, Amt fuer Stadtplanung und Umwelt
04.03.2023 08:00;169;85;84;Sonnig;2;2;0;Stadt Konstanz, Amt fuer Stadtplanung und Umwelt
04.03.2023 09:00;255;147;108;Sonnig;4;4;0;Stadt Konstanz, Amt fuer Stadtplanung und Umwelt
04.03.2023 10:00;295;152;143;Sonnig;6;6;0;Stadt Konstanz, Amt fuer Stadtplanung und Umwelt
04.03.2023 11:00;344;187;157;Sonnig;8;8;0;Stadt Konstanz, Amt fuer Stadtplanung und Umwelt
04.03.2023 12:00;436;239;197;Sonnig;10;10;0;Stadt Konstanz, Amt fuer Stadtplanung und Umwelt
04.03.2023 13:00;433;230;203;Sonnig;10;10;0;Stadt Konstanz, Amt fuer Stadtplanung und Umwelt
04.03.2023 14:00;464;238;226;Sonnig;10;10;0;Stadt Konstanz, Amt fuer Stadtplanung und Umwelt
04.03.2023 15:00;451;215;236;Sonnig;10;10;0;Stadt Konstanz, Amt fuer Stadtplanung und Umwelt
04.03.2023 16:00;476;222;254;Sonnig;9;8;0;Stadt Konstanz, Amt fuer Stadtplanung und Umwelt
04.03.2023 17:00;422;186;236;Sonnig;7;6;0;Stadt Konstanz, Amt fuer Stadtplanung und Umwelt
04.03.2023 18:00;379;166;213;Sonnig;5;4;0;Stadt Konstanz, Amt fuer Stadtplanung und Umwelt
04.03.2023 19:00;261;133;128;Sonnig;4;2;0;Stadt Konstanz, Amt fuer Stadtplanung und Umwelt
04.03.2023 20:00;222;114;108;Bewoelkt;3;1;0;Stadt Konstanz, Amt fuer Stadtplanung und Umwelt
04.03.2023 21:00;157;94;63;Bewoelkt;1;-1;0;Stadt Konstanz, Amt fuer Stadtplanung und Umwelt
04.03.2023 22:00;143;62;81;Bewoelkt;1;-1;0;Stadt Konstanz, Amt fuer Stadtplanung und Umwelt
04.03.2023 23:00;125;36;89;Sonnig;0;-2;0;Stadt Konstanz, Amt fuer Stadtplanung und Umwelt
05.03.2023 00:00;115;29;86;Sonnig;0;-2;0;Stadt Konstanz, Amt fuer Stadtplanung und Umwelt
05.03.2023 01:00;81;22;59;Sonnig;0;-2;0;Stadt Konstanz, Amt fuer Stadtplanung und Umwelt
05.03.2023 02:00;54;18;36;Sonnig;0;-2;0;Stadt Konstanz, Amt fuer Stadtplanung und Umwelt
05.03.2023 03:00;40;23;17;Sonnig;-1;-2;0;Stadt Konstanz, Amt fuer Stadtplanung und Umwelt
05.03.2023 04:00;30;22;8;Leicht bewoelkt;-2;-2;0;Stadt Konstanz, Amt fuer Stadtplanung und Umwelt
05.03.2023 05:00;22;12;10;Leicht bewoelkt;-2;-2;0;Stadt Konstanz, Amt fuer Stadtplanung und Umwelt
05.03.2023 06:00;24;16;8;Leichter Nebel;-1;-2;0;Stadt Konstanz, Amt fuer Stadtplanung und Umwelt
05.03.2023 07:00;23;11;12;Sonnig;-2;-2;0;Stadt Konstanz, Amt fuer Stadtplanung und Umwelt
05.03.2023 08:00;68;36;32;Leicht bewoelkt;-1;-1;0;Stadt Konstanz, Amt fuer Stadtplanung und Umwelt
05.03.2023 09:00;175;97;78;Bedeckt;2;2;0;Stadt Konstanz, Amt fuer Stadtplanung und Umwelt
05.03.2023 10:00;138;78;60;Leicht bewoelkt;4;4;0;Stadt Konstanz, Amt fuer Stadtplanung und Umwelt
05.03.2023 11:00;211;93;118;Leicht bewoelkt;6;6;0;Stadt Konstanz, Amt fuer Stadtplanung und Umwelt
05.03.2023 12:00;246;102;144;Bedeckt;5;5;0;Stadt Konstanz, Amt fuer Stadtplanung und Umwelt
05.03.2023 13:00;322;160;162;Leicht bewoelkt;8;8;0;Stadt Konstanz, Amt fuer Stadtplanung und Umwelt
05.03.2023 14:00;382;185;197;Bewoelkt;8;8;0;Stadt Konstanz, Amt fuer Stadtplanung und Umwelt
05.03.2023 15:00;321;156;165;Leicht bewoelkt;7;7;0;Stadt Konstanz, Amt fuer Stadtplanung und Umwelt
05.03.2023 16:00;308;156;152;Bedeckt;7;7;0;Stadt Konstanz, Amt fuer Stadtplanung und Umwelt
05.03.2023 17:00;352;181;171;Bewoelkt;7;7;0;Stadt Konstanz, Amt fuer Stadtplanung und Umwelt
05.03.2023 18:00;252;120;132;Bedeckt;4;4;0;Stadt Konstanz, Amt fuer Stadtplanung und Umwelt
05.03.2023 19:00;179;75;104;Bedeckt;2;0;0;Stadt Konstanz, Amt fuer Stadtplanung und Umwelt
05.03.2023 20:00;122;46;76;Leicht bewoelkt;1;-1;0;Stadt Konstanz, Amt fuer Stadtplanung und Umwelt
05.03.2023 21:00;103;50;53;Leicht bewoelkt;0;-2;0;Stadt Konstanz, Amt fuer Stadtplanung und Umwelt
05.03.2023 22:00;64;22;42;Leicht bewoelkt;-1;-2;0;Stadt Konstanz, Amt fuer Stadtplanung und Umwelt
05.03.2023 23:00;29;14;15;Leicht bewoelkt;-1;-2;0;Stadt Konstanz, Amt fuer Stadtplanung und Umwelt
06.03.2023 00:00;12;5;7;Bedeckt;0;-1;0;Stadt Konstanz, Amt fuer Stadtplanung und Umwelt
06.03.2023 01:00;9;5;4;Leicht bewoelkt;-1;-1;0;Stadt Konstanz, Amt fuer Stadtplanung und Umwelt
06.03.2023 02:00;5;3;2;Leicht bewoelkt;-1;-1;0;Stadt Konstanz, Amt fuer Stadtplanung und Umwelt
06.03.2023 03:00;3;0;3;Bedeckt;-1;-1;0;Stadt Konstanz, Amt fuer Stadtplanung und Umwelt
06.03.2023 04:00;5;3;2;Leicht bewoelkt;-1;-1;0;Stadt Konstanz, Amt fuer Stadtplanung und Umwelt
06.03.2023 05:00;53;32;21;Bedeckt;-1;-1;0;Stadt Konstanz, Amt fuer Stadtplanung und Umwelt
06.03.2023 06:00;168;104;64;Bedeckt;-1;-1;0;Stadt Konstanz, Amt fuer Stadtplanung und Umwelt
06.03.2023 07:00;788;483;305;Bedeckt;-1;-2;0;Stadt Konstanz, Amt fuer Stadtplanung und Umwelt
06.03.2023 08:00;664;356;308;Bedeckt;0;0;0;Stadt Konstanz, Amt fuer Stadtplanung und Umwelt
06.03.2023 09:00;459;263;196;Bewoelkt;1;0;0;Stadt Konstanz, Amt fuer Stadtplanung und Umwelt
06.03.2023 10:00;328;182;146;Bedeckt;3;0;0;Stadt Konstanz, Amt fuer Stadtplanung und Umwelt
06.03.2023 11:00;349;156;193;Bedeckt;5;2;0;Stadt Konstanz, Amt fuer Stadtplanung und Umwelt
06.03.2023 12:00;499;216;283;Bedeckt;5;2;0;Stadt Konstanz, Amt fuer Stadtplanung und Umwelt
06.03.2023 13:00;656;294;362;Leicht bewoelkt;7;3;0;Stadt Konstanz, Amt fuer Stadtplanung und Umwelt
06.03.2023 14:00;529;259;270;Leicht bewoelkt;7;4;0;Stadt Konstanz, Amt fuer Stadtplanung und Umwelt
06.03.2023 15:00;718;349;369;Sonnig;8;5;0;Stadt Konstanz, Amt fuer Stadtplanung und Umwelt
06.03.2023 16:00;626;307;319;Leicht bewoelkt;6;3;0;Stadt Konstanz, Amt fuer Stadtplanung und Umwelt
06.03.2023 17:00;758;328;430;Leicht bewoelkt;5;2;0;Stadt Konstanz, Amt fuer Stadtplanung und Umwelt
06.03.2023 18:00;549;251;298;Bedeckt;2;0;0;Stadt Konstanz, Amt fuer Stadtplanung und Umwelt
06.03.2023 19:00;422;213;209;Bedeckt;2;-1;0;Stadt Konstanz, Amt fuer Stadtplanung und Umwelt
06.03.2023 20:00;273;144;129;Bewoelkt;2;-1;0;Stadt Konstanz, Amt fuer Stadtplanung und Umwelt
06.03.2023 21:00;181;79;102;Sonnig;-1;-2;0;Stadt Konstanz, Amt fuer Stadtplanung und Umwelt
06.03.2023 22:00;159;73;86;Leicht bewoelkt;0;-3;0;Stadt Konstanz, Amt fuer Stadtplanung und Umwelt
06.03.2023 23:00;58;28;30;Leicht bewoelkt;-1;-4;0;Stadt Konstanz, Amt fuer Stadtplanung und Umwelt
07.03.2023 00:00;51;18;33;Bedeckt;1;-2;0;Stadt Konstanz, Amt fuer Stadtplanung und Umwelt
07.03.2023 01:00;16;6;10;Bewoelkt;-1;-3;0;Stadt Konstanz, Amt fuer Stadtplanung und Umwelt
07.03.2023 02:00;10;4;6;Bewoelkt;-1;-3;0;Stadt Konstanz, Amt fuer Stadtplanung und Umwelt
07.03.2023 03:00;5;3;2;Leichter Nebel;-2;-4;0;Stadt Konstanz, Amt fuer Stadtplanung und Umwelt
07.03.2023 04:00;7;4;3;Bedeckt;-1;-3;0;Stadt Konstanz, Amt fuer Stadtplanung und Umwelt
07.03.2023 05:00;52;33;19;Bewoelkt;-1;-3;0;Stadt Konstanz, Amt fuer Stadtplanung und Umwelt
07.03.2023 06:00;172;102;70;Leichter Nebel;-2;-4;0;Stadt Konstanz, Amt fuer Stadtplanung und Umwelt
07.03.2023 07:00;782;489;293;Leicht bewoelkt;-2;-5;0;Stadt Konstanz, Amt fuer Stadtplanung und Umwelt
07.03.2023 08:00;724;387;337;Leicht bewoelkt;-1;-3;0;Stadt Konstanz, Amt fuer Stadtplanung und Umwelt
07.03.2023 09:00;512;317;195;Leicht bewoelkt;2;-2;0;Stadt Konstanz, Amt fuer Stadtplanung und Umwelt
07.03.2023 10:00;365;198;167;Sonnig;3;0;0;Stadt Konstanz, Amt fuer Stadtplanung und Umwelt
07.03.2023 11:00;407;190;217;Sonnig;5;2;0;Stadt Konstanz, Amt fuer Stadtplanung und Umwelt
07.03.2023 12:00;542;210;332;Sonnig;7;4;0;Stadt Konstanz, Amt fuer Stadtplanung und Umwelt
07.03.2023 13:00;692;295;397;Sonnig;8;5;0;Stadt Konstanz, Amt fuer Stadtplanung und Umwelt
07.03.2023 14:00;544;259;285;Sonnig;8;5;0;Stadt Konstanz, Amt fuer Stadtplanung und Umwelt
07.03.2023 15:00;759;359;400;Leicht bewoelkt;9;6;0;Stadt Konstanz, Amt fuer Stadtplanung und Umwelt
07.03.2023 16:00;756;325;431;Sonnig;7;4;0;Stadt Konstanz, Amt fuer Stadtplanung und Umwelt
07.03.2023 17:00;798;359;439;Bewoelkt;5;2;0;Stadt Konstanz, Amt fuer Stadtplanung und Umwelt
07.03.2023 18:00;683;294;389;Sonnig;3;1;0;Stadt Konstanz, Amt fuer Stadtplanung und Umwelt
07.03.2023 19:00;454;226;228;Leicht bewoelkt;3;-1;0;Stadt Konstanz, Amt fuer Stadtplanung und Umwelt
07.03.2023 20:00;312;179;133;Sonnig;1;-3;0;Stadt Konstanz, Amt fuer Stadtplanung und Umwelt
07.03.2023 21:00;195;96;99;Leicht bewoelkt;-1;-3;0;Stadt Konstanz, Amt fuer Stadtplanung und Umwelt
07.03.2023 22:00;132;57;75;Leicht bewoelkt;2;-3;0;Stadt Konstanz, Amt fuer Stadtplanung und Umwelt
07.03.2023 23:00;96;36;60;Leicht bewoelkt;2;-3;0;Stadt Konstanz, Amt fuer Stadtplanung und Umwelt
08.03.2023 00:00;50;16;34;Sonnig;2;-3;0;Stadt Konstanz, Amt fuer Stadtplanung und Umwelt
08.03.2023 01:00;22;11;11;Bedeckt;1;-3;0;Stadt Konstanz, Amt fuer Stadtplanung und Umwelt
08.03.2023 02:00;6;2;4;Leicht bewoelkt;-1;-3;0;Stadt Konstanz, Amt fuer Stadtplanung und Umwelt
08.03.2023 03:00;2;1;1;Leicht bewoelkt;-2;-3;0;Stadt Konstanz, Amt fuer Stadtplanung und Umwelt
08.03.2023 04:00;7;5;2;Leicht bewoelkt;-2;-2;0;Stadt Konstanz, Amt fuer Stadtplanung und Umwelt
08.03.2023 05:00;53;35;18;Bedeckt;-2;-2;0;Stadt Konstanz, Amt fuer Stadtplanung und Umwelt
08.03.2023 06:00;160;91;69;Bedeckt;-1;-1;0;Stadt Konstanz, Amt fuer Stadtplanung und Umwelt
08.03.2023 07:00;749;477;272;Bedeckt;-1;-2;0;Stadt Konstanz, Amt fuer Stadtplanung und Umwelt
08.03.2023 08:00;656;343;313;Stellenweise maeßiger Schneefall;1;1;0.2;Stadt Konstanz, Amt fuer Stadtplanung und Umwelt
08.03.2023 09:00;499;295;204;Leicht bewoelkt;3;0;0;Stadt Konstanz, Amt fuer Stadtplanung und Umwelt
08.03.2023 10:00;323;165;158;Stellenweiser Nieselregen;6;3;0.2;Stadt Konstanz, Amt fuer Stadtplanung und Umwelt
08.03.2023 11:00;439;211;228;Bewoelkt;5;1;0;Stadt Konstanz, Amt fuer Stadtplanung und Umwelt
08.03.2023 12:00;512;229;283;Stellenweiser Regenfall;6;2;0.1;Stadt Konstanz, Amt fuer Stadtplanung und Umwelt
08.03.2023 13:00;745;317;428;Bedeckt;6;2;0;Stadt Konstanz, Amt fuer Stadtplanung und Umwelt
08.03.2023 14:00;502;208;294;Nieselregen;7;3;0.3;Stadt Konstanz, Amt fuer Stadtplanung und Umwelt
08.03.2023 15:00;685;311;374;Nieselregen;7;4;0.4;Stadt Konstanz, Amt fuer Stadtplanung und Umwelt
08.03.2023 16:00;622;310;312;Stellenweiser leichter Regenfall;9;6;0.8;Stadt Konstanz, Amt fuer Stadtplanung und Umwelt
08.03.2023 17:00;684;289;395;Nieselregen;10;7;0.2;Stadt Konstanz, Amt fuer Stadtplanung und Umwelt
08.03.2023 18:00;459;195;264;Nieselregen;9;5;0.4;Stadt Konstanz, Amt fuer Stadtplanung und Umwelt
08.03.2023 19:00;270;143;127;Maeßiger Regenfall;8;5;2.8;Stadt Konstanz, Amt fuer Stadtplanung und Umwelt
08.03.2023 20:00;218;104;114;Maeßiger Regenfall;8;5;3.6;Stadt Konstanz, Amt fuer Stadtplanung und Umwelt
08.03.2023 21:00;132;62;70;Maeßiger Regenfall;8;4;3.1;Stadt Konstanz, Amt fuer Stadtplanung und Umwelt
08.03.2023 22:00;113;43;70;Maeßiger Regenfall;10;6;7;Stadt Konstanz, Amt fuer Stadtplanung und Umwelt
08.03.2023 23:00;93;44;49;Leichter Regenfall;10;7;1.7;Stadt Konstanz, Amt fuer Stadtplanung und Umwelt
09.03.2023 00:00;31;9;22;Maeßiger bis starker Regen mit Gewitter;9;6;2.4;Stadt Konstanz, Amt fuer Stadtplanung und Umwelt
09.03.2023 01:00;9;3;6;Maeßiger bis starker Regen mit Gewitter;10;6;12.8;Stadt Konstanz, Amt fuer Stadtplanung und Umwelt
09.03.2023 02:00;11;4;7;Maeßiger bis starker Regen mit Gewitter;10;6;3.5;Stadt Konstanz, Amt fuer Stadtplanung und Umwelt
09.03.2023 03:00;3;2;1;Leichter Regenfall;10;7;1.5;Stadt Konstanz, Amt fuer Stadtplanung und Umwelt
09.03.2023 04:00;8;5;3;Maeßiger bis starker Regen mit Gewitter;10;6;4.8;Stadt Konstanz, Amt fuer Stadtplanung und Umwelt
09.03.2023 05:00;32;20;12;Stellenweiser Regenfall;9;6;0.5;Stadt Konstanz, Amt fuer Stadtplanung und Umwelt
09.03.2023 06:00;136;68;68;Leichter Regenschauer;9;5;1.1;Stadt Konstanz, Amt fuer Stadtplanung und Umwelt
09.03.2023 07:00;647;384;263;Bewoelkt;8;4;0;Stadt Konstanz, Amt fuer Stadtplanung und Umwelt
09.03.2023 08:00;597;324;273;Leicht bewoelkt;8;4;0;Stadt Konstanz, Amt fuer Stadtplanung und Umwelt
09.03.2023 09:00;477;265;212;Leicht bewoelkt;9;6;0;Stadt Konstanz, Amt fuer Stadtplanung und Umwelt
09.03.2023 10:00;352;175;177;Leicht bewoelkt;10;8;0;Stadt Konstanz, Amt fuer Stadtplanung und Umwelt
09.03.2023 11:00;405;194;211;Sonnig;12;9;0;Stadt Konstanz, Amt fuer Stadtplanung und Umwelt
09.03.2023 12:00;472;199;273;Sonnig;14;12;0;Stadt Konstanz, Amt fuer Stadtplanung und Umwelt
09.03.2023 13:00;639;252;387;Sonnig;14;12;0;Stadt Konstanz, Amt fuer Stadtplanung und Umwelt
09.03.2023 14:00;559;282;277;Bewoelkt;14;12;0;Stadt Konstanz, Amt fuer Stadtplanung und Umwelt
09.03.2023 15:00;667;336;331;Leicht bewoelkt;14;12;0;Stadt Konstanz, Amt fuer Stadtplanung und Umwelt
09.03.2023 16:00;704;339;365;Sonnig;14;12;0;Stadt Konstanz, Amt fuer Stadtplanung und Umwelt
09.03.2023 17:00;844;370;474;Bedeckt;12;11;0;Stadt Konstanz, Amt fuer Stadtplanung und Umwelt
09.03.2023 18:00;664;313;351;Bedeckt;9;8;0;Stadt Konstanz, Amt fuer Stadtplanung und Umwelt
09.03.2023 19:00;532;264;268;Leicht bewoelkt;9;8;0;Stadt Konstanz, Amt fuer Stadtplanung und Umwelt
09.03.2023 20:00;316;145;171;Leicht bewoelkt;7;6;0;Stadt Konstanz, Amt fuer Stadtplanung und Umwelt
09.03.2023 21:00;243;123;120;Leicht bewoelkt;6;5;0;Stadt Konstanz, Amt fuer Stadtplanung und Umwelt
09.03.2023 22:00;217;88;129;Leicht bewoelkt;6;6;0;Stadt Konstanz, Amt fuer Stadtplanung und Umwelt
09.03.2023 23:00;128;50;78;Bewoelkt;6;5;0;Stadt Konstanz, Amt fuer Stadtplanung und Umwelt
10.03.2023 00:00;63;19;44;Bewoelkt;5;4;0;Stadt Konstanz, Amt fuer Stadtplanung und Umwelt
10.03.2023 01:00;21;6;15;Bedeckt;5;3;0;Stadt Konstanz, Amt fuer Stadtplanung und Umwelt
10.03.2023 02:00;10;8;2;Bedeckt;6;4;0;Stadt Konstanz, Amt fuer Stadtplanung und Umwelt
10.03.2023 03:00;9;3;6;Bedeckt;6;5;0;Stadt Konstanz, Amt fuer Stadtplanung und Umwelt
10.03.2023 04:00;7;4;3;Leichter Regenfall;7;4;1.3;Stadt Konstanz, Amt fuer Stadtplanung und Umwelt
10.03.2023 05:00;33;18;15;Stellenweiser leichter Regenfall;7;5;1;Stadt Konstanz, Amt fuer Stadtplanung und Umwelt
10.03.2023 06:00;153;81;72;Leichter Regenfall;7;4;1;Stadt Konstanz, Amt fuer Stadtplanung und Umwelt
10.03.2023 07:00;735;441;294;Maeßiger Regenfall;7;3;4.4;Stadt Konstanz, Amt fuer Stadtplanung und Umwelt
10.03.2023 08:00;507;279;228;Nieselregen;7;3;0.3;Stadt Konstanz, Amt fuer Stadtplanung und Umwelt
10.03.2023 09:00;326;195;131;Bedeckt;7;3;0;Stadt Konstanz, Amt fuer Stadtplanung und Umwelt
10.03.2023 10:00;296;161;135;Leichter Regenschauer;6;2;0.6;Stadt Konstanz, Amt fuer Stadtplanung und Umwelt
10.03.2023 11:00;398;192;206;Leicht bewoelkt;9;5;0;Stadt Konstanz, Amt fuer Stadtplanung und Umwelt
10.03.2023 12:00;534;228;306;Stellenweiser Regenfall;9;6;0.1;Stadt Konstanz, Amt fuer Stadtplanung und Umwelt
10.03.2023 13:00;617;246;371;Leicht bewoelkt;10;6;0;Stadt Konstanz, Amt fuer Stadtplanung und Umwelt
10.03.2023 14:00;418;199;219;Stellenweiser Regenfall;10;6;0.1;Stadt Konstanz, Amt fuer Stadtplanung und Umwelt
10.03.2023 15:00;427;208;219;Bewoelkt;9;4;0;Stadt Konstanz, Amt fuer Stadtplanung und Umwelt
10.03.2023 16:00;439;213;226;Stellenweiser Regenfall;8;3;0.2;Stadt Konstanz, Amt fuer Stadtplanung und Umwelt
10.03.2023 17:00;396;172;224;Bedeckt;6;1;0;Stadt Konstanz, Amt fuer Stadtplanung und Umwelt
10.03.2023 18:00;322;142;180;Stellenweiser Regenfall;5;-1;0.1;Stadt Konstanz, Amt fuer Stadtplanung und Umwelt
10.03.2023 19:00;268;122;146;Bewoelkt;5;0;0;Stadt Konstanz, Amt fuer Stadtplanung und Umwelt
10.03.2023 20:00;221;133;88;Bewoelkt;5;-1;0;Stadt Konstanz, Amt fuer Stadtplanung und Umwelt
10.03.2023 21:00;142;60;82;Bedeckt;5;-1;0;Stadt Konstanz, Amt fuer Stadtplanung und Umwelt
10.03.2023 22:00;114;43;71;Leichter Eisregen;4;-2;0.2;Stadt Konstanz, Amt fuer Stadtplanung und Umwelt
10.03.2023 23:00;107;38;69;Bedeckt;3;-2;0;Stadt Konstanz, Amt fuer Stadtplanung und Umwelt
11.03.2023 00:00;66;21;45;Leichte Eisregen;4;-2;0.3;Stadt Konstanz, Amt fuer Stadtplanung und Umwelt
11.03.2023 01:00;67;22;45;Leichter Eisregen;3;-2;0.8;Stadt Konstanz, Amt fuer Stadtplanung und Umwelt
11.03.2023 02:00;47;21;26;Starker Schneefall;3;-2;0.7;Stadt Konstanz, Amt fuer Stadtplanung und Umwelt
11.03.2023 03:00;25;12;13;Maeßiger Schneefall;2;-2;0.2;Stadt Konstanz, Amt fuer Stadtplanung und Umwelt
11.03.2023 04:00;16;8;8;Starker Schneefall;2;-1;1.6;Stadt Konstanz, Amt fuer Stadtplanung und Umwelt
11.03.2023 05:00;26;17;9;Stellenweise maeßiger Schneefall;2;-1;0.1;Stadt Konstanz, Amt fuer Stadtplanung und Umwelt
11.03.2023 06:00;27;16;11;Starker Schneefall;2;0;0.3;Stadt Konstanz, Amt fuer Stadtplanung und Umwelt
11.03.2023 07:00;75;36;39;Leicht bewoelkt;1;1;0;Stadt Konstanz, Amt fuer Stadtplanung und Umwelt
11.03.2023 08:00;139;76;63;Leichte Schneeschauer;2;1;0.1;Stadt Konstanz, Amt fuer Stadtplanung und Umwelt
11.03.2023 09:00;271;158;113;Bedeckt;2;0;0;Stadt Konstanz, Amt fuer Stadtplanung und Umwelt
11.03.2023 10:00;271;151;120;Maeßige bis starke Schneefaelle;3;0;0.2;Stadt Konstanz, Amt fuer Stadtplanung und Umwelt
11.03.2023 11:00;364;202;162;Bedeckt;4;2;0;Stadt Konstanz, Amt fuer Stadtplanung und Umwelt
11.03.2023 12:00;438;219;219;Leichte Schneeschauer;4;3;0.1;Stadt Konstanz, Amt fuer Stadtplanung und Umwelt
11.03.2023 13:00;429;202;227;Bedeckt;5;5;0;Stadt Konstanz, Amt fuer Stadtplanung und Umwelt
11.03.2023 14:00;446;221;225;Bedeckt;5;5;0;Stadt Konstanz, Amt fuer Stadtplanung und Umwelt
11.03.2023 15:00;460;225;235;Bedeckt;5;4;0;Stadt Konstanz, Amt fuer Stadtplanung und Umwelt
11.03.2023 16:00;379;165;214;Stellenweiser Regenfall;5;4;0.1;Stadt Konstanz, Amt fuer Stadtplanung und Umwelt
11.03.2023 17:00;377;162;215;Bedeckt;5;4;0;Stadt Konstanz, Amt fuer Stadtplanung und Umwelt
11.03.2023 18:00;359;147;212;Stellenweiser Regenfall;3;3;0.1;Stadt Konstanz, Amt fuer Stadtplanung und Umwelt
11.03.2023 19:00;261;140;121;Leichte Eisregen;1;1;0.3;Stadt Konstanz, Amt fuer Stadtplanung und Umwelt
11.03.2023 20:00;196;120;76;Leichter Schneefall;1;1;0.1;Stadt Konstanz, Amt fuer Stadtplanung und Umwelt
11.03.2023 21:00;143;68;75;Leichte Schneeschauer;1;0;0;Stadt Konstanz, Amt fuer Stadtplanung und Umwelt
11.03.2023 22:00;112;41;71;Maeßige bis starke Schneefaelle;1;0;0.1;Stadt Konstanz, Amt fuer Stadtplanung und Umwelt
11.03.2023 23:00;121;48;73;Leichte Schneeschauer;0;0;0;Stadt Konstanz, Amt fuer Stadtplanung und Umwelt
12.03.2023 00:00;106;26;80;Leichter Nebel;1;0;0;Stadt Konstanz, Amt fuer Stadtplanung und Umwelt
12.03.2023 01:00;78;31;47;Maeßige bis starke Schneefaelle;1;0;0.2;Stadt Konstanz, Amt fuer Stadtplanung und Umwelt
12.03.2023 02:00;59;25;34;Starker Schneefall;1;-1;0.6;Stadt Konstanz, Amt fuer Stadtplanung und Umwelt
12.03.2023 03:00;33;12;21;Starker Schneefall;1;-1;0.6;Stadt Konstanz, Amt fuer Stadtplanung und Umwelt
12.03.2023 04:00;21;13;8;Starker Schneefall;2;0;1.2;Stadt Konstanz, Amt fuer Stadtplanung und Umwelt
12.03.2023 05:00;18;6;12;Leichter Eisregen;2;0;0.3;Stadt Konstanz, Amt fuer Stadtplanung und Umwelt
12.03.2023 06:00;24;14;10;Leichter Eisregen;2;0;0.3;Stadt Konstanz, Amt fuer Stadtplanung und Umwelt
12.03.2023 07:00;23;10;13;Leichter Regenfall;3;0;1.4;Stadt Konstanz, Amt fuer Stadtplanung und Umwelt
12.03.2023 08:00;65;36;29;Nebel;3;1;0.1;Stadt Konstanz, Amt fuer Stadtplanung und Umwelt
12.03.2023 09:00;139;81;58;Nebel;4;2;0;Stadt Konstanz, Amt fuer Stadtplanung und Umwelt
12.03.2023 10:00;152;65;87;Nieselregen;7;4;0.6;Stadt Konstanz, Amt fuer Stadtplanung und Umwelt
12.03.2023 11:00;176;91;85;Bedeckt;7;4;0;Stadt Konstanz, Amt fuer Stadtplanung und Umwelt
12.03.2023 12:00;155;62;93;Stellenweiser Regenfall;9;6;0.1;Stadt Konstanz, Amt fuer Stadtplanung und Umwelt
12.03.2023 13:00;233;103;130;Bedeckt;9;6;0;Stadt Konstanz, Amt fuer Stadtplanung und Umwelt
12.03.2023 14:00;241;117;124;Stellenweiser Regenfall;9;7;0.1;Stadt Konstanz, Amt fuer Stadtplanung und Umwelt
12.03.2023 15:00;262;132;130;Bewoelkt;10;8;0;Stadt Konstanz, Amt fuer Stadtplanung und Umwelt
12.03.2023 16:00;271;130;141;Stellenweiser Regenfall;10;8;0.4;Stadt Konstanz, Amt fuer Stadtplanung und Umwelt
12.03.2023 17:00;282;145;137;Leicht bewoelkt;10;7;0;Stadt Konstanz, Amt fuer Stadtplanung und Umwelt
12.03.2023 18:00;283;142;141;Stellenweiser Regenfall;8;6;0.1;Stadt Konstanz, Amt fuer Stadtplanung und Umwelt
12.03.2023 19:00;189;82;107;Leicht bewoelkt;8;5;0;Stadt Konstanz, Amt fuer Stadtplanung und Umwelt
12.03.2023 20:00;135;65;70;Sonnig;6;4;0;Stadt Konstanz, Amt fuer Stadtplanung und Umwelt
12.03.2023 21:00;88;28;60;Leichter Nebel;5;4;0;Stadt Konstanz, Amt fuer Stadtplanung und Umwelt
12.03.2023 22:00;61;27;34;Leichter Nebel;4;4;0;Stadt Konstanz, Amt fuer Stadtplanung und Umwelt
12.03.2023 23:00;46;20;26;Leichter Nebel;3;2;0;Stadt Konstanz, Amt fuer Stadtplanung und Umwelt
13.03.2023 00:00;15;7;8;Nebel;2;2;0;Stadt Konstanz, Amt fuer Stadtplanung und Umwelt
13.03.2023 01:00;12;5;7;Nebel;2;2;0;Stadt Konstanz, Amt fuer Stadtplanung und Umwelt
13.03.2023 02:00;6;1;5;Nebel;2;1;0;Stadt Konstanz, Amt fuer Stadtplanung und Umwelt
13.03.2023 03:00;3;1;2;Leichter Nebel;1;0;0;Stadt Konstanz, Amt fuer Stadtplanung und Umwelt
13.03.2023 04:00;10;5;5;Leichter Nebel;1;0;0;Stadt Konstanz, Amt fuer Stadtplanung und Umwelt
13.03.2023 05:00;55;35;20;Leichter Nebel;1;0;0;Stadt Konstanz, Amt fuer Stadtplanung und Umwelt
13.03.2023 06:00;186;98;88;Bedeckt;2;1;0;Stadt Konstanz, Amt fuer Stadtplanung und Umwelt
13.03.2023 07:00;890;553;337;Bewoelkt;2;1;0;Stadt Konstanz, Amt fuer Stadtplanung und Umwelt
13.03.2023 08:00;651;354;297;Bedeckt;3;2;0;Stadt Konstanz, Amt fuer Stadtplanung und Umwelt
13.03.2023 09:00;657;403;254;Leicht bewoelkt;5;4;0;Stadt Konstanz, Amt fuer Stadtplanung und Umwelt
13.03.2023 10:00;413;240;173;Bewoelkt;7;6;0;Stadt Konstanz, Amt fuer Stadtplanung und Umwelt
13.03.2023 11:00;550;260;290;Sonnig;9;9;0;Stadt Konstanz, Amt fuer Stadtplanung und Umwelt
13.03.2023 12:00;575;249;326;Sonnig;11;10;0;Stadt Konstanz, Amt fuer Stadtplanung und Umwelt
13.03.2023 13:00;831;372;459;Sonnig;12;12;0;Stadt Konstanz, Amt fuer Stadtplanung und Umwelt
13.03.2023 14:00;656;327;329;Sonnig;16;16;0;Stadt Konstanz, Amt fuer Stadtplanung und Umwelt
13.03.2023 15:00;931;433;498;Sonnig;16;16;0;Stadt Konstanz, Amt fuer Stadtplanung und Umwelt
13.03.2023 16:00;898;439;459;Sonnig;17;17;0;Stadt Konstanz, Amt fuer Stadtplanung und Umwelt
13.03.2023 17:00;1000;442;558;Sonnig;13;12;0;Stadt Konstanz, Amt fuer Stadtplanung und Umwelt
13.03.2023 18:00;794;310;484;Sonnig;9;8;0;Stadt Konstanz, Amt fuer Stadtplanung und Umwelt
13.03.2023 19:00;561;284;277;Leichter Nebel;8;7;0;Stadt Konstanz, Amt fuer Stadtplanung und Umwelt
13.03.2023 20:00;351;159;192;Nieselregen;10;8;0.6;Stadt Konstanz, Amt fuer Stadtplanung und Umwelt
13.03.2023 21:00;230;98;132;Bedeckt;9;7;0;Stadt Konstanz, Amt fuer Stadtplanung und Umwelt
13.03.2023 22:00;154;58;96;Maeßiger Regenfall;8;6;7.2;Stadt Konstanz, Amt fuer Stadtplanung und Umwelt
13.03.2023 23:00;93;36;57;Leichter Nebel;7;5;0;Stadt Konstanz, Amt fuer Stadtplanung und Umwelt
14.03.2023 00:00;39;8;31;Leichter Regenschauer;8;5;0.9;Stadt Konstanz, Amt fuer Stadtplanung und Umwelt
14.03.2023 01:00;27;11;16;Bedeckt;7;3;0;Stadt Konstanz, Amt fuer Stadtplanung und Umwelt
14.03.2023 02:00;12;8;4;Leichter Regenfall;8;4;2;Stadt Konstanz, Amt fuer Stadtplanung und Umwelt
14.03.2023 03:00;4;4;0;Leichter Regenfall;7;4;1.1;Stadt Konstanz, Amt fuer Stadtplanung und Umwelt
14.03.2023 04:00;19;13;6;Maeßiger Regenfall;7;4;2.5;Stadt Konstanz, Amt fuer Stadtplanung und Umwelt
14.03.2023 05:00;57;39;18;Stellenweiser Nieselregen;6;4;0.6;Stadt Konstanz, Amt fuer Stadtplanung und Umwelt
14.03.2023 06:00;177;98;79;Stellenweiser Regenfall;6;3;0.5;Stadt Konstanz, Amt fuer Stadtplanung und Umwelt
14.03.2023 07:00;980;628;352;Stellenweiser leichter Regenfall;7;3;2.3;Stadt Konstanz, Amt fuer Stadtplanung und Umwelt
14.03.2023 08:00;696;371;325;Bewoelkt;8;4;0;Stadt Konstanz, Amt fuer Stadtplanung und Umwelt
14.03.2023 09:00;633;380;253;Bedeckt;8;4;0;Stadt Konstanz, Amt fuer Stadtplanung und Umwelt
14.03.2023 10:00;403;219;184;Nieselregen;7;3;0.3;Stadt Konstanz, Amt fuer Stadtplanung und Umwelt
14.03.2023 11:00;523;260;263;Nieselregen;6;2;0.2;Stadt Konstanz, Amt fuer Stadtplanung und Umwelt
14.03.2023 12:00;510;171;339;Leichter Regenschauer;6;2;0.4;Stadt Konstanz, Amt fuer Stadtplanung und Umwelt
14.03.2023 13:00;681;289;392;Stellenweiser leichter Regenfall;9;5;1.1;Stadt Konstanz, Amt fuer Stadtplanung und Umwelt
14.03.2023 14:00;422;222;200;Stellenweiser Regenfall;9;5;0.3;Stadt Konstanz, Amt fuer Stadtplanung und Umwelt
14.03.2023 15:00;678;299;379;Stellenweiser Regenfall;8;4;0.1;Stadt Konstanz, Amt fuer Stadtplanung und Umwelt
14.03.2023 16:00;728;350;378;Stellenweiser Regenfall;8;4;0.7;Stadt Konstanz, Amt fuer Stadtplanung und Umwelt
14.03.2023 17:00;808;348;460;Bewoelkt;7;3;0;Stadt Konstanz, Amt fuer Stadtplanung und Umwelt
14.03.2023 18:00;669;285;384;Leichter Regenschauer;5;1;0.3;Stadt Konstanz, Amt fuer Stadtplanung und Umwelt
14.03.2023 19:00;488;243;245;Leichter Regenschauer;5;2;0.3;Stadt Konstanz, Amt fuer Stadtplanung und Umwelt
14.03.2023 20:00;309;149;160;Stellenweiser Regenfall;3;0;0.1;Stadt Konstanz, Amt fuer Stadtplanung und Umwelt
14.03.2023 21:00;218;95;123;Leichte Schneeschauer;3;-1;0.1;Stadt Konstanz, Amt fuer Stadtplanung und Umwelt
14.03.2023 22:00;174;66;108;Maeßige bis starke Schneefaelle;2;-2;0.4;Stadt Konstanz, Amt fuer Stadtplanung und Umwelt
14.03.2023 23:00;107;27;80;Leicht bewoelkt;2;-3;0;Stadt Konstanz, Amt fuer Stadtplanung und Umwelt
15.03.2023 00:00;47;12;35;Maeßige bis starke Schneefaelle;0;-2;0.1;Stadt Konstanz, Amt fuer Stadtplanung und Umwelt
15.03.2023 01:00;37;12;25;Maeßige bis starke Schneefaelle;0;-1;0.3;Stadt Konstanz, Amt fuer Stadtplanung und Umwelt
15.03.2023 02:00;8;4;4;Leicht bewoelkt;0;0;0;Stadt Konstanz, Amt fuer Stadtplanung und Umwelt
15.03.2023 03:00;4;2;2;Bedeckt;0;-2;0;Stadt Konstanz, Amt fuer Stadtplanung und Umwelt
15.03.2023 04:00;8;4;4;Leichte Schneeschauer;1;1;0.1;Stadt Konstanz, Amt fuer Stadtplanung und Umwelt
15.03.2023 05:00;48;30;18;Leichte Schneeschauer;1;0;0;Stadt Konstanz, Amt fuer Stadtplanung und Umwelt
15.03.2023 06:00;184;109;75;Leichte Schneeschauer;0;-1;0;Stadt Konstanz, Amt fuer Stadtplanung und Umwelt
15.03.2023 07:00;958;624;334;Maeßige bis starke Schneefaelle;0;-2;0.4;Stadt Konstanz, Amt fuer Stadtplanung und Umwelt
15.03.2023 08:00;749;415;334;Maeßige bis starke Schneefaelle;1;-2;0.3;Stadt Konstanz, Amt fuer Stadtplanung und Umwelt
15.03.2023 09:00;593;350;243;Maeßige bis starke Schneefaelle;2;-3;0.2;Stadt Konstanz, Amt fuer Stadtplanung und Umwelt
15.03.2023 10:00;384;182;202;Maeßige bis starke Schneefaelle;2;-2;0.9;Stadt Konstanz, Amt fuer Stadtplanung und Umwelt
15.03.2023 11:00;535;244;291;Leicht bewoelkt;3;-1;0;Stadt Konstanz, Amt fuer Stadtplanung und Umwelt
15.03.2023 12:00;664;284;380;Maeßige bis starke Schneefaelle;4;0;0.3;Stadt Konstanz, Amt fuer Stadtplanung und Umwelt
15.03.2023 13:00;939;426;513;Leicht bewoelkt;5;1;0;Stadt Konstanz, Amt fuer Stadtplanung und Umwelt
15.03.2023 14:00;587;291;296;Stellenweiser Regenfall;5;1;0.1;Stadt Konstanz, Amt fuer Stadtplanung und Umwelt
15.03.2023 15:00;868;392;476;Bewoelkt;5;2;0;Stadt Konstanz, Amt fuer Stadtplanung und Umwelt
15.03.2023 16:00;827;379;448;Stellenweiser Regenfall;5;2;0.1;Stadt Konstanz, Amt fuer Stadtplanung und Umwelt
15.03.2023 17:00;884;389;495;Leicht bewoelkt;5;2;0;Stadt Konstanz, Amt fuer Stadtplanung und Umwelt
15.03.2023 18:00;757;307;450;Stellenweiser Schneefall;4;1;0;Stadt Konstanz, Amt fuer Stadtplanung und Umwelt
15.03.2023 19:00;526;248;278;Sonnig;1;-2;0;Stadt Konstanz, Amt fuer Stadtplanung und Umwelt
15.03.2023 20:00;338;162;176;Sonnig;-1;-2;0;Stadt Konstanz, Amt fuer Stadtplanung und Umwelt
15.03.2023 21:00;228;96;132;Sonnig;-1;-1;0;Stadt Konstanz, Amt fuer Stadtplanung und Umwelt
15.03.2023 22:00;212;84;128;Sonnig;-2;-2;0;Stadt Konstanz, Amt fuer Stadtplanung und Umwelt
15.03.2023 23:00;109;44;65;Sonnig;-2;-2;0;Stadt Konstanz, Amt fuer Stadtplanung und Umwelt
16.03.2023 00:00;48;13;35;Bedeckt;-1;-2;0;Stadt Konstanz, Amt fuer Stadtplanung und Umwelt
16.03.2023 01:00;34;10;24;Bedeckt;-1;-2;0;Stadt Konstanz, Amt fuer Stadtplanung und Umwelt
16.03.2023 02:00;6;4;2;Bedeckt;-1;-2;0;Stadt Konstanz, Amt fuer Stadtplanung und Umwelt
16.03.2023 03:00;3;1;2;Bedeckt;-1;-2;0;Stadt Konstanz, Amt fuer Stadtplanung und Umwelt
16.03.2023 04:00;4;1;3;Bedeckt;-1;-1;0;Stadt Konstanz, Amt fuer Stadtplanung und Umwelt
16.03.2023 05:00;47;29;18;Bedeckt;-1;-2;0;Stadt Konstanz, Amt fuer Stadtplanung und Umwelt
16.03.2023 06:00;181;104;77;Bedeckt;0;-1;0;Stadt Konstanz, Amt fuer Stadtplanung und Umwelt
16.03.2023 07:00;958;607;351;Bewoelkt;1;0;0;Stadt Konstanz, Amt fuer Stadtplanung und Umwelt
16.03.2023 08:00;724;399;325;Leicht bewoelkt;2;1;0;Stadt Konstanz, Amt fuer Stadtplanung und Umwelt
16.03.2023 09:00;631;408;223;Leicht bewoelkt;3;3;0;Stadt Konstanz, Amt fuer Stadtplanung und Umwelt
16.03.2023 10:00;385;205;180;Sonnig;5;4;0;Stadt Konstanz, Amt fuer Stadtplanung und Umwelt
16.03.2023 11:00;538;282;256;Bewoelkt;7;6;0;Stadt Konstanz, Amt fuer Stadtplanung und Umwelt
16.03.2023 12:00;592;234;358;Bedeckt;8;8;0;Stadt Konstanz, Amt fuer Stadtplanung und Umwelt
16.03.2023 13:00;879;372;507;Bedeckt;9;8;0;Stadt Konstanz, Amt fuer Stadtplanung und Umwelt
16.03.2023 14:00;629;314;315;Sonnig;10;10;0;Stadt Konstanz, Amt fuer Stadtplanung und Umwelt
16.03.2023 15:00;892;419;473;Sonnig;11;11;0;Stadt Konstanz, Amt fuer Stadtplanung und Umwelt
16.03.2023 16:00;839;386;453;Sonnig;11;11;0;Stadt Konstanz, Amt fuer Stadtplanung und Umwelt
16.03.2023 17:00;1054;424;630;Sonnig;10;10;0;Stadt Konstanz, Amt fuer Stadtplanung und Umwelt
16.03.2023 18:00;824;365;459;Sonnig;6;6;0;Stadt Konstanz, Amt fuer Stadtplanung und Umwelt
16.03.2023 19:00;512;255;257;Sonnig;4;4;0;Stadt Konstanz, Amt fuer Stadtplanung und Umwelt
16.03.2023 20:00;343;148;195;Sonnig;3;3;0;Stadt Konstanz, Amt fuer Stadtplanung und Umwelt
16.03.2023 21:00;236;107;129;Leicht bewoelkt;2;2;0;Stadt Konstanz, Amt fuer Stadtplanung und Umwelt
16.03.2023 22:00;205;83;122;Sonnig;2;2;0;Stadt Konstanz, Amt fuer Stadtplanung und Umwelt
16.03.2023 23:00;109;24;85;Sonnig;2;2;0;Stadt Konstanz, Amt fuer Stadtplanung und Umwelt
17.03.2023 00:00;53;14;39;Leicht bewoelkt;2;2;0;Stadt Konstanz, Amt fuer Stadtplanung und Umwelt
17.03.2023 01:00;35;9;26;Sonnig;1;1;0;Stadt Konstanz, Amt fuer Stadtplanung und Umwelt
17.03.2023 02:00;7;2;5;Sonnig;1;1;0;Stadt Konstanz, Amt fuer Stadtplanung und Umwelt
17.03.2023 03:00;6;2;4;Sonnig;1;1;0;Stadt Konstanz, Amt fuer Stadtplanung und Umwelt
17.03.2023 04:00;11;4;7;Sonnig;1;1;0;Stadt Konstanz, Amt fuer Stadtplanung und Umwelt
17.03.2023 05:00;46;25;21;Sonnig;1;1;0;Stadt Konstanz, Amt fuer Stadtplanung und Umwelt
17.03.2023 06:00;162;94;68;Sonnig;1;1;0;Stadt Konstanz, Amt fuer Stadtplanung und Umwelt
17.03.2023 07:00;893;533;360;Sonnig;1;1;0;Stadt Konstanz, Amt fuer Stadtplanung und Umwelt
17.03.2023 08:00;616;358;258;Sonnig;3;3;0;Stadt Konstanz, Amt fuer Stadtplanung und Umwelt
17.03.2023 09:00;600;382;218;Sonnig;6;6;0;Stadt Konstanz, Amt fuer Stadtplanung und Umwelt
17.03.2023 10:00;458;243;215;Sonnig;9;9;0;Stadt Konstanz, Amt fuer Stadtplanung und Umwelt
17.03.2023 11:00;627;316;311;Sonnig;12;12;0;Stadt Konstanz, Amt fuer Stadtplanung und Umwelt
17.03.2023 12:00;774;362;412;Sonnig;13;14;0;Stadt Konstanz, Amt fuer Stadtplanung und Umwelt
17.03.2023 13:00;994;389;605;Sonnig;15;15;0;Stadt Konstanz, Amt fuer Stadtplanung und Umwelt
17.03.2023 14:00;651;307;344;Sonnig;16;16;0;Stadt Konstanz, Amt fuer Stadtplanung und Umwelt
17.03.2023 15:00;727;337;390;Sonnig;16;16;0;Stadt Konstanz, Amt fuer Stadtplanung und Umwelt
17.03.2023 16:00;701;349;352;Sonnig;16;16;0;Stadt Konstanz, Amt fuer Stadtplanung und Umwelt
17.03.2023 17:00;759;333;426;Sonnig;15;15;0;Stadt Konstanz, Amt fuer Stadtplanung und Umwelt
17.03.2023 18:00;646;277;369;Sonnig;11;11;0;Stadt Konstanz, Amt fuer Stadtplanung und Umwelt
17.03.2023 19:00;436;218;218;Sonnig;9;9;0;Stadt Konstanz, Amt fuer Stadtplanung und Umwelt
17.03.2023 20:00;292;143;149;Sonnig;8;8;0;Stadt Konstanz, Amt fuer Stadtplanung und Umwelt
17.03.2023 21:00;247;125;122;Sonnig;7;7;0;Stadt Konstanz, Amt fuer Stadtplanung und Umwelt
17.03.2023 22:00;230;97;133;Sonnig;7;7;0;Stadt Konstanz, Amt fuer Stadtplanung und Umwelt
17.03.2023 23:00;168;55;113;Sonnig;6;6;0;Stadt Konstanz, Amt fuer Stadtplanung und Umwelt
18.03.2023 00:00;93;25;68;Sonnig;6;6;0;Stadt Konstanz, Amt fuer Stadtplanung und Umwelt
18.03.2023 01:00;79;23;56;Sonnig;6;5;0;Stadt Konstanz, Amt fuer Stadtplanung und Umwelt
18.03.2023 02:00;53;15;38;Leicht bewoelkt;5;5;0;Stadt Konstanz, Amt fuer Stadtplanung und Umwelt
18.03.2023 03:00;20;6;14;Sonnig;5;5;0;Stadt Konstanz, Amt fuer Stadtplanung und Umwelt
18.03.2023 04:00;29;13;16;Sonnig;4;4;0;Stadt Konstanz, Amt fuer Stadtplanung und Umwelt
18.03.2023 05:00;31;18;13;Sonnig;4;4;0;Stadt Konstanz, Amt fuer Stadtplanung und Umwelt
18.03.2023 06:00;37;16;21;Sonnig;3;3;0;Stadt Konstanz, Amt fuer Stadtplanung und Umwelt
18.03.2023 07:00;69;39;30;Leicht bewoelkt;4;4;0;Stadt Konstanz, Amt fuer Stadtplanung und Umwelt
18.03.2023 08:00;207;116;91;Sonnig;6;6;0;Stadt Konstanz, Amt fuer Stadtplanung und Umwelt
18.03.2023 09:00;379;209;170;Sonnig;9;9;0;Stadt Konstanz, Amt fuer Stadtplanung und Umwelt
18.03.2023 10:00;395;212;183;Sonnig;11;11;0;Stadt Konstanz, Amt fuer Stadtplanung und Umwelt
18.03.2023 11:00;528;282;246;Sonnig;14;14;0;Stadt Konstanz, Amt fuer Stadtplanung und Umwelt
18.03.2023 12:00;625;309;316;Sonnig;16;16;0;Stadt Konstanz, Amt fuer Stadtplanung und Umwelt
18.03.2023 13:00;583;245;338;Sonnig;17;17;0;Stadt Konstanz, Amt fuer Stadtplanung und Umwelt
18.03.2023 14:00;615;298;317;Sonnig;17;17;0;Stadt Konstanz, Amt fuer Stadtplanung und Umwelt
18.03.2023 15:00;672;349;323;Sonnig;18;18;0;Stadt Konstanz, Amt fuer Stadtplanung und Umwelt
18.03.2023 16:00;595;317;278;Sonnig;17;17;0;Stadt Konstanz, Amt fuer Stadtplanung und Umwelt
18.03.2023 17:00;622;272;350;Sonnig;16;16;0;Stadt Konstanz, Amt fuer Stadtplanung und Umwelt
18.03.2023 18:00;508;205;303;Sonnig;12;12;0;Stadt Konstanz, Amt fuer Stadtplanung und Umwelt
18.03.2023 19:00;319;162;157;Sonnig;11;11;0;Stadt Konstanz, Amt fuer Stadtplanung und Umwelt
18.03.2023 20:00;258;150;108;Sonnig;9;9;0;Stadt Konstanz, Amt fuer Stadtplanung und Umwelt
18.03.2023 21:00;212;102;110;Sonnig;9;9;0;Stadt Konstanz, Amt fuer Stadtplanung und Umwelt
18.03.2023 22:00;181;79;102;Sonnig;8;8;0;Stadt Konstanz, Amt fuer Stadtplanung und Umwelt
18.03.2023 23:00;167;66;101;Sonnig;7;7;0;Stadt Konstanz, Amt fuer Stadtplanung und Umwelt
19.03.2023 00:00;138;39;99;Leicht bewoelkt;7;6;0;Stadt Konstanz, Amt fuer Stadtplanung und Umwelt
19.03.2023 01:00;120;34;86;Stellenweiser Regenfall;6;6;0.1;Stadt Konstanz, Amt fuer Stadtplanung und Umwelt
19.03.2023 02:00;82;21;61;Leichter Regenschauer;6;6;0.2;Stadt Konstanz, Amt fuer Stadtplanung und Umwelt
19.03.2023 03:00;42;15;27;Leichter Regenschauer;6;6;0.2;Stadt Konstanz, Amt fuer Stadtplanung und Umwelt
19.03.2023 04:00;33;20;13;Leichter Regenschauer;6;6;0.6;Stadt Konstanz, Amt fuer Stadtplanung und Umwelt
19.03.2023 05:00;24;16;8;Leichter Regenschauer;7;6;0.2;Stadt Konstanz, Amt fuer Stadtplanung und Umwelt
19.03.2023 06:00;29;15;14;Leichter Regenschauer;7;6;0.2;Stadt Konstanz, Amt fuer Stadtplanung und Umwelt
19.03.2023 07:00;34;11;23;Leichter Regenschauer;7;6;1.6;Stadt Konstanz, Amt fuer Stadtplanung und Umwelt
19.03.2023 08:00;50;23;27;Leichter Regenfall;8;6;1;Stadt Konstanz, Amt fuer Stadtplanung und Umwelt
19.03.2023 09:00;179;101;78;Leichter Regenfall;8;8;0.8;Stadt Konstanz, Amt fuer Stadtplanung und Umwelt
19.03.2023 10:00;186;88;98;Leichter Regenfall;9;8;1.6;Stadt Konstanz, Amt fuer Stadtplanung und Umwelt
19.03.2023 11:00;252;128;124;Nieselregen;9;9;0.4;Stadt Konstanz, Amt fuer Stadtplanung und Umwelt
19.03.2023 12:00;318;139;179;Nieselregen;11;10;0.3;Stadt Konstanz, Amt fuer Stadtplanung und Umwelt
19.03.2023 13:00;358;201;157;Stellenweiser leichter Regenfall;12;11;1.5;Stadt Konstanz, Amt fuer Stadtplanung und Umwelt
19.03.2023 14:00;340;168;172;Bewoelkt;12;12;0;Stadt Konstanz, Amt fuer Stadtplanung und Umwelt
19.03.2023 15:00;384;171;213;Leicht bewoelkt;12;12;0;Stadt Konstanz, Amt fuer Stadtplanung und Umwelt
19.03.2023 16:00;396;183;213;Stellenweiser Regenfall;13;13;0.1;Stadt Konstanz, Amt fuer Stadtplanung und Umwelt
19.03.2023 17:00;316;165;151;Leicht bewoelkt;13;13;0;Stadt Konstanz, Amt fuer Stadtplanung und Umwelt
19.03.2023 18:00;212;91;121;Leicht bewoelkt;11;11;0;Stadt Konstanz, Amt fuer Stadtplanung und Umwelt
19.03.2023 19:00;176;93;83;Leicht bewoelkt;8;8;0;Stadt Konstanz, Amt fuer Stadtplanung und Umwelt
19.03.2023 20:00;124;66;58;Leicht bewoelkt;7;7;0;Stadt Konstanz, Amt fuer Stadtplanung und Umwelt
19.03.2023 21:00;120;59;61;Leicht bewoelkt;6;6;0;Stadt Konstanz, Amt fuer Stadtplanung und Umwelt
19.03.2023 22:00;88;41;47;Sonnig;6;6;0;Stadt Konstanz, Amt fuer Stadtplanung und Umwelt
19.03.2023 23:00;34;15;19;Leicht bewoelkt;5;5;0;Stadt Konstanz, Amt fuer Stadtplanung und Umwelt
20.03.2023 00:00;16;6;10;Leichter Nebel;5;5;0;Stadt Konstanz, Amt fuer Stadtplanung und Umwelt
20.03.2023 01:00;9;5;4;Leichter Nebel;5;5;0;Stadt Konstanz, Amt fuer Stadtplanung und Umwelt
20.03.2023 02:00;4;1;3;Leichter Nebel;5;5;0;Stadt Konstanz, Amt fuer Stadtplanung und Umwelt
20.03.2023 03:00;7;2;5;Leichter Nebel;5;5;0;Stadt Konstanz, Amt fuer Stadtplanung und Umwelt
20.03.2023 04:00;5;3;2;Leichter Nebel;5;5;0;Stadt Konstanz, Amt fuer Stadtplanung und Umwelt
20.03.2023 05:00;46;33;13;Leichter Nebel;6;6;0;Stadt Konstanz, Amt fuer Stadtplanung und Umwelt
20.03.2023 06:00;184;106;78;Leichter Nebel;6;6;0;Stadt Konstanz, Amt fuer Stadtplanung und Umwelt
20.03.2023 07:00;927;576;351;Leichter Nebel;5;5;0;Stadt Konstanz, Amt fuer Stadtplanung und Umwelt
20.03.2023 08:00;703;389;314;Bedeckt;7;7;0;Stadt Konstanz, Amt fuer Stadtplanung und Umwelt
20.03.2023 09:00;719;436;283;Leicht bewoelkt;9;8;0;Stadt Konstanz, Amt fuer Stadtplanung und Umwelt
20.03.2023 10:00;403;210;193;Leicht bewoelkt;11;10;0;Stadt Konstanz, Amt fuer Stadtplanung und Umwelt
20.03.2023 11:00;546;262;284;Leicht bewoelkt;13;12;0;Stadt Konstanz, Amt fuer Stadtplanung und Umwelt
20.03.2023 12:00;599;243;356;Bewoelkt;14;13;0;Stadt Konstanz, Amt fuer Stadtplanung und Umwelt
20.03.2023 13:00;859;377;482;Bedeckt;14;14;0;Stadt Konstanz, Amt fuer Stadtplanung und Umwelt
20.03.2023 14:00;564;293;271;Leicht bewoelkt;14;14;0;Stadt Konstanz, Amt fuer Stadtplanung und Umwelt
20.03.2023 15:00;892;403;489;Leicht bewoelkt;15;15;0;Stadt Konstanz, Amt fuer Stadtplanung und Umwelt
20.03.2023 16:00;817;357;460;Leicht bewoelkt;15;15;0;Stadt Konstanz, Amt fuer Stadtplanung und Umwelt
20.03.2023 17:00;990;442;548;Leicht bewoelkt;13;13;0;Stadt Konstanz, Amt fuer Stadtplanung und Umwelt
20.03.2023 18:00;788;343;445;Leicht bewoelkt;11;11;0;Stadt Konstanz, Amt fuer Stadtplanung und Umwelt
20.03.2023 19:00;551;249;302;Sonnig;9;9;0;Stadt Konstanz, Amt fuer Stadtplanung und Umwelt
20.03.2023 20:00;356;158;198;Leicht bewoelkt;7;7;0;Stadt Konstanz, Amt fuer Stadtplanung und Umwelt
20.03.2023 21:00;228;104;124;Sonnig;7;6;0;Stadt Konstanz, Amt fuer Stadtplanung und Umwelt
20.03.2023 22:00;160;62;98;Sonnig;6;6;0;Stadt Konstanz, Amt fuer Stadtplanung und Umwelt
20.03.2023 23:00;76;35;41;Sonnig;6;6;0;Stadt Konstanz, Amt fuer Stadtplanung und Umwelt
21.03.2023 00:00;47;16;31;Leicht bewoelkt;5;5;0;Stadt Konstanz, Amt fuer Stadtplanung und Umwelt
21.03.2023 01:00;21;13;8;Sonnig;4;4;0;Stadt Konstanz, Amt fuer Stadtplanung und Umwelt
21.03.2023 02:00;8;4;4;Sonnig;4;4;0;Stadt Konstanz, Amt fuer Stadtplanung und Umwelt
21.03.2023 03:00;5;1;4;Sonnig;3;3;0;Stadt Konstanz, Amt fuer Stadtplanung und Umwelt
21.03.2023 04:00;8;6;2;Sonnig;3;3;0;Stadt Konstanz, Amt fuer Stadtplanung und Umwelt
21.03.2023 05:00;55;38;17;Sonnig;2;2;0;Stadt Konstanz, Amt fuer Stadtplanung und Umwelt
21.03.2023 06:00;175;105;70;Sonnig;2;2;0;Stadt Konstanz, Amt fuer Stadtplanung und Umwelt
21.03.2023 07:00;1043;686;357;Sonnig;2;2;0;Stadt Konstanz, Amt fuer Stadtplanung und Umwelt
21.03.2023 08:00;815;447;368;Leicht bewoelkt;6;6;0;Stadt Konstanz, Amt fuer Stadtplanung und Umwelt
21.03.2023 09:00;674;432;242;Leicht bewoelkt;8;8;0;Stadt Konstanz, Amt fuer Stadtplanung und Umwelt
21.03.2023 10:00;455;249;206;Leicht bewoelkt;10;10;0;Stadt Konstanz, Amt fuer Stadtplanung und Umwelt
21.03.2023 11:00;606;300;306;Sonnig;12;12;0;Stadt Konstanz, Amt fuer Stadtplanung und Umwelt
21.03.2023 12:00;674;255;419;Sonnig;13;13;0;Stadt Konstanz, Amt fuer Stadtplanung und Umwelt
21.03.2023 13:00;945;399;546;Sonnig;14;14;0;Stadt Konstanz, Amt fuer Stadtplanung und Umwelt
21.03.2023 14:00;673;352;321;Sonnig;14;14;0;Stadt Konstanz, Amt fuer Stadtplanung und Umwelt
21.03.2023 15:00;979;435;544;Sonnig;15;15;0;Stadt Konstanz, Amt fuer Stadtplanung und Umwelt
21.03.2023 16:00;924;409;515;Sonnig;15;15;0;Stadt Konstanz, Amt fuer Stadtplanung und Umwelt
21.03.2023 17:00;1033;446;587;Sonnig;13;13;0;Stadt Konstanz, Amt fuer Stadtplanung und Umwelt
21.03.2023 18:00;796;338;458;Sonnig;10;9;0;Stadt Konstanz, Amt fuer Stadtplanung und Umwelt
21.03.2023 19:00;652;289;363;Leicht bewoelkt;8;7;0;Stadt Konstanz, Amt fuer Stadtplanung und Umwelt
21.03.2023 20:00;358;161;197;Bedeckt;8;7;0;Stadt Konstanz, Amt fuer Stadtplanung und Umwelt
21.03.2023 21:00;251;101;150;Bewoelkt;8;7;0;Stadt Konstanz, Amt fuer Stadtplanung und Umwelt
21.03.2023 22:00;187;89;98;Leicht bewoelkt;8;7;0;Stadt Konstanz, Amt fuer Stadtplanung und Umwelt
21.03.2023 23:00;93;34;59;Leicht bewoelkt;7;6;0;Stadt Konstanz, Amt fuer Stadtplanung und Umwelt
22.03.2023 00:00;42;15;27;Leicht bewoelkt;7;7;0;Stadt Konstanz, Amt fuer Stadtplanung und Umwelt
22.03.2023 01:00;34;14;20;Sonnig;6;5;0;Stadt Konstanz, Amt fuer Stadtplanung und Umwelt
22.03.2023 02:00;4;1;3;Sonnig;5;5;0;Stadt Konstanz, Amt fuer Stadtplanung und Umwelt
22.03.2023 03:00;4;2;2;Leichter Nebel;4;4;0;Stadt Konstanz, Amt fuer Stadtplanung und Umwelt
22.03.2023 04:00;12;10;2;Leichter Nebel;5;5;0;Stadt Konstanz, Amt fuer Stadtplanung und Umwelt
22.03.2023 05:00;55;39;16;Leichter Nebel;4;4;0;Stadt Konstanz, Amt fuer Stadtplanung und Umwelt
22.03.2023 06:00;198;110;88;Leichter Nebel;3;3;0;Stadt Konstanz, Amt fuer Stadtplanung und Umwelt
22.03.2023 07:00;1113;748;365;Leichter Nebel;4;3;0;Stadt Konstanz, Amt fuer Stadtplanung und Umwelt
22.03.2023 08:00;838;484;354;Leicht bewoelkt;7;7;0;Stadt Konstanz, Amt fuer Stadtplanung und Umwelt
22.03.2023 09:00;752;445;307;Bewoelkt;9;9;0;Stadt Konstanz, Amt fuer Stadtplanung und Umwelt
22.03.2023 10:00;453;233;220;Leicht bewoelkt;11;10;0;Stadt Konstanz, Amt fuer Stadtplanung und Umwelt
22.03.2023 11:00;700;309;391;Sonnig;14;13;0;Stadt Konstanz, Amt fuer Stadtplanung und Umwelt
22.03.2023 12:00;800;370;430;Leicht bewoelkt;15;14;0;Stadt Konstanz, Amt fuer Stadtplanung und Umwelt
22.03.2023 13:00;1128;534;594;Sonnig;16;16;0;Stadt Konstanz, Amt fuer Stadtplanung und Umwelt
22.03.2023 14:00;823;413;410;Leicht bewoelkt;16;16;0;Stadt Konstanz, Amt fuer Stadtplanung und Umwelt
22.03.2023 15:00;1104;504;600;Leicht bewoelkt;16;16;0;Stadt Konstanz, Amt fuer Stadtplanung und Umwelt
22.03.2023 16:00;1089;546;543;Leicht bewoelkt;15;14;0;Stadt Konstanz, Amt fuer Stadtplanung und Umwelt
22.03.2023 17:00;1206;529;677;Leicht bewoelkt;14;13;0;Stadt Konstanz, Amt fuer Stadtplanung und Umwelt
22.03.2023 18:00;1049;482;567;Leicht bewoelkt;11;10;0;Stadt Konstanz, Amt fuer Stadtplanung und Umwelt
22.03.2023 19:00;671;296;375;Bewoelkt;9;9;0;Stadt Konstanz, Amt fuer Stadtplanung und Umwelt
22.03.2023 20:00;456;177;279;Bewoelkt;8;9;0;Stadt Konstanz, Amt fuer Stadtplanung und Umwelt
22.03.2023 21:00;282;104;178;Leicht bewoelkt;9;9;0;Stadt Konstanz, Amt fuer Stadtplanung und Umwelt
22.03.2023 22:00;271;105;166;Bewoelkt;8;8;0;Stadt Konstanz, Amt fuer Stadtplanung und Umwelt
22.03.2023 23:00;134;54;80;Bewoelkt;8;8;0;Stadt Konstanz, Amt fuer Stadtplanung und Umwelt
23.03.2023 00:00;69;16;53;Bewoelkt;7;7;0;Stadt Konstanz, Amt fuer Stadtplanung und Umwelt
23.03.2023 01:00;27;7;20;Bewoelkt;8;8;0;Stadt Konstanz, Amt fuer Stadtplanung und Umwelt
23.03.2023 02:00;3;1;2;Stellenweiser Regenfall;8;8;0.1;Stadt Konstanz, Amt fuer Stadtplanung und Umwelt
23.03.2023 03:00;9;4;5;Leicht bewoelkt;8;7;0;Stadt Konstanz, Amt fuer Stadtplanung und Umwelt
23.03.2023 04:00;14;9;5;Stellenweiser Regenfall;8;7;0.1;Stadt Konstanz, Amt fuer Stadtplanung und Umwelt
23.03.2023 05:00;59;39;20;Bedeckt;8;8;0;Stadt Konstanz, Amt fuer Stadtplanung und Umwelt
23.03.2023 06:00;181;98;83;Bedeckt;8;8;0;Stadt Konstanz, Amt fuer Stadtplanung und Umwelt
23.03.2023 07:00;1006;651;355;Leicht bewoelkt;8;8;0;Stadt Konstanz, Amt fuer Stadtplanung und Umwelt
23.03.2023 08:00;740;409;331;Leicht bewoelkt;9;9;0;Stadt Konstanz, Amt fuer Stadtplanung und Umwelt
23.03.2023 09:00;694;423;271;Bewoelkt;11;11;0;Stadt Konstanz, Amt fuer Stadtplanung und Umwelt
23.03.2023 10:00;399;206;193;Bedeckt;13;12;0;Stadt Konstanz, Amt fuer Stadtplanung und Umwelt
23.03.2023 11:00;588;306;282;Bedeckt;12;11;0;Stadt Konstanz, Amt fuer Stadtplanung und Umwelt
23.03.2023 12:00;634;285;349;Bedeckt;11;11;0;Stadt Konstanz, Amt fuer Stadtplanung und Umwelt
23.03.2023 13:00;960;378;582;Bedeckt;11;11;0;Stadt Konstanz, Amt fuer Stadtplanung und Umwelt
23.03.2023 14:00;612;288;324;Bedeckt;12;12;0;Stadt Konstanz, Amt fuer Stadtplanung und Umwelt
23.03.2023 15:00;874;399;475;Bedeckt;12;12;0;Stadt Konstanz, Amt fuer Stadtplanung und Umwelt
23.03.2023 16:00;810;359;451;Bedeckt;11;12;0;Stadt Konstanz, Amt fuer Stadtplanung und Umwelt
23.03.2023 17:00;1035;427;608;Bedeckt;12;12;0;Stadt Konstanz, Amt fuer Stadtplanung und Umwelt
23.03.2023 18:00;737;320;417;Bedeckt;10;10;0;Stadt Konstanz, Amt fuer Stadtplanung und Umwelt
23.03.2023 19:00;528;251;277;Nieselregen;10;10;0.4;Stadt Konstanz, Amt fuer Stadtplanung und Umwelt
23.03.2023 20:00;314;132;182;Leichter Regenfall;9;8;0.8;Stadt Konstanz, Amt fuer Stadtplanung und Umwelt
23.03.2023 21:00;277;108;169;Nieselregen;10;8;0.7;Stadt Konstanz, Amt fuer Stadtplanung und Umwelt
23.03.2023 22:00;216;84;132;Leichter Regenfall;10;9;1.9;Stadt Konstanz, Amt fuer Stadtplanung und Umwelt
23.03.2023 23:00;108;40;68;Nieselregen;10;10;0.2;Stadt Konstanz, Amt fuer Stadtplanung und Umwelt
24.03.2023 00:00;63;17;46;Bewoelkt;8;8;0;Stadt Konstanz, Amt fuer Stadtplanung und Umwelt
24.03.2023 01:00;28;11;17;Bewoelkt;8;8;0;Stadt Konstanz, Amt fuer Stadtplanung und Umwelt
24.03.2023 02:00;20;13;7;Bedeckt;7;7;0;Stadt Konstanz, Amt fuer Stadtplanung und Umwelt
24.03.2023 03:00;12;6;6;Bedeckt;7;7;0;Stadt Konstanz, Amt fuer Stadtplanung und Umwelt
24.03.2023 04:00;19;14;5;Bedeckt;7;6;0;Stadt Konstanz, Amt fuer Stadtplanung und Umwelt
24.03.2023 05:00;53;35;18;Bewoelkt;8;8;0;Stadt Konstanz, Amt fuer Stadtplanung und Umwelt
24.03.2023 06:00;133;74;59;Stellenweiser Regenfall;8;7;0.1;Stadt Konstanz, Amt fuer Stadtplanung und Umwelt
24.03.2023 07:00;796;492;304;Stellenweiser leichter Regenfall;9;8;1.2;Stadt Konstanz, Amt fuer Stadtplanung und Umwelt
24.03.2023 08:00;503;289;214;Stellenweiser Regenfall;11;10;0.1;Stadt Konstanz, Amt fuer Stadtplanung und Umwelt
24.03.2023 09:00;412;254;158;Stellenweiser Regenfall;11;11;0.1;Stadt Konstanz, Amt fuer Stadtplanung und Umwelt
24.03.2023 10:00;287;152;135;Stellenweiser leichter Regenfall;11;11;1;Stadt Konstanz, Amt fuer Stadtplanung und Umwelt
24.03.2023 11:00;371;191;180;Nieselregen;12;11;0.3;Stadt Konstanz, Amt fuer Stadtplanung und Umwelt
24.03.2023 12:00;485;208;277;Stellenweiser leichter Regenfall;12;9;0.8;Stadt Konstanz, Amt fuer Stadtplanung und Umwelt
24.03.2023 13:00;747;261;486;Maeßiger Regenfall;12;10;2.8;Stadt Konstanz, Amt fuer Stadtplanung und Umwelt
24.03.2023 14:00;436;187;249;Leichter Regenfall;12;10;0.8;Stadt Konstanz, Amt fuer Stadtplanung und Umwelt
24.03.2023 15:00;439;191;248;Nieselregen;10;7;0.2;Stadt Konstanz, Amt fuer Stadtplanung und Umwelt
24.03.2023 16:00;452;186;266;Stellenweiser leichter Regenfall;9;6;1.5;Stadt Konstanz, Amt fuer Stadtplanung und Umwelt
24.03.2023 17:00;378;190;188;Stellenweiser Regenfall;9;6;0.1;Stadt Konstanz, Amt fuer Stadtplanung und Umwelt
24.03.2023 18:00;390;174;216;Stellenweiser Regenfall;9;6;0.3;Stadt Konstanz, Amt fuer Stadtplanung und Umwelt
24.03.2023 19:00;337;171;166;Stellenweiser Nieselregen;8;5;0.3;Stadt Konstanz, Amt fuer Stadtplanung und Umwelt
24.03.2023 20:00;198;106;92;Leicht bewoelkt;6;4;0;Stadt Konstanz, Amt fuer Stadtplanung und Umwelt
24.03.2023 21:00;150;78;72;Leichter Nebel;6;4;0;Stadt Konstanz, Amt fuer Stadtplanung und Umwelt
24.03.2023 22:00;163;68;95;Leichter Nebel;5;4;0;Stadt Konstanz, Amt fuer Stadtplanung und Umwelt
24.03.2023 23:00;113;42;71;Leichter Nebel;5;4;0;Stadt Konstanz, Amt fuer Stadtplanung und Umwelt
25.03.2023 00:00;82;28;54;Stellenweiser Regenfall;7;5;0.1;Stadt Konstanz, Amt fuer Stadtplanung und Umwelt
25.03.2023 01:00;67;23;44;Nieselregen;8;4;0.5;Stadt Konstanz, Amt fuer Stadtplanung und Umwelt
25.03.2023 02:00;25;7;18;Stellenweiser Regenfall;7;4;0.1;Stadt Konstanz, Amt fuer Stadtplanung und Umwelt
25.03.2023 03:00;38;11;27;Bedeckt;7;3;0;Stadt Konstanz, Amt fuer Stadtplanung und Umwelt
25.03.2023 04:00;19;14;5;Leichter Regenschauer;7;3;0.2;Stadt Konstanz, Amt fuer Stadtplanung und Umwelt
25.03.2023 05:00;33;26;7;Stellenweise Gewitter und Niederschlaege;6;3;0;Stadt Konstanz, Amt fuer Stadtplanung und Umwelt
25.03.2023 06:00;35;21;14;Stellenweise Gewitter und Niederschlaege;6;2;0.1;Stadt Konstanz, Amt fuer Stadtplanung und Umwelt
25.03.2023 07:00;75;41;34;Stellenweise Gewitter und Niederschlaege;6;2;0;Stadt Konstanz, Amt fuer Stadtplanung und Umwelt
25.03.2023 08:00;197;93;104;Leichter Regenschauer;6;2;0.3;Stadt Konstanz, Amt fuer Stadtplanung und Umwelt
25.03.2023 09:00;347;206;141;Stellenweiser Regenfall;6;2;0.1;Stadt Konstanz, Amt fuer Stadtplanung und Umwelt
25.03.2023 10:00;296;171;125;Leichter Regenschauer;6;3;0.4;Stadt Konstanz, Amt fuer Stadtplanung und Umwelt
25.03.2023 11:00;258;129;129;Stellenweiser Regenfall;7;3;0.1;Stadt Konstanz, Amt fuer Stadtplanung und Umwelt
25.03.2023 12:00;213;111;102;Leichter Regenschauer;9;5;0.2;Stadt Konstanz, Amt fuer Stadtplanung und Umwelt
25.03.2023 13:00;325;149;176;Leichter Regenschauer;8;5;0.8;Stadt Konstanz, Amt fuer Stadtplanung und Umwelt
25.03.2023 14:00;410;208;202;Leichter Regenschauer;9;6;0.5;Stadt Konstanz, Amt fuer Stadtplanung und Umwelt
25.03.2023 15:00;392;194;198;Leichter Regenschauer;10;7;0.3;Stadt Konstanz, Amt fuer Stadtplanung und Umwelt
25.03.2023 16:00;370;192;178;Leichter Regenschauer;10;7;1.3;Stadt Konstanz, Amt fuer Stadtplanung und Umwelt
25.03.2023 17:00;373;198;175;Stellenweiser Regenfall;10;7;0.2;Stadt Konstanz, Amt fuer Stadtplanung und Umwelt
25.03.2023 18:00;353;174;179;Leichter Regenschauer;8;6;0.3;Stadt Konstanz, Amt fuer Stadtplanung und Umwelt
25.03.2023 19:00;315;194;121;Leichter Regenschauer;7;5;0.9;Stadt Konstanz, Amt fuer Stadtplanung und Umwelt
25.03.2023 20:00;253;138;115;Bewoelkt;5;4;0;Stadt Konstanz, Amt fuer Stadtplanung und Umwelt
25.03.2023 21:00;188;74;114;Bedeckt;5;4;0;Stadt Konstanz, Amt fuer Stadtplanung und Umwelt
25.03.2023 22:00;187;69;118;Bedeckt;5;5;0;Stadt Konstanz, Amt fuer Stadtplanung und Umwelt
25.03.2023 23:00;176;49;127;Leichter Nebel;5;4;0;Stadt Konstanz, Amt fuer Stadtplanung und Umwelt
26.03.2023 00:00;113;26;87;Stellenweiser Regenfall;7;5;0.1;Stadt Konstanz, Amt fuer Stadtplanung und Umwelt
26.03.2023 01:00;88;29;59;Stellenweiser Regenfall;6;4;0.1;Stadt Konstanz, Amt fuer Stadtplanung und Umwelt
26.03.2023 03:00;;;;weather_condition_null;;;;Stadt Konstanz, Amt fuer Stadtplanung und Umwelt
26.03.2023 03:00;82;34;48;Stellenweiser Regenfall;6;5;0.1;Stadt Konstanz, Amt fuer Stadtplanung und Umwelt
26.03.2023 04:00;51;23;28;Nieselregen;6;5;0.2;Stadt Konstanz, Amt fuer Stadtplanung und Umwelt
26.03.2023 05:00;41;28;13;Stellenweiser Regenfall;6;6;0.1;Stadt Konstanz, Amt fuer Stadtplanung und Umwelt
26.03.2023 06:00;20;12;8;Leichter Nebel;5;5;0.1;Stadt Konstanz, Amt fuer Stadtplanung und Umwelt
26.03.2023 07:00;29;15;14;Nieselregen;5;5;0.3;Stadt Konstanz, Amt fuer Stadtplanung und Umwelt
26.03.2023 08:00;35;18;17;Nieselregen;6;5;0.5;Stadt Konstanz, Amt fuer Stadtplanung und Umwelt
26.03.2023 09:00;74;43;31;Leichter Regenfall;6;3;1.2;Stadt Konstanz, Amt fuer Stadtplanung und Umwelt
26.03.2023 10:00;96;49;47;Maeßiger Regenfall;6;4;4.7;Stadt Konstanz, Amt fuer Stadtplanung und Umwelt
26.03.2023 11:00;117;46;71;Nieselregen;6;3;0.6;Stadt Konstanz, Amt fuer Stadtplanung und Umwelt
26.03.2023 12:00;166;85;81;Leichter Regenfall;6;3;1.4;Stadt Konstanz, Amt fuer Stadtplanung und Umwelt
26.03.2023 13:00;140;68;72;Maeßiger Regenfall;8;4;2.6;Stadt Konstanz, Amt fuer Stadtplanung und Umwelt
26.03.2023 14:00;252;121;131;Stellenweiser Regenfall;8;5;0.1;Stadt Konstanz, Amt fuer Stadtplanung und Umwelt
26.03.2023 15:00;265;138;127;Leicht bewoelkt;9;6;0;Stadt Konstanz, Amt fuer Stadtplanung und Umwelt
26.03.2023 16:00;237;118;119;Stellenweiser Regenfall;9;7;0.2;Stadt Konstanz, Amt fuer Stadtplanung und Umwelt
26.03.2023 17:00;215;107;108;Bewoelkt;9;7;0;Stadt Konstanz, Amt fuer Stadtplanung und Umwelt
26.03.2023 18:00;189;87;102;Stellenweiser Regenfall;8;6;0.1;Stadt Konstanz, Amt fuer Stadtplanung und Umwelt
26.03.2023 19:00;180;83;97;Sonnig;5;3;0;Stadt Konstanz, Amt fuer Stadtplanung und Umwelt
26.03.2023 20:00;133;73;60;Leicht bewoelkt;4;2;0;Stadt Konstanz, Amt fuer Stadtplanung und Umwelt
26.03.2023 21:00;89;48;41;Bewoelkt;4;2;0;Stadt Konstanz, Amt fuer Stadtplanung und Umwelt
26.03.2023 22:00;85;27;58;Stellenweiser Regenfall;3;2;0.1;Stadt Konstanz, Amt fuer Stadtplanung und Umwelt
26.03.2023 23:00;36;17;19;Bedeckt;4;2;0;Stadt Konstanz, Amt fuer Stadtplanung und Umwelt
27.03.2023 00:00;13;5;8;Stellenweiser Regenfall;5;3;0.1;Stadt Konstanz, Amt fuer Stadtplanung und Umwelt
27.03.2023 01:00;6;1;5;Nieselregen;5;1;0.5;Stadt Konstanz, Amt fuer Stadtplanung und Umwelt
27.03.2023 02:00;2;0;2;Nieselregen;5;2;0.4;Stadt Konstanz, Amt fuer Stadtplanung und Umwelt
27.03.2023 03:00;3;0;3;Bedeckt;5;1;0;Stadt Konstanz, Amt fuer Stadtplanung und Umwelt
27.03.2023 04:00;7;6;1;Leichter Regenfall;4;1;1.4;Stadt Konstanz, Amt fuer Stadtplanung und Umwelt
27.03.2023 05:00;51;32;19;Nebel;4;1;0;Stadt Konstanz, Amt fuer Stadtplanung und Umwelt
27.03.2023 06:00;169;94;75;Starker Schneefall;3;-2;0.8;Stadt Konstanz, Amt fuer Stadtplanung und Umwelt
27.03.2023 07:00;849;538;311;Leicht bewoelkt;2;-3;0;Stadt Konstanz, Amt fuer Stadtplanung und Umwelt
27.03.2023 08:00;635;344;291;Leicht bewoelkt;2;-2;0;Stadt Konstanz, Amt fuer Stadtplanung und Umwelt
27.03.2023 09:00;569;344;225;Bedeckt;3;-1;0;Stadt Konstanz, Amt fuer Stadtplanung und Umwelt
27.03.2023 10:00;321;182;139;Maeßige bis starke Schneefaelle;3;0;0.2;Stadt Konstanz, Amt fuer Stadtplanung und Umwelt
27.03.2023 11:00;482;244;238;Bedeckt;4;1;0;Stadt Konstanz, Amt fuer Stadtplanung und Umwelt
27.03.2023 12:00;483;214;269;Stellenweiser Regenfall;5;2;0.1;Stadt Konstanz, Amt fuer Stadtplanung und Umwelt
27.03.2023 13:00;696;308;388;Leicht bewoelkt;6;3;0;Stadt Konstanz, Amt fuer Stadtplanung und Umwelt
27.03.2023 14:00;509;254;255;Stellenweiser Regenfall;6;3;0.1;Stadt Konstanz, Amt fuer Stadtplanung und Umwelt
27.03.2023 15:00;794;375;419;Bedeckt;6;3;0;Stadt Konstanz, Amt fuer Stadtplanung und Umwelt
27.03.2023 16:00;709;337;372;Leichte Eisregen;5;2;0.6;Stadt Konstanz, Amt fuer Stadtplanung und Umwelt
27.03.2023 17:00;828;353;475;Bewoelkt;5;2;0;Stadt Konstanz, Amt fuer Stadtplanung und Umwelt
27.03.2023 18:00;741;304;437;Maeßige bis starke Schneefaelle;3;0;0.2;Stadt Konstanz, Amt fuer Stadtplanung und Umwelt
27.03.2023 19:00;562;234;328;Bewoelkt;1;-2;0;Stadt Konstanz, Amt fuer Stadtplanung und Umwelt
27.03.2023 20:00;349;170;179;Bewoelkt;0;-2;0;Stadt Konstanz, Amt fuer Stadtplanung und Umwelt
27.03.2023 21:00;257;118;139;Bedeckt;-1;-3;0;Stadt Konstanz, Amt fuer Stadtplanung und Umwelt
27.03.2023 22:00;174;76;98;Bedeckt;-1;-3;0;Stadt Konstanz, Amt fuer Stadtplanung und Umwelt
27.03.2023 23:00;66;27;39;Bedeckt;-1;-3;0;Stadt Konstanz, Amt fuer Stadtplanung und Umwelt
28.03.2023 00:00;45;19;26;Leicht bewoelkt;-2;-4;0;Stadt Konstanz, Amt fuer Stadtplanung und Umwelt
28.03.2023 01:00;18;10;8;Leichte Schneeschauer;-2;-4;0;Stadt Konstanz, Amt fuer Stadtplanung und Umwelt
28.03.2023 02:00;3;3;0;Leicht bewoelkt;-2;-3;0;Stadt Konstanz, Amt fuer Stadtplanung und Umwelt
28.03.2023 03:00;5;0;5;Sonnig;-2;-2;0;Stadt Konstanz, Amt fuer Stadtplanung und Umwelt
28.03.2023 04:00;3;1;2;Sonnig;-3;-3;0;Stadt Konstanz, Amt fuer Stadtplanung und Umwelt
28.03.2023 05:00;53;35;18;Sonnig;-3;-3;0;Stadt Konstanz, Amt fuer Stadtplanung und Umwelt
28.03.2023 06:00;170;94;76;Sonnig;-3;-3;0;Stadt Konstanz, Amt fuer Stadtplanung und Umwelt
28.03.2023 07:00;812;478;334;Sonnig;-1;-1;0;Stadt Konstanz, Amt fuer Stadtplanung und Umwelt
28.03.2023 08:00;725;426;299;Sonnig;1;0;0;Stadt Konstanz, Amt fuer Stadtplanung und Umwelt
28.03.2023 09:00;624;384;240;Sonnig;3;1;0;Stadt Konstanz, Amt fuer Stadtplanung und Umwelt
28.03.2023 10:00;393;201;192;Sonnig;4;2;0;Stadt Konstanz, Amt fuer Stadtplanung und Umwelt
28.03.2023 11:00;489;251;238;Sonnig;6;4;0;Stadt Konstanz, Amt fuer Stadtplanung und Umwelt
28.03.2023 12:00;561;243;318;Leicht bewoelkt;8;6;0;Stadt Konstanz, Amt fuer Stadtplanung und Umwelt
28.03.2023 13:00;758;353;405;Sonnig;9;7;0;Stadt Konstanz, Amt fuer Stadtplanung und Umwelt
28.03.2023 14:00;565;273;292;Leicht bewoelkt;10;9;0;Stadt Konstanz, Amt fuer Stadtplanung und Umwelt
28.03.2023 15:00;879;434;445;Bewoelkt;10;8;0;Stadt Konstanz, Amt fuer Stadtplanung und Umwelt
28.03.2023 16:00;856;375;481;Leicht bewoelkt;9;8;0;Stadt Konstanz, Amt fuer Stadtplanung und Umwelt
28.03.2023 17:00;912;385;527;Bedeckt;8;7;0;Stadt Konstanz, Amt fuer Stadtplanung und Umwelt
28.03.2023 18:00;800;340;460;Bedeckt;5;4;0;Stadt Konstanz, Amt fuer Stadtplanung und Umwelt
28.03.2023 19:00;613;267;346;Bedeckt;2;2;0;Stadt Konstanz, Amt fuer Stadtplanung und Umwelt
28.03.2023 20:00;417;176;241;Bedeckt;1;0;0;Stadt Konstanz, Amt fuer Stadtplanung und Umwelt
28.03.2023 21:00;294;118;176;Bedeckt;0;0;0;Stadt Konstanz, Amt fuer Stadtplanung und Umwelt
28.03.2023 22:00;201;89;112;Bedeckt;0;0;0;Stadt Konstanz, Amt fuer Stadtplanung und Umwelt
28.03.2023 23:00;109;39;70;Bedeckt;1;1;0;Stadt Konstanz, Amt fuer Stadtplanung und Umwelt
29.03.2023 00:00;46;23;23;Bedeckt;2;2;0;Stadt Konstanz, Amt fuer Stadtplanung und Umwelt
29.03.2023 01:00;30;15;15;Bedeckt;2;2;0;Stadt Konstanz, Amt fuer Stadtplanung und Umwelt
29.03.2023 02:00;12;8;4;Bedeckt;2;1;0;Stadt Konstanz, Amt fuer Stadtplanung und Umwelt
29.03.2023 03:00;9;5;4;Leicht bewoelkt;2;2;0;Stadt Konstanz, Amt fuer Stadtplanung und Umwelt
29.03.2023 04:00;7;3;4;Bedeckt;3;2;0;Stadt Konstanz, Amt fuer Stadtplanung und Umwelt
29.03.2023 05:00;44;27;17;Leicht bewoelkt;3;2;0;Stadt Konstanz, Amt fuer Stadtplanung und Umwelt
29.03.2023 06:00;160;89;71;Bedeckt;2;2;0;Stadt Konstanz, Amt fuer Stadtplanung und Umwelt
29.03.2023 07:00;954;617;337;Leicht bewoelkt;3;3;0;Stadt Konstanz, Amt fuer Stadtplanung und Umwelt
29.03.2023 08:00;710;394;316;Bedeckt;5;5;0;Stadt Konstanz, Amt fuer Stadtplanung und Umwelt
29.03.2023 09:00;580;357;223;Bewoelkt;7;6;0;Stadt Konstanz, Amt fuer Stadtplanung und Umwelt
29.03.2023 10:00;377;208;169;Leicht bewoelkt;9;8;0;Stadt Konstanz, Amt fuer Stadtplanung und Umwelt
29.03.2023 11:00;503;227;276;Leicht bewoelkt;11;10;0;Stadt Konstanz, Amt fuer Stadtplanung und Umwelt
29.03.2023 12:00;671;253;418;Leicht bewoelkt;13;12;0;Stadt Konstanz, Amt fuer Stadtplanung und Umwelt
29.03.2023 13:00;888;457;431;Leicht bewoelkt;15;14;0;Stadt Konstanz, Amt fuer Stadtplanung und Umwelt
29.03.2023 14:00;590;322;268;Leicht bewoelkt;16;16;0;Stadt Konstanz, Amt fuer Stadtplanung und Umwelt
29.03.2023 15:00;786;374;412;Sonnig;17;17;0;Stadt Konstanz, Amt fuer Stadtplanung und Umwelt
29.03.2023 16:00;818;363;455;Sonnig;16;16;0;Stadt Konstanz, Amt fuer Stadtplanung und Umwelt
29.03.2023 17:00;934;399;535;Sonnig;15;15;0;Stadt Konstanz, Amt fuer Stadtplanung und Umwelt
29.03.2023 18:00;763;329;434;Bedeckt;11;12;0;Stadt Konstanz, Amt fuer Stadtplanung und Umwelt
29.03.2023 19:00;537;230;307;Bedeckt;10;10;0;Stadt Konstanz, Amt fuer Stadtplanung und Umwelt
29.03.2023 20:00;376;173;203;Bedeckt;9;9;0;Stadt Konstanz, Amt fuer Stadtplanung und Umwelt
29.03.2023 21:00;289;102;187;Leicht bewoelkt;9;9;0;Stadt Konstanz, Amt fuer Stadtplanung und Umwelt
29.03.2023 22:00;224;92;132;Leicht bewoelkt;8;7;0;Stadt Konstanz, Amt fuer Stadtplanung und Umwelt
29.03.2023 23:00;119;44;75;Leicht bewoelkt;7;7;0;Stadt Konstanz, Amt fuer Stadtplanung und Umwelt
30.03.2023 00:00;67;20;47;Bedeckt;8;8;0;Stadt Konstanz, Amt fuer Stadtplanung und Umwelt
30.03.2023 01:00;43;8;35;Stellenweiser Regenfall;7;7;0.1;Stadt Konstanz, Amt fuer Stadtplanung und Umwelt
30.03.2023 02:00;13;6;7;Bedeckt;7;6;0;Stadt Konstanz, Amt fuer Stadtplanung und Umwelt
30.03.2023 03:00;6;4;2;Bedeckt;7;7;0;Stadt Konstanz, Amt fuer Stadtplanung und Umwelt
30.03.2023 04:00;8;6;2;Bedeckt;6;6;0;Stadt Konstanz, Amt fuer Stadtplanung und Umwelt
30.03.2023 05:00;40;28;12;Stellenweise Gewitter und Niederschlaege;7;7;0;Stadt Konstanz, Amt fuer Stadtplanung und Umwelt
30.03.2023 06:00;141;67;74;Leicht bewoelkt;6;6;0;Stadt Konstanz, Amt fuer Stadtplanung und Umwelt
30.03.2023 07:00;859;546;313;Leicht bewoelkt;7;7;0;Stadt Konstanz, Amt fuer Stadtplanung und Umwelt
30.03.2023 08:00;704;390;314;Bedeckt;9;9;0;Stadt Konstanz, Amt fuer Stadtplanung und Umwelt
30.03.2023 09:00;608;369;239;Bedeckt;11;11;0;Stadt Konstanz, Amt fuer Stadtplanung und Umwelt
30.03.2023 10:00;384;214;170;Bewoelkt;14;14;0;Stadt Konstanz, Amt fuer Stadtplanung und Umwelt
30.03.2023 11:00;515;279;236;Bedeckt;14;14;0;Stadt Konstanz, Amt fuer Stadtplanung und Umwelt
30.03.2023 12:00;489;216;273;Stellenweiser Regenfall;14;13;0.1;Stadt Konstanz, Amt fuer Stadtplanung und Umwelt
30.03.2023 13:00;748;301;447;Bedeckt;12;10;0;Stadt Konstanz, Amt fuer Stadtplanung und Umwelt
30.03.2023 14:00;437;217;220;Leichter Regenfall;12;10;1.6;Stadt Konstanz, Amt fuer Stadtplanung und Umwelt
30.03.2023 15:00;718;339;379;Nieselregen;12;10;0.3;Stadt Konstanz, Amt fuer Stadtplanung und Umwelt
30.03.2023 16:00;692;329;363;Maeßiger Regenfall;11;9;3;Stadt Konstanz, Amt fuer Stadtplanung und Umwelt
30.03.2023 17:00;877;377;500;Stellenweiser Nieselregen;11;9;0.5;Stadt Konstanz, Amt fuer Stadtplanung und Umwelt
30.03.2023 18:00;719;283;436;Leichter Regenfall;11;9;0.8;Stadt Konstanz, Amt fuer Stadtplanung und Umwelt
30.03.2023 19:00;585;299;286;Leichter Regenfall;10;8;2.2;Stadt Konstanz, Amt fuer Stadtplanung und Umwelt
30.03.2023 20:00;378;169;209;Nieselregen;10;7;0.4;Stadt Konstanz, Amt fuer Stadtplanung und Umwelt
30.03.2023 21:00;259;109;150;Stellenweiser Regenfall;9;7;0.1;Stadt Konstanz, Amt fuer Stadtplanung und Umwelt
30.03.2023 22:00;235;89;146;Nieselregen;9;7;0.7;Stadt Konstanz, Amt fuer Stadtplanung und Umwelt
30.03.2023 23:00;159;53;106;Leicht bewoelkt;9;7;0;Stadt Konstanz, Amt fuer Stadtplanung und Umwelt
31.03.2023 00:00;71;22;49;Nebel;6;6;0;Stadt Konstanz, Amt fuer Stadtplanung und Umwelt
31.03.2023 01:00;49;15;34;Nebel;6;6;0;Stadt Konstanz, Amt fuer Stadtplanung und Umwelt
31.03.2023 02:00;35;26;9;Nebel;6;6;0;Stadt Konstanz, Amt fuer Stadtplanung und Umwelt
31.03.2023 03:00;23;22;1;Nebel;6;6;0;Stadt Konstanz, Amt fuer Stadtplanung und Umwelt
31.03.2023 04:00;17;15;2;Nieselregen;6;6;0.3;Stadt Konstanz, Amt fuer Stadtplanung und Umwelt
31.03.2023 05:00;47;30;17;Nebel;6;6;0.1;Stadt Konstanz, Amt fuer Stadtplanung und Umwelt
31.03.2023 06:00;128;72;56;Nebel;6;6;0.1;Stadt Konstanz, Amt fuer Stadtplanung und Umwelt
31.03.2023 07:00;760;464;296;Leichter Regenfall;7;7;1.3;Stadt Konstanz, Amt fuer Stadtplanung und Umwelt
31.03.2023 08:00;545;306;239;Leichter Regenfall;8;7;1.1;Stadt Konstanz, Amt fuer Stadtplanung und Umwelt
31.03.2023 09:00;453;273;180;Leichter Regenfall;8;5;1.9;Stadt Konstanz, Amt fuer Stadtplanung und Umwelt
31.03.2023 10:00;386;216;170;Maeßiger Regenfall;9;5;4.4;Stadt Konstanz, Amt fuer Stadtplanung und Umwelt
31.03.2023 11:00;398;186;212;Stellenweiser leichter Regenfall;10;7;0.8;Stadt Konstanz, Amt fuer Stadtplanung und Umwelt
31.03.2023 12:00;532;238;294;Leichter Regenschauer;12;10;0.9;Stadt Konstanz, Amt fuer Stadtplanung und Umwelt
31.03.2023 13:00;680;244;436;Maeßiger Regenfall;13;11;2.9;Stadt Konstanz, Amt fuer Stadtplanung und Umwelt
31.03.2023 14:00;495;241;254;Leichter Regenschauer;13;10;0.2;Stadt Konstanz, Amt fuer Stadtplanung und Umwelt
31.03.2023 15:00;430;179;251;Leicht bewoelkt;13;11;0;Stadt Konstanz, Amt fuer Stadtplanung und Umwelt
31.03.2023 16:00;474;218;256;Leichter Regenschauer;13;10;0.7;Stadt Konstanz, Amt fuer Stadtplanung und Umwelt
31.03.2023 17:00;467;203;264;Stellenweise Gewitter und Niederschlaege;11;8;0.1;Stadt Konstanz, Amt fuer Stadtplanung und Umwelt
31.03.2023 18:00;432;204;228;Leichter Regenschauer;10;6;0.3;Stadt Konstanz, Amt fuer Stadtplanung und Umwelt
31.03.2023 19:00;397;234;163;Leichter Regenschauer;8;5;0.8;Stadt Konstanz, Amt fuer Stadtplanung und Umwelt
31.03.2023 20:00;252;110;142;Nieselregen;8;4;0.2;Stadt Konstanz, Amt fuer Stadtplanung und Umwelt
31.03.2023 21:00;203;103;100;Nieselregen;8;4;0.2;Stadt Konstanz, Amt fuer Stadtplanung und Umwelt
31.03.2023 22:00;187;81;106;Leichter Regenfall;8;4;1;Stadt Konstanz, Amt fuer Stadtplanung und Umwelt
31.03.2023 23:00;129;55;74;Leichter Regenschauer;7;4;0.2;Stadt Konstanz, Amt fuer Stadtplanung und Umwelt
01.04.2023 00:00;135;51;84;Leichter Regenschauer;7;4;0.2;Stadt Konstanz, Amt fuer Stadtplanung und Umwelt
01.04.2023 01:00;69;22;47;Bedeckt;6;3;0;Stadt Konstanz, Amt fuer Stadtplanung und Umwelt
01.04.2023 02:00;49;18;31;Nieselregen;6;3;0.2;Stadt Konstanz, Amt fuer Stadtplanung und Umwelt
01.04.2023 03:00;31;12;19;Nieselregen;6;2;0.3;Stadt Konstanz, Amt fuer Stadtplanung und Umwelt
01.04.2023 04:00;25;15;10;Leichter Regenfall;6;2;2.2;Stadt Konstanz, Amt fuer Stadtplanung und Umwelt
01.04.2023 05:00;30;17;13;Nieselregen;5;2;0.2;Stadt Konstanz, Amt fuer Stadtplanung und Umwelt
01.04.2023 06:00;40;22;18;Nieselregen;5;1;0.6;Stadt Konstanz, Amt fuer Stadtplanung und Umwelt
01.04.2023 07:00;66;37;29;Leichter Regenfall;5;1;1.3;Stadt Konstanz, Amt fuer Stadtplanung und Umwelt
01.04.2023 08:00;151;91;60;Nieselregen;5;1;0.2;Stadt Konstanz, Amt fuer Stadtplanung und Umwelt
01.04.2023 09:00;241;139;102;Nieselregen;5;1;0.3;Stadt Konstanz, Amt fuer Stadtplanung und Umwelt
01.04.2023 10:00;327;174;153;Leichter Regenfall;5;1;1.3;Stadt Konstanz, Amt fuer Stadtplanung und Umwelt
01.04.2023 11:00;307;166;141;Nieselregen;5;1;0.4;Stadt Konstanz, Amt fuer Stadtplanung und Umwelt
01.04.2023 12:00;335;181;154;Nieselregen;6;2;0.5;Stadt Konstanz, Amt fuer Stadtplanung und Umwelt
01.04.2023 13:00;348;167;181;Leichter Regenfall;6;2;1.9;Stadt Konstanz, Amt fuer Stadtplanung und Umwelt
01.04.2023 14:00;337;170;167;Bedeckt;6;2;0;Stadt Konstanz, Amt fuer Stadtplanung und Umwelt
01.04.2023 15:00;340;134;206;Bedeckt;7;3;0;Stadt Konstanz, Amt fuer Stadtplanung und Umwelt
01.04.2023 16:00;331;165;166;Stellenweiser Regenfall;7;3;0.1;Stadt Konstanz, Amt fuer Stadtplanung und Umwelt
01.04.2023 17:00;343;149;194;Bedeckt;7;4;0;Stadt Konstanz, Amt fuer Stadtplanung und Umwelt
01.04.2023 18:00;405;204;201;Bedeckt;7;3;0;Stadt Konstanz, Amt fuer Stadtplanung und Umwelt
01.04.2023 19:00;281;149;132;Bedeckt;7;3;0;Stadt Konstanz, Amt fuer Stadtplanung und Umwelt
01.04.2023 20:00;279;135;144;Bedeckt;6;2;0;Stadt Konstanz, Amt fuer Stadtplanung und Umwelt
01.04.2023 21:00;235;91;144;Bedeckt;6;3;0;Stadt Konstanz, Amt fuer Stadtplanung und Umwelt
01.04.2023 22:00;186;74;112;Stellenweiser Regenfall;6;3;0.1;Stadt Konstanz, Amt fuer Stadtplanung und Umwelt
01.04.2023 23:00;118;44;74;Bedeckt;6;2;0;Stadt Konstanz, Amt fuer Stadtplanung und Umwelt
02.04.2023 00:00;138;48;90;Nieselregen;5;1;0.2;Stadt Konstanz, Amt fuer Stadtplanung und Umwelt
02.04.2023 01:00;128;52;76;Bedeckt;5;1;0;Stadt Konstanz, Amt fuer Stadtplanung und Umwelt
02.04.2023 02:00;60;31;29;Nieselregen;5;1;0.2;Stadt Konstanz, Amt fuer Stadtplanung und Umwelt
02.04.2023 03:00;59;23;36;Bedeckt;5;1;0;Stadt Konstanz, Amt fuer Stadtplanung und Umwelt
02.04.2023 04:00;35;22;13;Leichter Regenfall;5;1;0.8;Stadt Konstanz, Amt fuer Stadtplanung und Umwelt
02.04.2023 05:00;32;14;18;Bedeckt;5;1;0;Stadt Konstanz, Amt fuer Stadtplanung und Umwelt
02.04.2023 06:00;20;12;8;Nieselregen;5;1;0.4;Stadt Konstanz, Amt fuer Stadtplanung und Umwelt
02.04.2023 07:00;26;13;13;Bedeckt;5;1;0;Stadt Konstanz, Amt fuer Stadtplanung und Umwelt
02.04.2023 08:00;51;28;23;Leichter Regenfall;5;2;0.9;Stadt Konstanz, Amt fuer Stadtplanung und Umwelt
02.04.2023 09:00;167;68;99;Nieselregen;4;3;0.4;Stadt Konstanz, Amt fuer Stadtplanung und Umwelt
02.04.2023 10:00;184;88;96;Starker Schneefall;3;0;2.4;Stadt Konstanz, Amt fuer Stadtplanung und Umwelt
02.04.2023 11:00;276;137;139;Starker Schneefall;3;1;0.4;Stadt Konstanz, Amt fuer Stadtplanung und Umwelt
02.04.2023 12:00;250;127;123;Starker Schneefall;2;0;0.9;Stadt Konstanz, Amt fuer Stadtplanung und Umwelt
02.04.2023 13:00;276;139;137;Starker Schneefall;2;0;3.6;Stadt Konstanz, Amt fuer Stadtplanung und Umwelt
02.04.2023 14:00;360;176;184;Starker Schneefall;3;1;0.7;Stadt Konstanz, Amt fuer Stadtplanung und Umwelt
02.04.2023 15:00;348;170;178;Starker Schneefall;3;1;0.6;Stadt Konstanz, Amt fuer Stadtplanung und Umwelt
02.04.2023 16:00;409;215;194;Starker Schneefall;3;1;1.7;Stadt Konstanz, Amt fuer Stadtplanung und Umwelt
02.04.2023 17:00;422;197;225;Maeßige bis starke Schneefaelle;3;1;0.5;Stadt Konstanz, Amt fuer Stadtplanung und Umwelt
02.04.2023 18:00;374;172;202;Maeßige bis starke Schneefaelle;3;0;0.4;Stadt Konstanz, Amt fuer Stadtplanung und Umwelt
02.04.2023 19:00;257;128;129;Starker Schneefall;2;0;2;Stadt Konstanz, Amt fuer Stadtplanung und Umwelt
02.04.2023 20:00;172;82;90;Bewoelkt;1;-1;0;Stadt Konstanz, Amt fuer Stadtplanung und Umwelt
02.04.2023 21:00;129;62;67;Leicht bewoelkt;0;-2;0;Stadt Konstanz, Amt fuer Stadtplanung und Umwelt
02.04.2023 22:00;124;54;70;Bedeckt;0;-2;0;Stadt Konstanz, Amt fuer Stadtplanung und Umwelt
02.04.2023 23:00;58;28;30;Leicht bewoelkt;0;-3;0;Stadt Konstanz, Amt fuer Stadtplanung und Umwelt
03.04.2023 00:00;21;10;11;Leichter Nebel;4;1;0;Stadt Konstanz, Amt fuer Stadtplanung und Umwelt
03.04.2023 01:00;7;5;2;Leichter Nebel;4;0;0;Stadt Konstanz, Amt fuer Stadtplanung und Umwelt
03.04.2023 02:00;3;0;3;Stellenweiser Regenfall;3;-1;0.1;Stadt Konstanz, Amt fuer Stadtplanung und Umwelt
03.04.2023 03:00;2;1;1;Leichter Schneefall;3;-1;0;Stadt Konstanz, Amt fuer Stadtplanung und Umwelt
03.04.2023 04:00;8;3;5;Starker Schneefall;2;-2;0.4;Stadt Konstanz, Amt fuer Stadtplanung und Umwelt
03.04.2023 05:00;51;28;23;Maeßige bis starke Schneefaelle;1;-3;0.1;Stadt Konstanz, Amt fuer Stadtplanung und Umwelt
03.04.2023 06:00;142;88;54;Maeßige bis starke Schneefaelle;1;-4;0.2;Stadt Konstanz, Amt fuer Stadtplanung und Umwelt
03.04.2023 07:00;934;617;317;Starker Schneefall;1;-4;0.7;Stadt Konstanz, Amt fuer Stadtplanung und Umwelt
03.04.2023 08:00;673;377;296;Leichter Schneefall;2;-3;0.1;Stadt Konstanz, Amt fuer Stadtplanung und Umwelt
03.04.2023 09:00;622;378;244;Leichter Schneefall;3;-2;0;Stadt Konstanz, Amt fuer Stadtplanung und Umwelt
03.04.2023 10:00;398;217;181;Maeßiger Schneefall;3;-1;0.1;Stadt Konstanz, Amt fuer Stadtplanung und Umwelt
03.04.2023 11:00;540;272;268;Leichter Schneefall;4;-1;0;Stadt Konstanz, Amt fuer Stadtplanung und Umwelt
03.04.2023 12:00;595;275;320;Leichter Schneefall;4;0;0;Stadt Konstanz, Amt fuer Stadtplanung und Umwelt
03.04.2023 13:00;828;359;469;Maeßige bis starke Schneefaelle;4;0;0.1;Stadt Konstanz, Amt fuer Stadtplanung und Umwelt
03.04.2023 14:00;551;282;269;Bedeckt;5;1;0;Stadt Konstanz, Amt fuer Stadtplanung und Umwelt
03.04.2023 15:00;835;366;469;Bedeckt;5;0;0;Stadt Konstanz, Amt fuer Stadtplanung und Umwelt
03.04.2023 16:00;730;323;407;Leicht bewoelkt;4;0;0;Stadt Konstanz, Amt fuer Stadtplanung und Umwelt
03.04.2023 17:00;920;355;565;Sonnig;5;2;0;Stadt Konstanz, Amt fuer Stadtplanung und Umwelt
03.04.2023 18:00;688;325;363;Sonnig;7;3;0;Stadt Konstanz, Amt fuer Stadtplanung und Umwelt
03.04.2023 19:00;436;211;225;Sonnig;4;0;0;Stadt Konstanz, Amt fuer Stadtplanung und Umwelt
03.04.2023 20:00;340;134;206;Sonnig;1;-4;0;Stadt Konstanz, Amt fuer Stadtplanung und Umwelt
03.04.2023 21:00;206;95;111;Sonnig;0;-4;0;Stadt Konstanz, Amt fuer Stadtplanung und Umwelt
03.04.2023 22:00;169;69;100;Sonnig;0;-5;0;Stadt Konstanz, Amt fuer Stadtplanung und Umwelt
03.04.2023 23:00;79;35;44;Sonnig;-1;-5;0;Stadt Konstanz, Amt fuer Stadtplanung und Umwelt
04.04.2023 00:00;50;19;31;Sonnig;0;-6;0;Stadt Konstanz, Amt fuer Stadtplanung und Umwelt
04.04.2023 01:00;28;14;14;Sonnig;-1;-6;0;Stadt Konstanz, Amt fuer Stadtplanung und Umwelt
04.04.2023 02:00;7;3;4;Sonnig;-1;-7;0;Stadt Konstanz, Amt fuer Stadtplanung und Umwelt
04.04.2023 03:00;9;2;7;Sonnig;-2;-7;0;Stadt Konstanz, Amt fuer Stadtplanung und Umwelt
04.04.2023 04:00;12;10;2;Sonnig;-2;-8;0;Stadt Konstanz, Amt fuer Stadtplanung und Umwelt
04.04.2023 05:00;48;31;17;Sonnig;-2;-8;0;Stadt Konstanz, Amt fuer Stadtplanung und Umwelt
04.04.2023 06:00;158;85;73;Sonnig;-2;-8;0;Stadt Konstanz, Amt fuer Stadtplanung und Umwelt
04.04.2023 07:00;732;410;322;Sonnig;-1;-7;0;Stadt Konstanz, Amt fuer Stadtplanung und Umwelt
04.04.2023 08:00;748;414;334;Sonnig;0;-5;0;Stadt Konstanz, Amt fuer Stadtplanung und Umwelt
04.04.2023 09:00;892;640;252;Sonnig;3;-3;0;Stadt Konstanz, Amt fuer Stadtplanung und Umwelt
04.04.2023 10:00;422;242;180;Sonnig;4;0;0;Stadt Konstanz, Amt fuer Stadtplanung und Umwelt
04.04.2023 11:00;543;255;288;Sonnig;8;5;0;Stadt Konstanz, Amt fuer Stadtplanung und Umwelt
04.04.2023 12:00;659;275;384;Sonnig;10;7;0;Stadt Konstanz, Amt fuer Stadtplanung und Umwelt
04.04.2023 13:00;869;349;520;Sonnig;11;8;0;Stadt Konstanz, Amt fuer Stadtplanung und Umwelt
04.04.2023 14:00;680;315;365;Sonnig;10;7;0;Stadt Konstanz, Amt fuer Stadtplanung und Umwelt
04.04.2023 15:00;789;367;422;Sonnig;10;6;0;Stadt Konstanz, Amt fuer Stadtplanung und Umwelt
04.04.2023 16:00;744;340;404;Sonnig;10;7;0;Stadt Konstanz, Amt fuer Stadtplanung und Umwelt
04.04.2023 17:00;909;367;542;Sonnig;9;6;0;Stadt Konstanz, Amt fuer Stadtplanung und Umwelt
04.04.2023 18:00;781;331;450;Sonnig;7;4;0;Stadt Konstanz, Amt fuer Stadtplanung und Umwelt
04.04.2023 19:00;589;247;342;Sonnig;5;1;0;Stadt Konstanz, Amt fuer Stadtplanung und Umwelt
04.04.2023 20:00;364;140;224;Sonnig;1;-3;0;Stadt Konstanz, Amt fuer Stadtplanung und Umwelt
04.04.2023 21:00;258;104;154;Sonnig;0;-4;0;Stadt Konstanz, Amt fuer Stadtplanung und Umwelt
04.04.2023 22:00;212;91;121;Sonnig;-1;-5;0;Stadt Konstanz, Amt fuer Stadtplanung und Umwelt
04.04.2023 23:00;161;63;98;Sonnig;-2;-6;0;Stadt Konstanz, Amt fuer Stadtplanung und Umwelt
05.04.2023 00:00;42;13;29;Sonnig;-3;-6;0;Stadt Konstanz, Amt fuer Stadtplanung und Umwelt
05.04.2023 01:00;49;33;16;Sonnig;-3;-6;0;Stadt Konstanz, Amt fuer Stadtplanung und Umwelt
05.04.2023 02:00;12;9;3;Sonnig;-3;-6;0;Stadt Konstanz, Amt fuer Stadtplanung und Umwelt
05.04.2023 03:00;16;6;10;Sonnig;-4;-6;0;Stadt Konstanz, Amt fuer Stadtplanung und Umwelt
05.04.2023 04:00;10;5;5;Sonnig;-4;-6;0;Stadt Konstanz, Amt fuer Stadtplanung und Umwelt
05.04.2023 05:00;59;39;20;Sonnig;-4;-6;0;Stadt Konstanz, Amt fuer Stadtplanung und Umwelt
05.04.2023 06:00;132;75;57;Sonnig;-4;-6;0;Stadt Konstanz, Amt fuer Stadtplanung und Umwelt
05.04.2023 07:00;470;319;151;Sonnig;-1;-3;0;Stadt Konstanz, Amt fuer Stadtplanung und Umwelt
05.04.2023 08:00;659;363;296;Sonnig;1;-1;0;Stadt Konstanz, Amt fuer Stadtplanung und Umwelt
05.04.2023 09:00;529;337;192;Sonnig;3;1;0;Stadt Konstanz, Amt fuer Stadtplanung und Umwelt
05.04.2023 10:00;399;207;192;Sonnig;5;3;0;Stadt Konstanz, Amt fuer Stadtplanung und Umwelt
05.04.2023 11:00;527;255;272;Sonnig;7;5;0;Stadt Konstanz, Amt fuer Stadtplanung und Umwelt
05.04.2023 12:00;577;282;295;Sonnig;9;7;0;Stadt Konstanz, Amt fuer Stadtplanung und Umwelt
05.04.2023 13:00;601;309;292;Sonnig;10;8;0;Stadt Konstanz, Amt fuer Stadtplanung und Umwelt
05.04.2023 14:00;586;267;319;Sonnig;10;9;0;Stadt Konstanz, Amt fuer Stadtplanung und Umwelt
05.04.2023 15:00;706;355;351;Sonnig;10;9;0;Stadt Konstanz, Amt fuer Stadtplanung und Umwelt
05.04.2023 16:00;745;339;406;Sonnig;10;9;0;Stadt Konstanz, Amt fuer Stadtplanung und Umwelt
05.04.2023 17:00;895;362;533;Sonnig;8;7;0;Stadt Konstanz, Amt fuer Stadtplanung und Umwelt
05.04.2023 18:00;715;299;416;Sonnig;7;5;0;Stadt Konstanz, Amt fuer Stadtplanung und Umwelt
05.04.2023 19:00;588;248;340;Leicht bewoelkt;2;0;0;Stadt Konstanz, Amt fuer Stadtplanung und Umwelt
05.04.2023 20:00;357;152;205;Leicht bewoelkt;1;-2;0;Stadt Konstanz, Amt fuer Stadtplanung und Umwelt
05.04.2023 21:00;258;122;136;Sonnig;-1;-3;0;Stadt Konstanz, Amt fuer Stadtplanung und Umwelt
05.04.2023 22:00;220;91;129;Sonnig;-2;-4;0;Stadt Konstanz, Amt fuer Stadtplanung und Umwelt
05.04.2023 23:00;113;38;75;Sonnig;-2;-4;0;Stadt Konstanz, Amt fuer Stadtplanung und Umwelt
06.04.2023 00:00;75;14;61;Leicht bewoelkt;-2;-3;0;Stadt Konstanz, Amt fuer Stadtplanung und Umwelt
06.04.2023 01:00;56;16;40;Leicht bewoelkt;-2;-2;0;Stadt Konstanz, Amt fuer Stadtplanung und Umwelt
06.04.2023 02:00;11;6;5;Leicht bewoelkt;-3;-3;0;Stadt Konstanz, Amt fuer Stadtplanung und Umwelt
06.04.2023 03:00;8;1;7;Sonnig;-3;-3;0;Stadt Konstanz, Amt fuer Stadtplanung und Umwelt
06.04.2023 04:00;9;6;3;Sonnig;-3;-3;0;Stadt Konstanz, Amt fuer Stadtplanung und Umwelt
06.04.2023 05:00;50;34;16;Sonnig;-4;-4;0;Stadt Konstanz, Amt fuer Stadtplanung und Umwelt
06.04.2023 06:00;156;90;66;Sonnig;-4;-4;0;Stadt Konstanz, Amt fuer Stadtplanung und Umwelt
06.04.2023 07:00;392;244;148;Sonnig;-1;-1;0;Stadt Konstanz, Amt fuer Stadtplanung und Umwelt
06.04.2023 08:00;501;292;209;Sonnig;2;2;0;Stadt Konstanz, Amt fuer Stadtplanung und Umwelt
06.04.2023 09:00;525;344;181;Sonnig;5;5;0;Stadt Konstanz, Amt fuer Stadtplanung und Umwelt
06.04.2023 10:00;429;251;178;Sonnig;8;8;0;Stadt Konstanz, Amt fuer Stadtplanung und Umwelt
06.04.2023 11:00;572;272;300;Sonnig;11;11;0;Stadt Konstanz, Amt fuer Stadtplanung und Umwelt
06.04.2023 12:00;544;276;268;Sonnig;12;12;0;Stadt Konstanz, Amt fuer Stadtplanung und Umwelt
06.04.2023 13:00;657;313;344;Sonnig;12;12;0;Stadt Konstanz, Amt fuer Stadtplanung und Umwelt
06.04.2023 14:00;612;293;319;Sonnig;12;12;0;Stadt Konstanz, Amt fuer Stadtplanung und Umwelt
06.04.2023 15:00;657;311;346;Sonnig;12;12;0;Stadt Konstanz, Amt fuer Stadtplanung und Umwelt
06.04.2023 16:00;730;334;396;Sonnig;12;11;0;Stadt Konstanz, Amt fuer Stadtplanung und Umwelt
06.04.2023 17:00;787;325;462;Sonnig;11;11;0;Stadt Konstanz, Amt fuer Stadtplanung und Umwelt
06.04.2023 18:00;639;267;372;Sonnig;8;8;0;Stadt Konstanz, Amt fuer Stadtplanung und Umwelt
06.04.2023 19:00;469;197;272;Sonnig;5;5;0;Stadt Konstanz, Amt fuer Stadtplanung und Umwelt
06.04.2023 20:00;350;155;195;Sonnig;3;2;0;Stadt Konstanz, Amt fuer Stadtplanung und Umwelt
06.04.2023 21:00;231;131;100;Leicht bewoelkt;2;1;0;Stadt Konstanz, Amt fuer Stadtplanung und Umwelt
06.04.2023 22:00;184;71;113;Bedeckt;2;2;0;Stadt Konstanz, Amt fuer Stadtplanung und Umwelt
06.04.2023 23:00;130;59;71;Bedeckt;2;2;0;Stadt Konstanz, Amt fuer Stadtplanung und Umwelt
07.04.2023 00:00;108;29;79;Bewoelkt;1;1;0;Stadt Konstanz, Amt fuer Stadtplanung und Umwelt
07.04.2023 01:00;63;19;44;Leicht bewoelkt;1;0;0;Stadt Konstanz, Amt fuer Stadtplanung und Umwelt
07.04.2023 02:00;39;6;33;Bedeckt;0;0;0;Stadt Konstanz, Amt fuer Stadtplanung und Umwelt
07.04.2023 03:00;20;6;14;Bedeckt;1;1;0;Stadt Konstanz, Amt fuer Stadtplanung und Umwelt
07.04.2023 04:00;14;7;7;Stellenweiser Regenfall;2;2;0.1;Stadt Konstanz, Amt fuer Stadtplanung und Umwelt
07.04.2023 05:00;15;7;8;Leicht bewoelkt;1;1;0;Stadt Konstanz, Amt fuer Stadtplanung und Umwelt
07.04.2023 06:00;32;11;21;Bedeckt;1;1;0;Stadt Konstanz, Amt fuer Stadtplanung und Umwelt
07.04.2023 07:00;36;23;13;Starker Schneefall;1;1;2;Stadt Konstanz, Amt fuer Stadtplanung und Umwelt
07.04.2023 08:00;44;19;25;Starker Schneefall;1;0;3.7;Stadt Konstanz, Amt fuer Stadtplanung und Umwelt
07.04.2023 09:00;145;61;84;Starker Schneefall;1;-1;3.4;Stadt Konstanz, Amt fuer Stadtplanung und Umwelt
07.04.2023 10:00;163;85;78;Starker Schneefall;1;-1;8.3;Stadt Konstanz, Amt fuer Stadtplanung und Umwelt
07.04.2023 11:00;193;103;90;Leichter Eisregen;2;0;2.2;Stadt Konstanz, Amt fuer Stadtplanung und Umwelt
07.04.2023 12:00;234;107;127;Leichter Eisregen;3;1;1.8;Stadt Konstanz, Amt fuer Stadtplanung und Umwelt
07.04.2023 13:00;264;134;130;Starker Regenfall;4;3;8.5;Stadt Konstanz, Amt fuer Stadtplanung und Umwelt
07.04.2023 14:00;320;155;165;Leichter Nebel;5;5;0;Stadt Konstanz, Amt fuer Stadtplanung und Umwelt
07.04.2023 15:00;313;160;153;Leichter Nebel;6;6;0;Stadt Konstanz, Amt fuer Stadtplanung und Umwelt
07.04.2023 16:00;344;181;163;Leichter Regenschauer;6;6;0.2;Stadt Konstanz, Amt fuer Stadtplanung und Umwelt
07.04.2023 17:00;328;137;191;Leichter Nebel;6;5;0;Stadt Konstanz, Amt fuer Stadtplanung und Umwelt
07.04.2023 18:00;258;133;125;Nebel;5;4;0;Stadt Konstanz, Amt fuer Stadtplanung und Umwelt
07.04.2023 19:00;194;88;106;Leichter Nebel;3;2;0;Stadt Konstanz, Amt fuer Stadtplanung und Umwelt
07.04.2023 20:00;185;72;113;Leichter Nebel;2;0;0;Stadt Konstanz, Amt fuer Stadtplanung und Umwelt
07.04.2023 21:00;116;58;58;Leichter Nebel;2;2;0;Stadt Konstanz, Amt fuer Stadtplanung und Umwelt
07.04.2023 22:00;81;43;38;Leichter Nebel;1;1;0;Stadt Konstanz, Amt fuer Stadtplanung und Umwelt
07.04.2023 23:00;72;37;35;Leichter Nebel;1;1;0;Stadt Konstanz, Amt fuer Stadtplanung und Umwelt
08.04.2023 00:00;40;13;27;Nieselregen;3;3;0.4;Stadt Konstanz, Amt fuer Stadtplanung und Umwelt
08.04.2023 01:00;30;13;17;Maeßiger Regenfall;3;3;2.6;Stadt Konstanz, Amt fuer Stadtplanung und Umwelt
08.04.2023 02:00;24;6;18;Nieselregen;3;3;0.2;Stadt Konstanz, Amt fuer Stadtplanung und Umwelt
08.04.2023 03:00;22;5;17;Nebel;3;3;0.1;Stadt Konstanz, Amt fuer Stadtplanung und Umwelt
08.04.2023 04:00;4;4;0;Nieselregen;3;3;0.2;Stadt Konstanz, Amt fuer Stadtplanung und Umwelt
08.04.2023 05:00;19;13;6;Nebel;3;3;0;Stadt Konstanz, Amt fuer Stadtplanung und Umwelt
08.04.2023 06:00;31;21;10;Leichter Nebel;3;3;0;Stadt Konstanz, Amt fuer Stadtplanung und Umwelt
08.04.2023 07:00;83;37;46;Nieselregen;4;4;0.2;Stadt Konstanz, Amt fuer Stadtplanung und Umwelt
08.04.2023 08:00;150;79;71;Bedeckt;5;5;0;Stadt Konstanz, Amt fuer Stadtplanung und Umwelt
08.04.2023 09:00;277;171;106;Stellenweiser Regenfall;5;5;0.1;Stadt Konstanz, Amt fuer Stadtplanung und Umwelt
08.04.2023 10:00;330;168;162;Nieselregen;5;5;0.4;Stadt Konstanz, Amt fuer Stadtplanung und Umwelt
08.04.2023 11:00;455;263;192;Stellenweiser Regenfall;6;6;0.1;Stadt Konstanz, Amt fuer Stadtplanung und Umwelt
08.04.2023 12:00;393;204;189;Stellenweiser Regenfall;7;7;0.1;Stadt Konstanz, Amt fuer Stadtplanung und Umwelt
08.04.2023 13:00;385;177;208;Nieselregen;7;7;0.6;Stadt Konstanz, Amt fuer Stadtplanung und Umwelt
08.04.2023 14:00;400;210;190;Stellenweiser Regenfall;7;7;0.1;Stadt Konstanz, Amt fuer Stadtplanung und Umwelt
08.04.2023 15:00;338;166;172;Stellenweiser Regenfall;7;7;0.1;Stadt Konstanz, Amt fuer Stadtplanung und Umwelt
08.04.2023 16:00;262;116;146;Leichter Regenschauer;7;7;0.4;Stadt Konstanz, Amt fuer Stadtplanung und Umwelt
08.04.2023 17:00;293;108;185;Stellenweiser Regenfall;8;8;0.1;Stadt Konstanz, Amt fuer Stadtplanung und Umwelt
08.04.2023 18:00;261;95;166;Leichter Regenschauer;7;6;0.2;Stadt Konstanz, Amt fuer Stadtplanung und Umwelt
08.04.2023 19:00;180;77;103;Leichter Regenschauer;6;5;0.6;Stadt Konstanz, Amt fuer Stadtplanung und Umwelt
08.04.2023 20:00;159;80;79;Bewoelkt;4;4;0;Stadt Konstanz, Amt fuer Stadtplanung und Umwelt
08.04.2023 21:00;109;61;48;Leichter Nebel;4;3;0;Stadt Konstanz, Amt fuer Stadtplanung und Umwelt
08.04.2023 22:00;88;41;47;Bedeckt;4;4;0;Stadt Konstanz, Amt fuer Stadtplanung und Umwelt
08.04.2023 23:00;75;21;54;Bedeckt;5;4;0;Stadt Konstanz, Amt fuer Stadtplanung und Umwelt
09.04.2023 00:00;49;20;29;Bewoelkt;3;2;0;Stadt Konstanz, Amt fuer Stadtplanung und Umwelt
09.04.2023 01:00;44;12;32;Leichter Nebel;3;2;0;Stadt Konstanz, Amt fuer Stadtplanung und Umwelt
09.04.2023 02:00;35;18;17;Leichter Nebel;4;3;0;Stadt Konstanz, Amt fuer Stadtplanung und Umwelt
09.04.2023 03:00;27;13;14;Bedeckt;4;4;0;Stadt Konstanz, Amt fuer Stadtplanung und Umwelt
09.04.2023 04:00;15;8;7;Stellenweiser Regenfall;4;4;0.1;Stadt Konstanz, Amt fuer Stadtplanung und Umwelt
09.04.2023 05:00;16;6;10;Leichter Nebel;4;4;0;Stadt Konstanz, Amt fuer Stadtplanung und Umwelt
09.04.2023 06:00;33;20;13;Leichter Nebel;4;4;0;Stadt Konstanz, Amt fuer Stadtplanung und Umwelt
09.04.2023 07:00;32;17;15;Stellenweiser Regenfall;5;5;0.1;Stadt Konstanz, Amt fuer Stadtplanung und Umwelt
09.04.2023 08:00;43;19;24;Stellenweiser Regenfall;6;5;0.1;Stadt Konstanz, Amt fuer Stadtplanung und Umwelt
09.04.2023 09:00;179;102;77;Leicht bewoelkt;6;5;0;Stadt Konstanz, Amt fuer Stadtplanung und Umwelt
09.04.2023 10:00;222;111;111;Stellenweiser Regenfall;7;6;0.1;Stadt Konstanz, Amt fuer Stadtplanung und Umwelt
09.04.2023 11:00;243;119;124;Bedeckt;9;8;0;Stadt Konstanz, Amt fuer Stadtplanung und Umwelt
09.04.2023 12:00;268;116;152;Leicht bewoelkt;11;10;0;Stadt Konstanz, Amt fuer Stadtplanung und Umwelt
09.04.2023 13:00;319;173;146;Stellenweiser Regenfall;11;10;0.1;Stadt Konstanz, Amt fuer Stadtplanung und Umwelt
09.04.2023 14:00;272;164;108;Leicht bewoelkt;12;11;0;Stadt Konstanz, Amt fuer Stadtplanung und Umwelt
09.04.2023 15:00;331;141;190;Leicht bewoelkt;12;11;0;Stadt Konstanz, Amt fuer Stadtplanung und Umwelt
09.04.2023 16:00;362;170;192;Leicht bewoelkt;12;11;0;Stadt Konstanz, Amt fuer Stadtplanung und Umwelt
09.04.2023 17:00;365;184;181;Leicht bewoelkt;12;11;0;Stadt Konstanz, Amt fuer Stadtplanung und Umwelt
09.04.2023 18:00;238;125;113;Sonnig;12;11;0;Stadt Konstanz, Amt fuer Stadtplanung und Umwelt
09.04.2023 19:00;218;102;116;Sonnig;6;5;0;Stadt Konstanz, Amt fuer Stadtplanung und Umwelt
09.04.2023 20:00;205;99;106;Sonnig;3;1;0;Stadt Konstanz, Amt fuer Stadtplanung und Umwelt
09.04.2023 21:00;100;47;53;Sonnig;3;1;0;Stadt Konstanz, Amt fuer Stadtplanung und Umwelt
09.04.2023 22:00;110;49;61;Sonnig;2;0;0;Stadt Konstanz, Amt fuer Stadtplanung und Umwelt
09.04.2023 23:00;45;12;33;Sonnig;1;-1;0;Stadt Konstanz, Amt fuer Stadtplanung und Umwelt
10.04.2023 00:00;49;17;32;Sonnig;1;-1;0;Stadt Konstanz, Amt fuer Stadtplanung und Umwelt
10.04.2023 01:00;21;8;13;Sonnig;0;-2;0;Stadt Konstanz, Amt fuer Stadtplanung und Umwelt
10.04.2023 02:00;18;5;13;Sonnig;0;-2;0;Stadt Konstanz, Amt fuer Stadtplanung und Umwelt
10.04.2023 03:00;13;7;6;Sonnig;-1;-2;0;Stadt Konstanz, Amt fuer Stadtplanung und Umwelt
10.04.2023 04:00;9;8;1;Sonnig;-1;-3;0;Stadt Konstanz, Amt fuer Stadtplanung und Umwelt
10.04.2023 05:00;14;8;6;Sonnig;-2;-2;0;Stadt Konstanz, Amt fuer Stadtplanung und Umwelt
10.04.2023 06:00;27;12;15;Sonnig;-2;-3;0;Stadt Konstanz, Amt fuer Stadtplanung und Umwelt
10.04.2023 07:00;34;25;9;Leicht bewoelkt;2;2;0;Stadt Konstanz, Amt fuer Stadtplanung und Umwelt
10.04.2023 08:00;55;30;25;Leicht bewoelkt;5;5;0;Stadt Konstanz, Amt fuer Stadtplanung und Umwelt
10.04.2023 09:00;148;71;77;Bedeckt;8;8;0;Stadt Konstanz, Amt fuer Stadtplanung und Umwelt
10.04.2023 10:00;230;108;122;Bedeckt;10;10;0;Stadt Konstanz, Amt fuer Stadtplanung und Umwelt
10.04.2023 11:00;345;163;182;Leicht bewoelkt;12;13;0;Stadt Konstanz, Amt fuer Stadtplanung und Umwelt
10.04.2023 12:00;300;144;156;Sonnig;14;15;0;Stadt Konstanz, Amt fuer Stadtplanung und Umwelt
10.04.2023 13:00;384;177;207;Sonnig;15;15;0;Stadt Konstanz, Amt fuer Stadtplanung und Umwelt
10.04.2023 14:00;477;230;247;Sonnig;15;15;0;Stadt Konstanz, Amt fuer Stadtplanung und Umwelt
10.04.2023 15:00;481;228;253;Sonnig;15;15;0;Stadt Konstanz, Amt fuer Stadtplanung und Umwelt
10.04.2023 16:00;420;223;197;Leicht bewoelkt;15;14;0;Stadt Konstanz, Amt fuer Stadtplanung und Umwelt
10.04.2023 17:00;454;216;238;Bedeckt;14;14;0;Stadt Konstanz, Amt fuer Stadtplanung und Umwelt
10.04.2023 18:00;340;164;176;Bedeckt;11;11;0;Stadt Konstanz, Amt fuer Stadtplanung und Umwelt
10.04.2023 19:00;252;105;147;Bedeckt;9;9;0;Stadt Konstanz, Amt fuer Stadtplanung und Umwelt
10.04.2023 20:00;189;85;104;Bedeckt;8;8;0;Stadt Konstanz, Amt fuer Stadtplanung und Umwelt
10.04.2023 21:00;120;59;61;Bedeckt;8;8;0;Stadt Konstanz, Amt fuer Stadtplanung und Umwelt
10.04.2023 22:00;106;40;66;Leicht bewoelkt;7;7;0;Stadt Konstanz, Amt fuer Stadtplanung und Umwelt
10.04.2023 23:00;55;26;29;Leicht bewoelkt;6;5;0;Stadt Konstanz, Amt fuer Stadtplanung und Umwelt
11.04.2023 00:00;35;9;26;Bewoelkt;9;7;0;Stadt Konstanz, Amt fuer Stadtplanung und Umwelt
11.04.2023 01:00;17;13;4;Stellenweiser Regenfall;9;6;0.1;Stadt Konstanz, Amt fuer Stadtplanung und Umwelt
11.04.2023 02:00;9;6;3;Stellenweiser Regenfall;9;6;0.1;Stadt Konstanz, Amt fuer Stadtplanung und Umwelt
11.04.2023 03:00;8;3;5;Bedeckt;8;6;0;Stadt Konstanz, Amt fuer Stadtplanung und Umwelt
11.04.2023 04:00;5;4;1;Nieselregen;8;6;0.5;Stadt Konstanz, Amt fuer Stadtplanung und Umwelt
11.04.2023 05:00;41;26;15;Bedeckt;9;6;0;Stadt Konstanz, Amt fuer Stadtplanung und Umwelt
11.04.2023 06:00;120;77;43;Nieselregen;9;5;0.2;Stadt Konstanz, Amt fuer Stadtplanung und Umwelt
11.04.2023 07:00;350;231;119;Bedeckt;8;5;0;Stadt Konstanz, Amt fuer Stadtplanung und Umwelt
11.04.2023 08:00;454;247;207;Stellenweiser Regenfall;9;6;0.1;Stadt Konstanz, Amt fuer Stadtplanung und Umwelt
11.04.2023 09:00;316;195;121;Bedeckt;8;5;0;Stadt Konstanz, Amt fuer Stadtplanung und Umwelt
11.04.2023 10:00;200;109;91;Leichter Regenschauer;8;5;0.3;Stadt Konstanz, Amt fuer Stadtplanung und Umwelt
11.04.2023 11:00;365;225;140;Bewoelkt;9;7;0;Stadt Konstanz, Amt fuer Stadtplanung und Umwelt
11.04.2023 12:00;346;146;200;Stellenweiser Regenfall;10;7;0.1;Stadt Konstanz, Amt fuer Stadtplanung und Umwelt
11.04.2023 13:00;429;225;204;Bewoelkt;11;9;0;Stadt Konstanz, Amt fuer Stadtplanung und Umwelt
11.04.2023 14:00;401;198;203;Stellenweiser Regenfall;11;9;0.1;Stadt Konstanz, Amt fuer Stadtplanung und Umwelt
11.04.2023 15:00;485;221;264;Stellenweiser Regenfall;11;9;0.1;Stadt Konstanz, Amt fuer Stadtplanung und Umwelt
11.04.2023 16:00;556;284;272;Leichter Regenschauer;11;9;0.4;Stadt Konstanz, Amt fuer Stadtplanung und Umwelt
11.04.2023 17:00;678;279;399;Stellenweiser Regenfall;11;9;0.1;Stadt Konstanz, Amt fuer Stadtplanung und Umwelt
11.04.2023 18:00;637;266;371;Stellenweiser Regenfall;10;8;0.1;Stadt Konstanz, Amt fuer Stadtplanung und Umwelt
11.04.2023 19:00;500;209;291;Leichter Regenschauer;7;6;0.4;Stadt Konstanz, Amt fuer Stadtplanung und Umwelt
11.04.2023 20:00;432;185;247;Stellenweiser Regenfall;6;5;0.1;Stadt Konstanz, Amt fuer Stadtplanung und Umwelt
11.04.2023 21:00;216;104;112;Stellenweiser Regenfall;6;5;0.1;Stadt Konstanz, Amt fuer Stadtplanung und Umwelt
11.04.2023 22:00;166;71;95;Nieselregen;6;5;0.4;Stadt Konstanz, Amt fuer Stadtplanung und Umwelt
11.04.2023 23:00;199;95;104;Leichter Regenschauer;6;5;0.2;Stadt Konstanz, Amt fuer Stadtplanung und Umwelt
12.04.2023 00:00;59;23;36;Nieselregen;6;5;0.3;Stadt Konstanz, Amt fuer Stadtplanung und Umwelt
12.04.2023 01:00;39;22;17;Leichter Regenfall;6;6;1.8;Stadt Konstanz, Amt fuer Stadtplanung und Umwelt
12.04.2023 02:00;14;6;8;Nebel;6;6;0;Stadt Konstanz, Amt fuer Stadtplanung und Umwelt
12.04.2023 03:00;6;1;5;Nebel;6;6;0;Stadt Konstanz, Amt fuer Stadtplanung und Umwelt
12.04.2023 04:00;9;4;5;Nebel;6;6;0;Stadt Konstanz, Amt fuer Stadtplanung und Umwelt
12.04.2023 05:00;42;27;15;Nebel;6;6;0;Stadt Konstanz, Amt fuer Stadtplanung und Umwelt
12.04.2023 06:00;115;64;51;Nebel;6;6;0;Stadt Konstanz, Amt fuer Stadtplanung und Umwelt
12.04.2023 07:00;428;292;136;Leichter Nebel;6;6;0;Stadt Konstanz, Amt fuer Stadtplanung und Umwelt
12.04.2023 08:00;472;269;203;Leichter Nebel;7;7;0.1;Stadt Konstanz, Amt fuer Stadtplanung und Umwelt
12.04.2023 09:00;447;253;194;Bedeckt;8;8;0;Stadt Konstanz, Amt fuer Stadtplanung und Umwelt
12.04.2023 10:00;376;221;155;Stellenweiser Regenfall;10;9;0.1;Stadt Konstanz, Amt fuer Stadtplanung und Umwelt
12.04.2023 11:00;494;256;238;Leicht bewoelkt;12;11;0;Stadt Konstanz, Amt fuer Stadtplanung und Umwelt
12.04.2023 12:00;555;254;301;Leicht bewoelkt;15;14;0;Stadt Konstanz, Amt fuer Stadtplanung und Umwelt
12.04.2023 13:00;597;311;286;Leicht bewoelkt;18;18;0;Stadt Konstanz, Amt fuer Stadtplanung und Umwelt
12.04.2023 14:00;447;206;241;Leicht bewoelkt;19;19;0;Stadt Konstanz, Amt fuer Stadtplanung und Umwelt
12.04.2023 15:00;459;205;254;Bedeckt;16;16;0;Stadt Konstanz, Amt fuer Stadtplanung und Umwelt
12.04.2023 16:00;514;225;289;Leichter Regenschauer;14;12;0.2;Stadt Konstanz, Amt fuer Stadtplanung und Umwelt
12.04.2023 17:00;608;257;351;Bedeckt;12;9;0;Stadt Konstanz, Amt fuer Stadtplanung und Umwelt
12.04.2023 18:00;463;210;253;Stellenweiser Regenfall;10;7;0.1;Stadt Konstanz, Amt fuer Stadtplanung und Umwelt
12.04.2023 19:00;324;139;185;Bedeckt;8;6;0;Stadt Konstanz, Amt fuer Stadtplanung und Umwelt
12.04.2023 20:00;256;112;144;Nieselregen;7;4;0.4;Stadt Konstanz, Amt fuer Stadtplanung und Umwelt
12.04.2023 21:00;179;89;90;Nieselregen;7;3;0.4;Stadt Konstanz, Amt fuer Stadtplanung und Umwelt
12.04.2023 22:00;139;57;82;Leichter Regenfall;6;3;1.6;Stadt Konstanz, Amt fuer Stadtplanung und Umwelt
12.04.2023 23:00;91;34;57;Nieselregen;6;3;0.5;Stadt Konstanz, Amt fuer Stadtplanung und Umwelt
13.04.2023 00:00;49;18;31;Leichter Regenschauer;6;2;0.5;Stadt Konstanz, Amt fuer Stadtplanung und Umwelt
13.04.2023 01:00;40;15;25;Leichter Regenfall;5;2;1.9;Stadt Konstanz, Amt fuer Stadtplanung und Umwelt
13.04.2023 02:00;15;5;10;Stellenweiser Regenfall;5;2;0.1;Stadt Konstanz, Amt fuer Stadtplanung und Umwelt
13.04.2023 03:00;11;3;8;Bedeckt;5;1;0;Stadt Konstanz, Amt fuer Stadtplanung und Umwelt
13.04.2023 04:00;7;5;2;Stellenweiser Regenfall;4;1;0.1;Stadt Konstanz, Amt fuer Stadtplanung und Umwelt
13.04.2023 05:00;48;37;11;Bedeckt;3;0;0;Stadt Konstanz, Amt fuer Stadtplanung und Umwelt
13.04.2023 06:00;134;80;54;Bedeckt;3;0;0;Stadt Konstanz, Amt fuer Stadtplanung und Umwelt
13.04.2023 07:00;426;259;167;Bedeckt;3;0;0;Stadt Konstanz, Amt fuer Stadtplanung und Umwelt
13.04.2023 08:00;539;304;235;Bedeckt;4;1;0;Stadt Konstanz, Amt fuer Stadtplanung und Umwelt
13.04.2023 09:00;511;314;197;Bedeckt;4;1;0;Stadt Konstanz, Amt fuer Stadtplanung und Umwelt
13.04.2023 10:00;383;207;176;Bedeckt;5;1;0;Stadt Konstanz, Amt fuer Stadtplanung und Umwelt
13.04.2023 11:00;515;283;232;Bedeckt;6;3;0;Stadt Konstanz, Amt fuer Stadtplanung und Umwelt
13.04.2023 12:00;503;219;284;Bedeckt;8;5;0;Stadt Konstanz, Amt fuer Stadtplanung und Umwelt
13.04.2023 13:00;595;276;319;Bedeckt;9;7;0;Stadt Konstanz, Amt fuer Stadtplanung und Umwelt
13.04.2023 14:00;484;224;260;Bedeckt;9;7;0;Stadt Konstanz, Amt fuer Stadtplanung und Umwelt
13.04.2023 15:00;603;291;312;Bedeckt;9;8;0;Stadt Konstanz, Amt fuer Stadtplanung und Umwelt
13.04.2023 16:00;671;286;385;Stellenweiser Regenfall;9;8;0.1;Stadt Konstanz, Amt fuer Stadtplanung und Umwelt
13.04.2023 17:00;778;335;443;Bedeckt;8;8;0;Stadt Konstanz, Amt fuer Stadtplanung und Umwelt
13.04.2023 18:00;612;272;340;Stellenweiser Regenfall;7;6;0.1;Stadt Konstanz, Amt fuer Stadtplanung und Umwelt
13.04.2023 19:00;415;184;231;Leichter Regenschauer;5;4;0.2;Stadt Konstanz, Amt fuer Stadtplanung und Umwelt
13.04.2023 20:00;347;167;180;Leicht bewoelkt;4;2;0;Stadt Konstanz, Amt fuer Stadtplanung und Umwelt
13.04.2023 21:00;206;104;102;Bewoelkt;3;1;0;Stadt Konstanz, Amt fuer Stadtplanung und Umwelt
13.04.2023 22:00;186;89;97;Leicht bewoelkt;3;2;0;Stadt Konstanz, Amt fuer Stadtplanung und Umwelt
13.04.2023 23:00;136;63;73;Leicht bewoelkt;1;1;0;Stadt Konstanz, Amt fuer Stadtplanung und Umwelt
14.04.2023 00:00;76;33;43;Leichter Nebel;2;2;0;Stadt Konstanz, Amt fuer Stadtplanung und Umwelt
14.04.2023 01:00;51;13;38;Leichte Eisregen;1;1;0.2;Stadt Konstanz, Amt fuer Stadtplanung und Umwelt
14.04.2023 02:00;15;6;9;Leichter Nebel;2;2;0;Stadt Konstanz, Amt fuer Stadtplanung und Umwelt
14.04.2023 03:00;7;3;4;Leichter Nebel;2;1;0;Stadt Konstanz, Amt fuer Stadtplanung und Umwelt
14.04.2023 04:00;6;3;3;Leichter Nebel;2;2;0;Stadt Konstanz, Amt fuer Stadtplanung und Umwelt
14.04.2023 05:00;32;22;10;Leichter Nebel;1;1;0;Stadt Konstanz, Amt fuer Stadtplanung und Umwelt
14.04.2023 06:00;113;72;41;Leichter Nebel;1;0;0;Stadt Konstanz, Amt fuer Stadtplanung und Umwelt
14.04.2023 07:00;394;238;156;Bedeckt;2;1;0;Stadt Konstanz, Amt fuer Stadtplanung und Umwelt
14.04.2023 08:00;501;289;212;Bewoelkt;4;2;0;Stadt Konstanz, Amt fuer Stadtplanung und Umwelt
14.04.2023 09:00;541;322;219;Bewoelkt;5;4;0;Stadt Konstanz, Amt fuer Stadtplanung und Umwelt
14.04.2023 10:00;503;277;226;Leichter Regenschauer;6;5;0.2;Stadt Konstanz, Amt fuer Stadtplanung und Umwelt
14.04.2023 11:00;560;283;277;Bedeckt;8;8;0;Stadt Konstanz, Amt fuer Stadtplanung und Umwelt
14.04.2023 12:00;595;251;344;Leichter Regenschauer;9;9;0.2;Stadt Konstanz, Amt fuer Stadtplanung und Umwelt
14.04.2023 13:00;700;296;404;Stellenweiser Regenfall;10;10;0.6;Stadt Konstanz, Amt fuer Stadtplanung und Umwelt
14.04.2023 14:00;708;370;338;Leichter Regenschauer;11;11;0.4;Stadt Konstanz, Amt fuer Stadtplanung und Umwelt
14.04.2023 15:00;705;353;352;Leichter Regenschauer;11;11;0.2;Stadt Konstanz, Amt fuer Stadtplanung und Umwelt
14.04.2023 16:00;696;341;355;Leichter Regenschauer;10;10;1.1;Stadt Konstanz, Amt fuer Stadtplanung und Umwelt
14.04.2023 17:00;754;351;403;Leichter Regenschauer;10;9;0.2;Stadt Konstanz, Amt fuer Stadtplanung und Umwelt
14.04.2023 18:00;750;355;395;Leichter Regenschauer;8;8;0.4;Stadt Konstanz, Amt fuer Stadtplanung und Umwelt
14.04.2023 19:00;612;308;304;Leichter Regenschauer;6;5;1.4;Stadt Konstanz, Amt fuer Stadtplanung und Umwelt
14.04.2023 20:00;374;188;186;Leicht bewoelkt;4;4;0;Stadt Konstanz, Amt fuer Stadtplanung und Umwelt
14.04.2023 21:00;324;149;175;Leicht bewoelkt;2;1;0;Stadt Konstanz, Amt fuer Stadtplanung und Umwelt
14.04.2023 22:00;288;115;173;Leicht bewoelkt;2;1;0;Stadt Konstanz, Amt fuer Stadtplanung und Umwelt
14.04.2023 23:00;205;68;137;Leicht bewoelkt;1;1;0;Stadt Konstanz, Amt fuer Stadtplanung und Umwelt
15.04.2023 00:00;180;59;121;Sonnig;0;-1;0;Stadt Konstanz, Amt fuer Stadtplanung und Umwelt
15.04.2023 01:00;120;42;78;Sonnig;0;-1;0;Stadt Konstanz, Amt fuer Stadtplanung und Umwelt
15.04.2023 02:00;65;25;40;Sonnig;-1;-1;0;Stadt Konstanz, Amt fuer Stadtplanung und Umwelt
15.04.2023 03:00;52;25;27;Sonnig;-1;-1;0;Stadt Konstanz, Amt fuer Stadtplanung und Umwelt
15.04.2023 04:00;42;31;11;Leichter Nebel;-1;-1;0;Stadt Konstanz, Amt fuer Stadtplanung und Umwelt
15.04.2023 05:00;34;17;17;Leichter Nebel;-1;-3;0;Stadt Konstanz, Amt fuer Stadtplanung und Umwelt
15.04.2023 06:00;33;23;10;Sonnig;-1;-1;0;Stadt Konstanz, Amt fuer Stadtplanung und Umwelt
15.04.2023 07:00;78;46;32;Leicht bewoelkt;1;1;0;Stadt Konstanz, Amt fuer Stadtplanung und Umwelt
15.04.2023 08:00;180;86;94;Sonnig;4;4;0;Stadt Konstanz, Amt fuer Stadtplanung und Umwelt
15.04.2023 09:00;329;192;137;Sonnig;7;6;0;Stadt Konstanz, Amt fuer Stadtplanung und Umwelt
15.04.2023 10:00;393;235;158;Sonnig;9;8;0;Stadt Konstanz, Amt fuer Stadtplanung und Umwelt
15.04.2023 11:00;469;260;209;Sonnig;11;10;0;Stadt Konstanz, Amt fuer Stadtplanung und Umwelt
15.04.2023 12:00;562;297;265;Leicht bewoelkt;12;12;0;Stadt Konstanz, Amt fuer Stadtplanung und Umwelt
15.04.2023 13:00;504;253;251;Bewoelkt;14;13;0;Stadt Konstanz, Amt fuer Stadtplanung und Umwelt
15.04.2023 14:00;491;248;243;Leicht bewoelkt;13;12;0;Stadt Konstanz, Amt fuer Stadtplanung und Umwelt
15.04.2023 15:00;512;250;262;Leicht bewoelkt;13;13;0;Stadt Konstanz, Amt fuer Stadtplanung und Umwelt
15.04.2023 16:00;503;203;300;Leicht bewoelkt;13;13;0;Stadt Konstanz, Amt fuer Stadtplanung und Umwelt
15.04.2023 17:00;478;220;258;Leicht bewoelkt;13;13;0;Stadt Konstanz, Amt fuer Stadtplanung und Umwelt
15.04.2023 18:00;423;181;242;Leicht bewoelkt;11;11;0;Stadt Konstanz, Amt fuer Stadtplanung und Umwelt
15.04.2023 19:00;299;150;149;Leicht bewoelkt;8;8;0;Stadt Konstanz, Amt fuer Stadtplanung und Umwelt
15.04.2023 20:00;264;111;153;Leicht bewoelkt;6;5;0;Stadt Konstanz, Amt fuer Stadtplanung und Umwelt
15.04.2023 21:00;182;84;98;Bedeckt;6;6;0;Stadt Konstanz, Amt fuer Stadtplanung und Umwelt
15.04.2023 22:00;208;80;128;Bewoelkt;6;6;0.1;Stadt Konstanz, Amt fuer Stadtplanung und Umwelt
15.04.2023 23:00;121;42;79;Leicht bewoelkt;5;4;0;Stadt Konstanz, Amt fuer Stadtplanung und Umwelt
16.04.2023 00:00;104;36;68;Leichter Regenfall;6;5;1.2;Stadt Konstanz, Amt fuer Stadtplanung und Umwelt
16.04.2023 01:00;92;17;75;Maeßiger Regenfall;6;5;3.8;Stadt Konstanz, Amt fuer Stadtplanung und Umwelt
16.04.2023 02:00;54;22;32;Leichter Regenfall;6;4;1.5;Stadt Konstanz, Amt fuer Stadtplanung und Umwelt
16.04.2023 03:00;37;15;22;Leichter Regenfall;6;4;0.9;Stadt Konstanz, Amt fuer Stadtplanung und Umwelt
16.04.2023 04:00;26;12;14;Maeßiger Regenfall;5;3;3.9;Stadt Konstanz, Amt fuer Stadtplanung und Umwelt
16.04.2023 05:00;25;13;12;Nieselregen;5;3;0.7;Stadt Konstanz, Amt fuer Stadtplanung und Umwelt
16.04.2023 06:00;23;13;10;Leichter Regenfall;5;3;1.1;Stadt Konstanz, Amt fuer Stadtplanung und Umwelt
16.04.2023 07:00;19;11;8;Maeßiger Regenfall;5;3;2.7;Stadt Konstanz, Amt fuer Stadtplanung und Umwelt
16.04.2023 08:00;24;11;13;Nieselregen;5;4;0.5;Stadt Konstanz, Amt fuer Stadtplanung und Umwelt
16.04.2023 09:00;69;38;31;Nebel;6;4;0;Stadt Konstanz, Amt fuer Stadtplanung und Umwelt
16.04.2023 10:00;104;57;47;Leichter Regenfall;6;4;1.2;Stadt Konstanz, Amt fuer Stadtplanung und Umwelt
16.04.2023 11:00;105;59;46;Nebel;6;5;0;Stadt Konstanz, Amt fuer Stadtplanung und Umwelt
16.04.2023 12:00;102;51;51;Nieselregen;6;5;0.4;Stadt Konstanz, Amt fuer Stadtplanung und Umwelt
16.04.2023 13:00;111;48;63;Nieselregen;6;6;0.4;Stadt Konstanz, Amt fuer Stadtplanung und Umwelt
16.04.2023 14:00;170;84;86;Nieselregen;7;6;0.2;Stadt Konstanz, Amt fuer Stadtplanung und Umwelt
16.04.2023 15:00;180;81;99;Nebel;7;6;0;Stadt Konstanz, Amt fuer Stadtplanung und Umwelt
16.04.2023 16:00;185;89;96;Nieselregen;7;7;0.6;Stadt Konstanz, Amt fuer Stadtplanung und Umwelt
16.04.2023 17:00;209;109;100;Nebel;7;7;0.1;Stadt Konstanz, Amt fuer Stadtplanung und Umwelt
16.04.2023 18:00;210;95;115;Nieselregen;7;7;0.3;Stadt Konstanz, Amt fuer Stadtplanung und Umwelt
16.04.2023 19:00;128;63;65;Leichter Regenfall;6;6;1.2;Stadt Konstanz, Amt fuer Stadtplanung und Umwelt
16.04.2023 20:00;116;66;50;Nieselregen;6;6;0.3;Stadt Konstanz, Amt fuer Stadtplanung und Umwelt
16.04.2023 21:00;75;42;33;Nieselregen;6;6;0.2;Stadt Konstanz, Amt fuer Stadtplanung und Umwelt
16.04.2023 22:00;67;32;35;Nieselregen;6;6;0.7;Stadt Konstanz, Amt fuer Stadtplanung und Umwelt
16.04.2023 23:00;53;26;27;Nieselregen;6;6;0.2;Stadt Konstanz, Amt fuer Stadtplanung und Umwelt
17.04.2023 00:00;28;15;13;Nieselregen;5;5;0.5;Stadt Konstanz, Amt fuer Stadtplanung und Umwelt
17.04.2023 01:00;8;3;5;Maeßiger Regenfall;5;5;2.5;Stadt Konstanz, Amt fuer Stadtplanung und Umwelt
17.04.2023 02:00;4;2;2;Nieselregen;5;5;0.4;Stadt Konstanz, Amt fuer Stadtplanung und Umwelt
17.04.2023 03:00;5;3;2;Nieselregen;5;5;0.3;Stadt Konstanz, Amt fuer Stadtplanung und Umwelt
17.04.2023 04:00;6;4;2;Nieselregen;6;5;0.7;Stadt Konstanz, Amt fuer Stadtplanung und Umwelt
17.04.2023 05:00;53;42;11;Nieselregen;6;4;0.2;Stadt Konstanz, Amt fuer Stadtplanung und Umwelt
17.04.2023 06:00;139;73;66;Nieselregen;5;4;0.2;Stadt Konstanz, Amt fuer Stadtplanung und Umwelt
17.04.2023 07:00;845;529;316;Nieselregen;6;4;0.4;Stadt Konstanz, Amt fuer Stadtplanung und Umwelt
17.04.2023 08:00;691;389;302;Leichter Nebel;6;5;0;Stadt Konstanz, Amt fuer Stadtplanung und Umwelt
17.04.2023 09:00;677;374;303;Bedeckt;6;6;0;Stadt Konstanz, Amt fuer Stadtplanung und Umwelt
17.04.2023 10:00;363;169;194;Bedeckt;7;6;0.1;Stadt Konstanz, Amt fuer Stadtplanung und Umwelt
17.04.2023 11:00;579;289;290;Bedeckt;7;6;0;Stadt Konstanz, Amt fuer Stadtplanung und Umwelt
17.04.2023 12:00;562;261;301;Leichter Nebel;7;5;0.1;Stadt Konstanz, Amt fuer Stadtplanung und Umwelt
17.04.2023 13:00;862;378;484;Bedeckt;6;5;0;Stadt Konstanz, Amt fuer Stadtplanung und Umwelt
17.04.2023 14:00;562;274;288;Bedeckt;8;6;0;Stadt Konstanz, Amt fuer Stadtplanung und Umwelt
17.04.2023 15:00;874;433;441;Bedeckt;10;8;0;Stadt Konstanz, Amt fuer Stadtplanung und Umwelt
17.04.2023 16:00;807;386;421;Leichter Regenschauer;11;9;0.2;Stadt Konstanz, Amt fuer Stadtplanung und Umwelt
17.04.2023 17:00;976;412;564;Leicht bewoelkt;10;8;0;Stadt Konstanz, Amt fuer Stadtplanung und Umwelt
17.04.2023 18:00;798;357;441;Leicht bewoelkt;10;7;0.1;Stadt Konstanz, Amt fuer Stadtplanung und Umwelt
17.04.2023 19:00;575;249;326;Leicht bewoelkt;8;5;0;Stadt Konstanz, Amt fuer Stadtplanung und Umwelt
17.04.2023 20:00;450;196;254;Bedeckt;7;4;0;Stadt Konstanz, Amt fuer Stadtplanung und Umwelt
17.04.2023 21:00;305;134;171;Bewoelkt;8;5;0;Stadt Konstanz, Amt fuer Stadtplanung und Umwelt
17.04.2023 22:00;197;89;108;Bewoelkt;8;5;0;Stadt Konstanz, Amt fuer Stadtplanung und Umwelt
17.04.2023 23:00;102;53;49;Bedeckt;8;5;0;Stadt Konstanz, Amt fuer Stadtplanung und Umwelt
18.04.2023 00:00;65;22;43;Bedeckt;7;4;0.1;Stadt Konstanz, Amt fuer Stadtplanung und Umwelt
18.04.2023 01:00;35;16;19;Bedeckt;7;4;0;Stadt Konstanz, Amt fuer Stadtplanung und Umwelt
18.04.2023 02:00;12;9;3;Bedeckt;7;4;0;Stadt Konstanz, Amt fuer Stadtplanung und Umwelt
18.04.2023 03:00;12;10;2;Bedeckt;7;4;0;Stadt Konstanz, Amt fuer Stadtplanung und Umwelt
18.04.2023 04:00;8;6;2;Bedeckt;7;4;0;Stadt Konstanz, Amt fuer Stadtplanung und Umwelt
18.04.2023 05:00;56;42;14;Bedeckt;7;4;0;Stadt Konstanz, Amt fuer Stadtplanung und Umwelt
18.04.2023 06:00;197;109;88;Bedeckt;7;4;0;Stadt Konstanz, Amt fuer Stadtplanung und Umwelt
18.04.2023 07:00;1043;660;383;Bedeckt;7;4;0.1;Stadt Konstanz, Amt fuer Stadtplanung und Umwelt
18.04.2023 08:00;835;469;366;Bedeckt;7;4;0;Stadt Konstanz, Amt fuer Stadtplanung und Umwelt
18.04.2023 09:00;783;439;344;Bedeckt;7;4;0;Stadt Konstanz, Amt fuer Stadtplanung und Umwelt
18.04.2023 10:00;448;198;250;Bedeckt;8;5;0;Stadt Konstanz, Amt fuer Stadtplanung und Umwelt
18.04.2023 11:00;644;315;329;Bedeckt;9;6;0;Stadt Konstanz, Amt fuer Stadtplanung und Umwelt
18.04.2023 12:00;689;263;426;Bedeckt;10;7;0;Stadt Konstanz, Amt fuer Stadtplanung und Umwelt
18.04.2023 13:00;923;403;520;Bedeckt;11;9;0.1;Stadt Konstanz, Amt fuer Stadtplanung und Umwelt
18.04.2023 14:00;712;346;366;Leichter Regenschauer;11;9;0.2;Stadt Konstanz, Amt fuer Stadtplanung und Umwelt
18.04.2023 15:00;956;457;499;Bedeckt;11;9;0.1;Stadt Konstanz, Amt fuer Stadtplanung und Umwelt
18.04.2023 16:00;962;451;511;Leichter Regenschauer;11;9;0.3;Stadt Konstanz, Amt fuer Stadtplanung und Umwelt
18.04.2023 17:00;1123;486;637;Bewoelkt;11;9;0.1;Stadt Konstanz, Amt fuer Stadtplanung und Umwelt
18.04.2023 18:00;921;405;516;Bewoelkt;10;7;0.1;Stadt Konstanz, Amt fuer Stadtplanung und Umwelt
18.04.2023 19:00;682;309;373;Leichter Regenschauer;9;6;0.2;Stadt Konstanz, Amt fuer Stadtplanung und Umwelt
18.04.2023 20:00;477;241;236;Bedeckt;7;4;0;Stadt Konstanz, Amt fuer Stadtplanung und Umwelt
18.04.2023 21:00;352;158;194;Bewoelkt;8;6;0;Stadt Konstanz, Amt fuer Stadtplanung und Umwelt
18.04.2023 22:00;236;103;133;Bewoelkt;8;5;0;Stadt Konstanz, Amt fuer Stadtplanung und Umwelt
18.04.2023 23:00;143;63;80;Bewoelkt;8;5;0;Stadt Konstanz, Amt fuer Stadtplanung und Umwelt
19.04.2023 00:00;58;22;36;Bedeckt;8;4;0;Stadt Konstanz, Amt fuer Stadtplanung und Umwelt
19.04.2023 01:00;28;17;11;Bedeckt;8;5;0;Stadt Konstanz, Amt fuer Stadtplanung und Umwelt
19.04.2023 02:00;12;3;9;Bedeckt;8;5;0;Stadt Konstanz, Amt fuer Stadtplanung und Umwelt
19.04.2023 03:00;4;0;4;Bedeckt;8;5;0;Stadt Konstanz, Amt fuer Stadtplanung und Umwelt
19.04.2023 04:00;10;7;3;Bedeckt;7;5;0;Stadt Konstanz, Amt fuer Stadtplanung und Umwelt
19.04.2023 05:00;77;47;30;Bedeckt;7;5;0;Stadt Konstanz, Amt fuer Stadtplanung und Umwelt
19.04.2023 06:00;172;96;76;Bedeckt;7;5;0;Stadt Konstanz, Amt fuer Stadtplanung und Umwelt
19.04.2023 07:00;1013;659;354;Bedeckt;8;6;0;Stadt Konstanz, Amt fuer Stadtplanung und Umwelt
19.04.2023 08:00;880;519;361;Bedeckt;8;6;0;Stadt Konstanz, Amt fuer Stadtplanung und Umwelt
19.04.2023 09:00;642;362;280;Stellenweiser Regenfall;8;6;0.1;Stadt Konstanz, Amt fuer Stadtplanung und Umwelt
19.04.2023 10:00;487;254;233;Leichter Regenschauer;8;6;0.2;Stadt Konstanz, Amt fuer Stadtplanung und Umwelt
19.04.2023 11:00;576;256;320;Bedeckt;9;6;0;Stadt Konstanz, Amt fuer Stadtplanung und Umwelt
19.04.2023 12:00;679;297;382;Stellenweiser Regenfall;9;7;0.1;Stadt Konstanz, Amt fuer Stadtplanung und Umwelt
19.04.2023 13:00;1013;461;552;Bedeckt;9;7;0;Stadt Konstanz, Amt fuer Stadtplanung und Umwelt
19.04.2023 14:00;684;328;356;Bewoelkt;9;8;0;Stadt Konstanz, Amt fuer Stadtplanung und Umwelt
19.04.2023 15:00;922;410;512;Bedeckt;11;10;0;Stadt Konstanz, Amt fuer Stadtplanung und Umwelt
19.04.2023 16:00;884;407;477;Leichter Regenschauer;10;8;0.4;Stadt Konstanz, Amt fuer Stadtplanung und Umwelt
19.04.2023 17:00;1041;450;591;Bedeckt;8;6;0;Stadt Konstanz, Amt fuer Stadtplanung und Umwelt
19.04.2023 18:00;876;368;508;Leichter Regenschauer;7;5;0.2;Stadt Konstanz, Amt fuer Stadtplanung und Umwelt
19.04.2023 19:00;543;221;322;Leichter Nebel;6;4;0;Stadt Konstanz, Amt fuer Stadtplanung und Umwelt
19.04.2023 20:00;429;213;216;Nieselregen;5;2;0.5;Stadt Konstanz, Amt fuer Stadtplanung und Umwelt
19.04.2023 21:00;238;115;123;Nieselregen;4;2;0.6;Stadt Konstanz, Amt fuer Stadtplanung und Umwelt
19.04.2023 22:00;219;105;114;Maeßiger bis starker Eisregen;3;1;3.1;Stadt Konstanz, Amt fuer Stadtplanung und Umwelt
19.04.2023 23:00;179;77;102;Leichter Eisregen;3;1;0.8;Stadt Konstanz, Amt fuer Stadtplanung und Umwelt
20.04.2023 00:00;57;23;34;Nieselregen;4;1;0.7;Stadt Konstanz, Amt fuer Stadtplanung und Umwelt
20.04.2023 01:00;28;10;18;Maeßiger Regenfall;4;1;3.5;Stadt Konstanz, Amt fuer Stadtplanung und Umwelt
20.04.2023 02:00;14;1;13;Nieselregen;3;1;0.3;Stadt Konstanz, Amt fuer Stadtplanung und Umwelt
20.04.2023 03:00;7;0;7;Leichter Eisregen;3;1;0.4;Stadt Konstanz, Amt fuer Stadtplanung und Umwelt
20.04.2023 04:00;11;8;3;Leichter Eisregen;3;1;1.1;Stadt Konstanz, Amt fuer Stadtplanung und Umwelt
20.04.2023 05:00;54;32;22;Starker Schneefall;3;0;0.3;Stadt Konstanz, Amt fuer Stadtplanung und Umwelt
20.04.2023 06:00;168;91;77;Starker Schneefall;2;0;0.4;Stadt Konstanz, Amt fuer Stadtplanung und Umwelt
20.04.2023 07:00;836;530;306;Starker Schneefall;2;1;2.4;Stadt Konstanz, Amt fuer Stadtplanung und Umwelt
20.04.2023 08:00;606;333;273;Starker Schneefall;2;1;1.2;Stadt Konstanz, Amt fuer Stadtplanung und Umwelt
20.04.2023 09:00;572;330;242;Starker Schneefall;2;2;0.9;Stadt Konstanz, Amt fuer Stadtplanung und Umwelt
20.04.2023 10:00;334;198;136;Starker Schneefall;3;2;2.9;Stadt Konstanz, Amt fuer Stadtplanung und Umwelt
20.04.2023 11:00;474;247;227;Leichter Eisregen;4;4;0.6;Stadt Konstanz, Amt fuer Stadtplanung und Umwelt
20.04.2023 12:00;478;214;264;Leichter Eisregen;4;4;0.7;Stadt Konstanz, Amt fuer Stadtplanung und Umwelt
20.04.2023 13:00;848;366;482;Maeßiger Regenfall;5;4;2.5;Stadt Konstanz, Amt fuer Stadtplanung und Umwelt
20.04.2023 14:00;494;213;281;Stellenweiser Regenfall;5;4;0.1;Stadt Konstanz, Amt fuer Stadtplanung und Umwelt
20.04.2023 15:00;764;360;404;Bedeckt;5;3;0;Stadt Konstanz, Amt fuer Stadtplanung und Umwelt
20.04.2023 16:00;676;320;356;Leichter Nebel;5;3;0.1;Stadt Konstanz, Amt fuer Stadtplanung und Umwelt
20.04.2023 17:00;784;324;460;Leichter Nebel;5;4;0;Stadt Konstanz, Amt fuer Stadtplanung und Umwelt
20.04.2023 18:00;611;269;342;Leichter Nebel;5;4;0;Stadt Konstanz, Amt fuer Stadtplanung und Umwelt
20.04.2023 19:00;447;213;234;Nebel;4;4;0.1;Stadt Konstanz, Amt fuer Stadtplanung und Umwelt
20.04.2023 20:00;323;163;160;Nebel;4;4;0;Stadt Konstanz, Amt fuer Stadtplanung und Umwelt
20.04.2023 21:00;221;103;118;Nebel;4;4;0;Stadt Konstanz, Amt fuer Stadtplanung und Umwelt
20.04.2023 22:00;196;99;97;Nebel;4;3;0;Stadt Konstanz, Amt fuer Stadtplanung und Umwelt
20.04.2023 23:00;103;47;56;Nebel;4;4;0.1;Stadt Konstanz, Amt fuer Stadtplanung und Umwelt
21.04.2023 00:00;77;26;51;Bedeckt;4;3;0;Stadt Konstanz, Amt fuer Stadtplanung und Umwelt
21.04.2023 01:00;36;10;26;Leichter Nebel;4;3;0.1;Stadt Konstanz, Amt fuer Stadtplanung und Umwelt
21.04.2023 02:00;17;3;14;Leichter Nebel;3;3;0;Stadt Konstanz, Amt fuer Stadtplanung und Umwelt
21.04.2023 03:00;10;4;6;Leicht bewoelkt;4;4;0;Stadt Konstanz, Amt fuer Stadtplanung und Umwelt
21.04.2023 04:00;9;5;4;Leichter Nebel;4;2;0;Stadt Konstanz, Amt fuer Stadtplanung und Umwelt
21.04.2023 05:00;40;23;17;Nebel;3;3;0;Stadt Konstanz, Amt fuer Stadtplanung und Umwelt
21.04.2023 06:00;160;81;79;Nebel;3;3;0;Stadt Konstanz, Amt fuer Stadtplanung und Umwelt
21.04.2023 07:00;844;521;323;Leicht bewoelkt;5;5;0;Stadt Konstanz, Amt fuer Stadtplanung und Umwelt
21.04.2023 08:00;682;393;289;Leicht bewoelkt;7;7;0;Stadt Konstanz, Amt fuer Stadtplanung und Umwelt
21.04.2023 09:00;671;398;273;Bewoelkt;9;9;0;Stadt Konstanz, Amt fuer Stadtplanung und Umwelt
21.04.2023 10:00;592;360;232;Leicht bewoelkt;11;12;0;Stadt Konstanz, Amt fuer Stadtplanung und Umwelt
21.04.2023 11:00;706;339;367;Leicht bewoelkt;13;12;0;Stadt Konstanz, Amt fuer Stadtplanung und Umwelt
21.04.2023 12:00;820;382;438;Leicht bewoelkt;15;14;0;Stadt Konstanz, Amt fuer Stadtplanung und Umwelt
21.04.2023 13:00;985;390;595;Sonnig;16;16;0;Stadt Konstanz, Amt fuer Stadtplanung und Umwelt
21.04.2023 14:00;814;412;402;Sonnig;18;18;0;Stadt Konstanz, Amt fuer Stadtplanung und Umwelt
21.04.2023 15:00;876;441;435;Sonnig;18;18;0;Stadt Konstanz, Amt fuer Stadtplanung und Umwelt
21.04.2023 16:00;906;412;494;Leicht bewoelkt;18;18;0;Stadt Konstanz, Amt fuer Stadtplanung und Umwelt
21.04.2023 17:00;806;376;430;Sonnig;17;17;0;Stadt Konstanz, Amt fuer Stadtplanung und Umwelt
21.04.2023 18:00;767;329;438;Leicht bewoelkt;14;13;0;Stadt Konstanz, Amt fuer Stadtplanung und Umwelt
21.04.2023 19:00;576;240;336;Bewoelkt;11;10;0;Stadt Konstanz, Amt fuer Stadtplanung und Umwelt
21.04.2023 20:00;405;178;227;Leichter Regenschauer;9;8;0.5;Stadt Konstanz, Amt fuer Stadtplanung und Umwelt
21.04.2023 21:00;329;177;152;Leichter Regenschauer;8;7;0.3;Stadt Konstanz, Amt fuer Stadtplanung und Umwelt
21.04.2023 22:00;265;140;125;Leichter Regenschauer;8;8;0.5;Stadt Konstanz, Amt fuer Stadtplanung und Umwelt
21.04.2023 23:00;236;84;152;Stellenweiser Regenfall;8;7;0.1;Stadt Konstanz, Amt fuer Stadtplanung und Umwelt
22.04.2023 00:00;182;64;118;Leichter Nebel;7;6;0;Stadt Konstanz, Amt fuer Stadtplanung und Umwelt
22.04.2023 01:00;90;28;62;Leichter Nebel;6;5;0;Stadt Konstanz, Amt fuer Stadtplanung und Umwelt
22.04.2023 02:00;77;36;41;Leichter Nebel;6;5;0;Stadt Konstanz, Amt fuer Stadtplanung und Umwelt
22.04.2023 03:00;39;19;20;Leichter Nebel;6;5;0;Stadt Konstanz, Amt fuer Stadtplanung und Umwelt
22.04.2023 04:00;29;21;8;Leichter Nebel;5;5;0;Stadt Konstanz, Amt fuer Stadtplanung und Umwelt
22.04.2023 05:00;33;23;10;Leichter Nebel;5;5;0;Stadt Konstanz, Amt fuer Stadtplanung und Umwelt
22.04.2023 06:00;46;29;17;Leichter Nebel;5;5;0;Stadt Konstanz, Amt fuer Stadtplanung und Umwelt
22.04.2023 07:00;90;42;48;Leicht bewoelkt;7;7;0;Stadt Konstanz, Amt fuer Stadtplanung und Umwelt
22.04.2023 08:00;239;146;93;Leicht bewoelkt;10;10;0;Stadt Konstanz, Amt fuer Stadtplanung und Umwelt
22.04.2023 09:00;443;251;192;Leicht bewoelkt;12;12;0;Stadt Konstanz, Amt fuer Stadtplanung und Umwelt
22.04.2023 10:00;582;304;278;Sonnig;14;15;0;Stadt Konstanz, Amt fuer Stadtplanung und Umwelt
22.04.2023 11:00;652;334;318;Sonnig;17;17;0;Stadt Konstanz, Amt fuer Stadtplanung und Umwelt
22.04.2023 12:00;720;382;338;Leicht bewoelkt;18;18;0;Stadt Konstanz, Amt fuer Stadtplanung und Umwelt
22.04.2023 13:00;824;401;423;Leicht bewoelkt;20;20;0;Stadt Konstanz, Amt fuer Stadtplanung und Umwelt
22.04.2023 14:00;851;433;418;Leicht bewoelkt;20;20;0;Stadt Konstanz, Amt fuer Stadtplanung und Umwelt
22.04.2023 15:00;783;403;380;Leicht bewoelkt;20;20;0;Stadt Konstanz, Amt fuer Stadtplanung und Umwelt
22.04.2023 16:00;779;369;410;Bewoelkt;19;19;0;Stadt Konstanz, Amt fuer Stadtplanung und Umwelt
22.04.2023 17:00;854;423;431;Bedeckt;18;18;0;Stadt Konstanz, Amt fuer Stadtplanung und Umwelt
22.04.2023 18:00;608;249;359;Leicht bewoelkt;14;12;0;Stadt Konstanz, Amt fuer Stadtplanung und Umwelt
22.04.2023 19:00;367;187;180;Leicht bewoelkt;12;9;0;Stadt Konstanz, Amt fuer Stadtplanung und Umwelt
22.04.2023 20:00;329;176;153;Bedeckt;12;10;0;Stadt Konstanz, Amt fuer Stadtplanung und Umwelt
22.04.2023 21:00;296;166;130;Bedeckt;11;9;0;Stadt Konstanz, Amt fuer Stadtplanung und Umwelt
22.04.2023 22:00;257;130;127;Stellenweiser Regenfall;10;8;0.1;Stadt Konstanz, Amt fuer Stadtplanung und Umwelt
22.04.2023 23:00;180;58;122;Bedeckt;10;8;0;Stadt Konstanz, Amt fuer Stadtplanung und Umwelt
23.04.2023 00:00;197;61;136;Bedeckt;9;9;0;Stadt Konstanz, Amt fuer Stadtplanung und Umwelt
23.04.2023 01:00;120;39;81;Bedeckt;9;9;0;Stadt Konstanz, Amt fuer Stadtplanung und Umwelt
23.04.2023 02:00;109;37;72;Nieselregen;9;9;0.3;Stadt Konstanz, Amt fuer Stadtplanung und Umwelt
23.04.2023 03:00;65;22;43;Nieselregen;9;8;0.7;Stadt Konstanz, Amt fuer Stadtplanung und Umwelt
23.04.2023 04:00;40;16;24;Stellenweiser leichter Regenfall;9;8;2.4;Stadt Konstanz, Amt fuer Stadtplanung und Umwelt
23.04.2023 05:00;39;18;21;Nieselregen;9;8;0.6;Stadt Konstanz, Amt fuer Stadtplanung und Umwelt
23.04.2023 06:00;21;8;13;Leichter Regenfall;9;8;1;Stadt Konstanz, Amt fuer Stadtplanung und Umwelt
23.04.2023 07:00;24;10;14;Maeßiger Regenfall;9;9;3.6;Stadt Konstanz, Amt fuer Stadtplanung und Umwelt
23.04.2023 08:00;88;38;50;Leichter Nebel;10;10;0;Stadt Konstanz, Amt fuer Stadtplanung und Umwelt
23.04.2023 09:00;179;101;78;Bewoelkt;12;11;0;Stadt Konstanz, Amt fuer Stadtplanung und Umwelt
23.04.2023 10:00;263;154;109;Stellenweiser Regenfall;13;12;0.2;Stadt Konstanz, Amt fuer Stadtplanung und Umwelt
23.04.2023 11:00;324;149;175;Leicht bewoelkt;14;13;0;Stadt Konstanz, Amt fuer Stadtplanung und Umwelt
23.04.2023 12:00;361;164;197;Leicht bewoelkt;15;15;0;Stadt Konstanz, Amt fuer Stadtplanung und Umwelt
23.04.2023 13:00;447;196;251;Stellenweiser Regenfall;17;17;0.1;Stadt Konstanz, Amt fuer Stadtplanung und Umwelt
23.04.2023 14:00;552;267;285;Leicht bewoelkt;17;17;0;Stadt Konstanz, Amt fuer Stadtplanung und Umwelt
23.04.2023 15:00;542;284;258;Leicht bewoelkt;18;18;0;Stadt Konstanz, Amt fuer Stadtplanung und Umwelt
23.04.2023 16:00;618;286;332;Leicht bewoelkt;18;18;0;Stadt Konstanz, Amt fuer Stadtplanung und Umwelt
23.04.2023 17:00;446;218;228;Leicht bewoelkt;18;18;0;Stadt Konstanz, Amt fuer Stadtplanung und Umwelt
23.04.2023 18:00;231;116;115;Sonnig;15;15;0;Stadt Konstanz, Amt fuer Stadtplanung und Umwelt
23.04.2023 19:00;258;124;134;Leicht bewoelkt;12;11;0;Stadt Konstanz, Amt fuer Stadtplanung und Umwelt
23.04.2023 20:00;184;75;109;Stellenweiser Regenfall;9;9;0.1;Stadt Konstanz, Amt fuer Stadtplanung und Umwelt
23.04.2023 21:00;73;37;36;Leichter Regenschauer;9;6;0.6;Stadt Konstanz, Amt fuer Stadtplanung und Umwelt
23.04.2023 22:00;92;35;57;Maeßiger Regenfall;8;5;2.7;Stadt Konstanz, Amt fuer Stadtplanung und Umwelt
23.04.2023 23:00;50;21;29;Leichter Regenschauer;9;6;0.7;Stadt Konstanz, Amt fuer Stadtplanung und Umwelt
24.04.2023 00:00;28;11;17;Leichter Regenschauer;9;7;1;Stadt Konstanz, Amt fuer Stadtplanung und Umwelt
24.04.2023 01:00;8;6;2;Leichter Nebel;9;7;0;Stadt Konstanz, Amt fuer Stadtplanung und Umwelt
24.04.2023 02:00;6;3;3;Leichter Regenschauer;8;7;0.2;Stadt Konstanz, Amt fuer Stadtplanung und Umwelt
24.04.2023 03:00;2;0;2;Leichter Regenschauer;7;6;0.2;Stadt Konstanz, Amt fuer Stadtplanung und Umwelt
24.04.2023 04:00;10;7;3;Leichter Regenschauer;8;6;0.3;Stadt Konstanz, Amt fuer Stadtplanung und Umwelt
24.04.2023 05:00;47;28;19;Leichter Nebel;8;6;0.1;Stadt Konstanz, Amt fuer Stadtplanung und Umwelt
24.04.2023 06:00;202;111;91;Leichter Nebel;8;6;0.1;Stadt Konstanz, Amt fuer Stadtplanung und Umwelt
24.04.2023 07:00;882;541;341;Leichter Regenfall;8;5;1.3;Stadt Konstanz, Amt fuer Stadtplanung und Umwelt
24.04.2023 08:00;785;438;347;Leichter Regenfall;7;4;2.1;Stadt Konstanz, Amt fuer Stadtplanung und Umwelt
24.04.2023 09:00;685;364;321;Stellenweiser Regenfall;8;5;0.5;Stadt Konstanz, Amt fuer Stadtplanung und Umwelt
24.04.2023 10:00;360;181;179;Stellenweiser Regenfall;10;7;2.2;Stadt Konstanz, Amt fuer Stadtplanung und Umwelt
24.04.2023 11:00;551;254;297;Nieselregen;10;7;0.3;Stadt Konstanz, Amt fuer Stadtplanung und Umwelt
24.04.2023 12:00;632;276;356;Leichter Regenschauer;8;5;0.5;Stadt Konstanz, Amt fuer Stadtplanung und Umwelt
24.04.2023 13:00;799;342;457;Stellenweiser Regenfall;10;7;0.1;Stadt Konstanz, Amt fuer Stadtplanung und Umwelt
24.04.2023 14:00;628;307;321;Leichter Regenschauer;11;8;0.2;Stadt Konstanz, Amt fuer Stadtplanung und Umwelt
24.04.2023 15:00;923;429;494;Bedeckt;8;5;0;Stadt Konstanz, Amt fuer Stadtplanung und Umwelt
24.04.2023 16:00;880;400;480;Leichter Regenschauer;8;4;0.3;Stadt Konstanz, Amt fuer Stadtplanung und Umwelt
24.04.2023 17:00;1020;447;573;Bedeckt;8;5;0;Stadt Konstanz, Amt fuer Stadtplanung und Umwelt
24.04.2023 18:00;891;406;485;Stellenweiser Regenfall;8;4;0.1;Stadt Konstanz, Amt fuer Stadtplanung und Umwelt
24.04.2023 19:00;609;281;328;Bedeckt;7;4;0;Stadt Konstanz, Amt fuer Stadtplanung und Umwelt
24.04.2023 20:00;489;202;287;Bedeckt;7;5;0;Stadt Konstanz, Amt fuer Stadtplanung und Umwelt
24.04.2023 21:00;274;132;142;Bedeckt;8;5;0;Stadt Konstanz, Amt fuer Stadtplanung und Umwelt
24.04.2023 22:00;206;81;125;Bedeckt;8;5;0;Stadt Konstanz, Amt fuer Stadtplanung und Umwelt
24.04.2023 23:00;110;44;66;Bedeckt;7;5;0;Stadt Konstanz, Amt fuer Stadtplanung und Umwelt
25.04.2023 00:00;48;21;27;Bedeckt;5;4;0;Stadt Konstanz, Amt fuer Stadtplanung und Umwelt
25.04.2023 01:00;24;7;17;Stellenweiser Regenfall;5;4;0.1;Stadt Konstanz, Amt fuer Stadtplanung und Umwelt
25.04.2023 02:00;10;8;2;Leicht bewoelkt;4;4;0;Stadt Konstanz, Amt fuer Stadtplanung und Umwelt
25.04.2023 03:00;15;7;8;Bedeckt;4;3;0;Stadt Konstanz, Amt fuer Stadtplanung und Umwelt
25.04.2023 04:00;7;6;1;Nieselregen;5;3;0.2;Stadt Konstanz, Amt fuer Stadtplanung und Umwelt
25.04.2023 05:00;40;29;11;Stellenweiser Regenfall;6;4;0.1;Stadt Konstanz, Amt fuer Stadtplanung und Umwelt
25.04.2023 06:00;190;98;92;Stellenweiser Regenfall;6;4;0.1;Stadt Konstanz, Amt fuer Stadtplanung und Umwelt
25.04.2023 07:00;981;613;368;Nieselregen;7;4;0.2;Stadt Konstanz, Amt fuer Stadtplanung und Umwelt
25.04.2023 08:00;831;470;361;Stellenweiser Regenfall;7;4;0.1;Stadt Konstanz, Amt fuer Stadtplanung und Umwelt
25.04.2023 09:00;568;324;244;Bedeckt;7;5;0;Stadt Konstanz, Amt fuer Stadtplanung und Umwelt
25.04.2023 10:00;307;176;131;Leichter Regenschauer;7;5;0.9;Stadt Konstanz, Amt fuer Stadtplanung und Umwelt
25.04.2023 11:00;446;197;249;Stellenweise Gewitter und Niederschlaege;8;6;0;Stadt Konstanz, Amt fuer Stadtplanung und Umwelt
25.04.2023 12:00;490;197;293;Leichter Regenschauer;8;7;0.4;Stadt Konstanz, Amt fuer Stadtplanung und Umwelt
25.04.2023 13:00;788;339;449;Leichter Regenschauer;9;9;0.9;Stadt Konstanz, Amt fuer Stadtplanung und Umwelt
25.04.2023 14:00;527;247;280;Leichter Regenschauer;9;8;0.6;Stadt Konstanz, Amt fuer Stadtplanung und Umwelt
25.04.2023 15:00;761;360;401;Leichter Regenschauer;9;9;0.7;Stadt Konstanz, Amt fuer Stadtplanung und Umwelt
25.04.2023 16:00;759;331;428;Leichter Regenschauer;10;10;2.4;Stadt Konstanz, Amt fuer Stadtplanung und Umwelt
25.04.2023 17:00;935;437;498;Leichter Regenschauer;10;10;0.8;Stadt Konstanz, Amt fuer Stadtplanung und Umwelt
25.04.2023 18:00;781;353;428;Leichter Regenschauer;9;9;0.8;Stadt Konstanz, Amt fuer Stadtplanung und Umwelt
25.04.2023 19:00;598;260;338;Maeßiger bis starker Regenschauer;7;7;4.4;Stadt Konstanz, Amt fuer Stadtplanung und Umwelt
25.04.2023 20:00;406;165;241;Stellenweiser Regenfall;5;4;0.1;Stadt Konstanz, Amt fuer Stadtplanung und Umwelt
25.04.2023 21:00;306;124;182;Bewoelkt;4;3;0;Stadt Konstanz, Amt fuer Stadtplanung und Umwelt
25.04.2023 22:00;241;115;126;Leichter Regenschauer;4;4;0.2;Stadt Konstanz, Amt fuer Stadtplanung und Umwelt
25.04.2023 23:00;103;41;62;Bewoelkt;5;5;0;Stadt Konstanz, Amt fuer Stadtplanung und Umwelt
26.04.2023 00:00;46;18;28;Leichter Nebel;2;2;0.1;Stadt Konstanz, Amt fuer Stadtplanung und Umwelt
26.04.2023 01:00;25;17;8;Leichter Regenschauer;2;1;0.2;Stadt Konstanz, Amt fuer Stadtplanung und Umwelt
26.04.2023 02:00;9;5;4;Leichter Nebel;2;2;0;Stadt Konstanz, Amt fuer Stadtplanung und Umwelt
26.04.2023 03:00;2;1;1;Nebel;2;2;0;Stadt Konstanz, Amt fuer Stadtplanung und Umwelt
26.04.2023 04:00;3;3;0;Nebel;2;2;0;Stadt Konstanz, Amt fuer Stadtplanung und Umwelt
26.04.2023 05:00;57;33;24;Nebel;2;2;0;Stadt Konstanz, Amt fuer Stadtplanung und Umwelt
26.04.2023 06:00;183;102;81;Nebel;3;3;0;Stadt Konstanz, Amt fuer Stadtplanung und Umwelt
26.04.2023 07:00;992;649;343;Leichter Nebel;5;5;0;Stadt Konstanz, Amt fuer Stadtplanung und Umwelt
26.04.2023 08:00;831;467;364;Bedeckt;6;6;0;Stadt Konstanz, Amt fuer Stadtplanung und Umwelt
26.04.2023 09:00;727;383;344;Bedeckt;8;8;0;Stadt Konstanz, Amt fuer Stadtplanung und Umwelt
26.04.2023 10:00;406;218;188;Bewoelkt;10;10;0;Stadt Konstanz, Amt fuer Stadtplanung und Umwelt
26.04.2023 11:00;619;260;359;Bedeckt;12;11;0;Stadt Konstanz, Amt fuer Stadtplanung und Umwelt
26.04.2023 12:00;656;291;365;Bedeckt;12;12;0;Stadt Konstanz, Amt fuer Stadtplanung und Umwelt
26.04.2023 13:00;1013;447;566;Leicht bewoelkt;13;13;0;Stadt Konstanz, Amt fuer Stadtplanung und Umwelt
26.04.2023 14:00;663;319;344;Stellenweiser Regenfall;13;13;0.1;Stadt Konstanz, Amt fuer Stadtplanung und Umwelt
26.04.2023 15:00;951;448;503;Stellenweiser Regenfall;13;12;0.1;Stadt Konstanz, Amt fuer Stadtplanung und Umwelt
26.04.2023 16:00;936;434;502;Leichter Regenschauer;11;9;0.6;Stadt Konstanz, Amt fuer Stadtplanung und Umwelt
26.04.2023 17:00;1109;454;655;Leichter Regenschauer;10;10;0.2;Stadt Konstanz, Amt fuer Stadtplanung und Umwelt
26.04.2023 18:00;989;438;551;Leichter Regenschauer;9;9;0.2;Stadt Konstanz, Amt fuer Stadtplanung und Umwelt
26.04.2023 19:00;676;323;353;Leichter Regenschauer;8;8;1.3;Stadt Konstanz, Amt fuer Stadtplanung und Umwelt
26.04.2023 20:00;550;264;286;Nieselregen;6;6;0.3;Stadt Konstanz, Amt fuer Stadtplanung und Umwelt
26.04.2023 21:00;377;184;193;Nieselregen;6;6;0.3;Stadt Konstanz, Amt fuer Stadtplanung und Umwelt
26.04.2023 22:00;297;137;160;Leichter Regenfall;6;6;0.9;Stadt Konstanz, Amt fuer Stadtplanung und Umwelt
26.04.2023 23:00;169;68;101;Nieselregen;6;6;0.4;Stadt Konstanz, Amt fuer Stadtplanung und Umwelt
27.04.2023 00:00;97;18;79;Leicht bewoelkt;6;6;0;Stadt Konstanz, Amt fuer Stadtplanung und Umwelt
27.04.2023 01:00;87;15;72;Leichter Nebel;5;5;0.1;Stadt Konstanz, Amt fuer Stadtplanung und Umwelt
27.04.2023 02:00;83;16;67;Leichter Nebel;4;4;0;Stadt Konstanz, Amt fuer Stadtplanung und Umwelt
27.04.2023 03:00;28;7;21;Leichter Nebel;3;3;0;Stadt Konstanz, Amt fuer Stadtplanung und Umwelt
27.04.2023 04:00;17;13;4;Leichter Nebel;3;3;0;Stadt Konstanz, Amt fuer Stadtplanung und Umwelt
27.04.2023 05:00;67;50;17;Leichter Nebel;3;3;0;Stadt Konstanz, Amt fuer Stadtplanung und Umwelt
27.04.2023 06:00;182;95;87;Leichter Nebel;3;3;0;Stadt Konstanz, Amt fuer Stadtplanung und Umwelt
27.04.2023 07:00;968;585;383;Leicht bewoelkt;7;7;0;Stadt Konstanz, Amt fuer Stadtplanung und Umwelt
27.04.2023 08:00;826;448;378;Bewoelkt;9;9;0;Stadt Konstanz, Amt fuer Stadtplanung und Umwelt
27.04.2023 09:00;783;438;345;Leicht bewoelkt;11;11;0;Stadt Konstanz, Amt fuer Stadtplanung und Umwelt
27.04.2023 10:00;504;278;226;Leicht bewoelkt;14;14;0;Stadt Konstanz, Amt fuer Stadtplanung und Umwelt
27.04.2023 11:00;644;324;320;Bewoelkt;15;15;0;Stadt Konstanz, Amt fuer Stadtplanung und Umwelt
27.04.2023 12:00;710;314;396;Leicht bewoelkt;16;16;0;Stadt Konstanz, Amt fuer Stadtplanung und Umwelt
27.04.2023 13:00;954;411;543;Leicht bewoelkt;17;17;0;Stadt Konstanz, Amt fuer Stadtplanung und Umwelt
27.04.2023 14:00;708;338;370;Leicht bewoelkt;17;17;0;Stadt Konstanz, Amt fuer Stadtplanung und Umwelt
27.04.2023 15:00;976;487;489;Leicht bewoelkt;17;17;0;Stadt Konstanz, Amt fuer Stadtplanung und Umwelt
27.04.2023 16:00;1012;508;504;Leicht bewoelkt;17;17;0;Stadt Konstanz, Amt fuer Stadtplanung und Umwelt
27.04.2023 17:00;1147;512;635;Leicht bewoelkt;17;17;0;Stadt Konstanz, Amt fuer Stadtplanung und Umwelt
27.04.2023 18:00;965;439;526;Leicht bewoelkt;15;15;0;Stadt Konstanz, Amt fuer Stadtplanung und Umwelt
27.04.2023 19:00;769;364;405;Leicht bewoelkt;12;12;0;Stadt Konstanz, Amt fuer Stadtplanung und Umwelt
27.04.2023 20:00;552;211;341;Bedeckt;9;9;0;Stadt Konstanz, Amt fuer Stadtplanung und Umwelt
27.04.2023 21:00;327;122;205;Bedeckt;9;8;0;Stadt Konstanz, Amt fuer Stadtplanung und Umwelt
27.04.2023 22:00;249;88;161;Bedeckt;9;9;0;Stadt Konstanz, Amt fuer Stadtplanung und Umwelt
27.04.2023 23:00;158;65;93;Bedeckt;9;9;0;Stadt Konstanz, Amt fuer Stadtplanung und Umwelt
28.04.2023 00:00;88;30;58;Leicht bewoelkt;7;7;0;Stadt Konstanz, Amt fuer Stadtplanung und Umwelt
28.04.2023 01:00;50;8;42;Leicht bewoelkt;7;7;0;Stadt Konstanz, Amt fuer Stadtplanung und Umwelt
28.04.2023 02:00;13;5;8;Leicht bewoelkt;6;6;0;Stadt Konstanz, Amt fuer Stadtplanung und Umwelt
28.04.2023 03:00;10;4;6;Bedeckt;7;7;0;Stadt Konstanz, Amt fuer Stadtplanung und Umwelt
28.04.2023 04:00;9;7;2;Bedeckt;7;7;0;Stadt Konstanz, Amt fuer Stadtplanung und Umwelt
28.04.2023 05:00;36;23;13;Bedeckt;8;8;0;Stadt Konstanz, Amt fuer Stadtplanung und Umwelt
28.04.2023 06:00;121;66;55;Bedeckt;8;8;0;Stadt Konstanz, Amt fuer Stadtplanung und Umwelt
28.04.2023 07:00;475;274;201;Bedeckt;9;9;0;Stadt Konstanz, Amt fuer Stadtplanung und Umwelt
28.04.2023 08:00;455;257;198;Nieselregen;10;10;0.6;Stadt Konstanz, Amt fuer Stadtplanung und Umwelt
28.04.2023 09:00;364;220;144;Nieselregen;10;10;0.4;Stadt Konstanz, Amt fuer Stadtplanung und Umwelt
28.04.2023 10:00;191;101;90;Leichter Regenfall;11;11;1.5;Stadt Konstanz, Amt fuer Stadtplanung und Umwelt
28.04.2023 11:00;323;175;148;Nieselregen;10;10;0.6;Stadt Konstanz, Amt fuer Stadtplanung und Umwelt
28.04.2023 12:00;428;177;251;Leichter Regenfall;11;10;1;Stadt Konstanz, Amt fuer Stadtplanung und Umwelt
28.04.2023 13:00;490;183;307;Maeßiger Regenfall;11;10;5.3;Stadt Konstanz, Amt fuer Stadtplanung und Umwelt
28.04.2023 14:00;407;195;212;Leichter Regenfall;11;10;0.9;Stadt Konstanz, Amt fuer Stadtplanung und Umwelt
28.04.2023 15:00;496;230;266;Nieselregen;12;11;0.3;Stadt Konstanz, Amt fuer Stadtplanung und Umwelt
28.04.2023 16:00;523;265;258;Leichter Regenfall;13;11;1.5;Stadt Konstanz, Amt fuer Stadtplanung und Umwelt
28.04.2023 17:00;515;230;285;Stellenweiser Regenfall;13;12;0.1;Stadt Konstanz, Amt fuer Stadtplanung und Umwelt
28.04.2023 18:00;527;252;275;Nieselregen;12;11;0.3;Stadt Konstanz, Amt fuer Stadtplanung und Umwelt
28.04.2023 19:00;424;190;234;Leichter Nebel;11;10;0;Stadt Konstanz, Amt fuer Stadtplanung und Umwelt
28.04.2023 20:00;271;132;139;Nebel;11;10;0.1;Stadt Konstanz, Amt fuer Stadtplanung und Umwelt
28.04.2023 21:00;259;129;130;Nebel;9;9;0;Stadt Konstanz, Amt fuer Stadtplanung und Umwelt
28.04.2023 22:00;233;97;136;Leichter Regenschauer;9;9;0.2;Stadt Konstanz, Amt fuer Stadtplanung und Umwelt
28.04.2023 23:00;170;71;99;Nebel;9;9;0;Stadt Konstanz, Amt fuer Stadtplanung und Umwelt
29.04.2023 00:00;144;47;97;Leichter Regenschauer;8;8;0.2;Stadt Konstanz, Amt fuer Stadtplanung und Umwelt
29.04.2023 01:00;71;22;49;Leichter Regenschauer;8;8;0.8;Stadt Konstanz, Amt fuer Stadtplanung und Umwelt
29.04.2023 02:00;59;34;25;Nebel;8;8;0.1;Stadt Konstanz, Amt fuer Stadtplanung und Umwelt
29.04.2023 03:00;59;26;33;Nebel;8;8;0;Stadt Konstanz, Amt fuer Stadtplanung und Umwelt
29.04.2023 04:00;34;16;18;Nebel;9;9;0.1;Stadt Konstanz, Amt fuer Stadtplanung und Umwelt
29.04.2023 05:00;24;21;3;Nebel;9;9;0;Stadt Konstanz, Amt fuer Stadtplanung und Umwelt
29.04.2023 06:00;42;30;12;Bedeckt;10;10;0;Stadt Konstanz, Amt fuer Stadtplanung und Umwelt
29.04.2023 07:00;104;48;56;Bedeckt;11;11;0;Stadt Konstanz, Amt fuer Stadtplanung und Umwelt
29.04.2023 08:00;196;102;94;Bedeckt;12;12;0;Stadt Konstanz, Amt fuer Stadtplanung und Umwelt
29.04.2023 09:00;504;290;214;Bedeckt;12;12;0;Stadt Konstanz, Amt fuer Stadtplanung und Umwelt
29.04.2023 10:00;577;280;297;Bewoelkt;14;14;0;Stadt Konstanz, Amt fuer Stadtplanung und Umwelt
29.04.2023 11:00;704;381;323;Bedeckt;16;16;0;Stadt Konstanz, Amt fuer Stadtplanung und Umwelt
29.04.2023 12:00;720;367;353;Leicht bewoelkt;18;18;0;Stadt Konstanz, Amt fuer Stadtplanung und Umwelt
29.04.2023 13:00;753;390;363;Leicht bewoelkt;20;20;0;Stadt Konstanz, Amt fuer Stadtplanung und Umwelt
29.04.2023 14:00;907;457;450;Bewoelkt;20;20;0;Stadt Konstanz, Amt fuer Stadtplanung und Umwelt
29.04.2023 15:00;616;301;315;Leicht bewoelkt;19;19;0;Stadt Konstanz, Amt fuer Stadtplanung und Umwelt
29.04.2023 16:00;664;288;376;Leicht bewoelkt;19;19;0;Stadt Konstanz, Amt fuer Stadtplanung und Umwelt
29.04.2023 17:00;589;258;331;Leicht bewoelkt;18;18;0;Stadt Konstanz, Amt fuer Stadtplanung und Umwelt
29.04.2023 18:00;513;231;282;Bedeckt;16;16;0;Stadt Konstanz, Amt fuer Stadtplanung und Umwelt
29.04.2023 19:00;400;182;218;Leichter Regenschauer;13;13;0.4;Stadt Konstanz, Amt fuer Stadtplanung und Umwelt
29.04.2023 20:00;405;187;218;Leichter Regenschauer;12;11;0.5;Stadt Konstanz, Amt fuer Stadtplanung und Umwelt
29.04.2023 21:00;357;198;159;Leichter Regenschauer;11;11;0.4;Stadt Konstanz, Amt fuer Stadtplanung und Umwelt
29.04.2023 22:00;199;89;110;Leichter Regenschauer;11;11;0.9;Stadt Konstanz, Amt fuer Stadtplanung und Umwelt
29.04.2023 23:00;198;67;131;Leichter Regenschauer;11;10;0.3;Stadt Konstanz, Amt fuer Stadtplanung und Umwelt
30.04.2023 00:00;155;44;111;Sonnig;7;6;0;Stadt Konstanz, Amt fuer Stadtplanung und Umwelt
30.04.2023 01:00;121;39;82;Leichter Nebel;7;6;0;Stadt Konstanz, Amt fuer Stadtplanung und Umwelt
30.04.2023 02:00;102;33;69;Sonnig;7;5;0;Stadt Konstanz, Amt fuer Stadtplanung und Umwelt
30.04.2023 03:00;81;27;54;Sonnig;6;5;0;Stadt Konstanz, Amt fuer Stadtplanung und Umwelt
30.04.2023 04:00;19;8;11;Leichter Nebel;6;5;0;Stadt Konstanz, Amt fuer Stadtplanung und Umwelt
30.04.2023 05:00;32;21;11;Leichter Nebel;6;5;0;Stadt Konstanz, Amt fuer Stadtplanung und Umwelt
30.04.2023 06:00;39;25;14;Leicht bewoelkt;7;5;0;Stadt Konstanz, Amt fuer Stadtplanung und Umwelt
30.04.2023 07:00;31;18;13;Leicht bewoelkt;9;8;0;Stadt Konstanz, Amt fuer Stadtplanung und Umwelt
30.04.2023 08:00;91;40;51;Leicht bewoelkt;11;10;0;Stadt Konstanz, Amt fuer Stadtplanung und Umwelt
30.04.2023 09:00;236;134;102;Bedeckt;13;11;0;Stadt Konstanz, Amt fuer Stadtplanung und Umwelt
30.04.2023 10:00;348;198;150;Bedeckt;14;13;0;Stadt Konstanz, Amt fuer Stadtplanung und Umwelt
30.04.2023 11:00;518;213;305;Bedeckt;14;13;0;Stadt Konstanz, Amt fuer Stadtplanung und Umwelt
30.04.2023 12:00;524;289;235;Bedeckt;14;13;0;Stadt Konstanz, Amt fuer Stadtplanung und Umwelt
30.04.2023 13:00;541;237;304;Bedeckt;15;14;0;Stadt Konstanz, Amt fuer Stadtplanung und Umwelt
30.04.2023 14:00;604;297;307;Stellenweiser Regenfall;15;14;0.1;Stadt Konstanz, Amt fuer Stadtplanung und Umwelt
30.04.2023 15:00;644;323;321;Bewoelkt;15;15;0;Stadt Konstanz, Amt fuer Stadtplanung und Umwelt
30.04.2023 16:00;569;284;285;Stellenweiser Regenfall;15;14;0.1;Stadt Konstanz, Amt fuer Stadtplanung und Umwelt
30.04.2023 17:00;533;266;267;Bewoelkt;15;14;0;Stadt Konstanz, Amt fuer Stadtplanung und Umwelt
30.04.2023 18:00;410;195;215;Leicht bewoelkt;14;14;0;Stadt Konstanz, Amt fuer Stadtplanung und Umwelt
30.04.2023 19:00;337;158;179;Bewoelkt;11;10;0;Stadt Konstanz, Amt fuer Stadtplanung und Umwelt
30.04.2023 20:00;310;158;152;Bewoelkt;9;8;0;Stadt Konstanz, Amt fuer Stadtplanung und Umwelt
30.04.2023 21:00;214;101;113;Bewoelkt;8;7;0;Stadt Konstanz, Amt fuer Stadtplanung und Umwelt
30.04.2023 22:00;179;61;118;Stellenweiser Regenfall;8;7;0.1;Stadt Konstanz, Amt fuer Stadtplanung und Umwelt
30.04.2023 23:00;154;58;96;Leichter Nebel;8;6;0;Stadt Konstanz, Amt fuer Stadtplanung und Umwelt
01.05.2023 00:00;120;37;83;Leicht bewoelkt;9;8;0;Stadt Konstanz, Amt fuer Stadtplanung und Umwelt
01.05.2023 01:00;88;20;68;Bedeckt;9;7;0;Stadt Konstanz, Amt fuer Stadtplanung und Umwelt
01.05.2023 02:00;28;12;16;Bedeckt;8;6;0;Stadt Konstanz, Amt fuer Stadtplanung und Umwelt
01.05.2023 03:00;20;6;14;Bedeckt;7;6;0;Stadt Konstanz, Amt fuer Stadtplanung und Umwelt
01.05.2023 04:00;16;9;7;Bewoelkt;7;6;0;Stadt Konstanz, Amt fuer Stadtplanung und Umwelt
01.05.2023 05:00;23;14;9;Bewoelkt;7;5;0;Stadt Konstanz, Amt fuer Stadtplanung und Umwelt
01.05.2023 06:00;29;16;13;Bewoelkt;7;6;0;Stadt Konstanz, Amt fuer Stadtplanung und Umwelt
01.05.2023 07:00;35;22;13;Bewoelkt;9;7;0;Stadt Konstanz, Amt fuer Stadtplanung und Umwelt
01.05.2023 08:00;58;32;26;Bedeckt;10;9;0;Stadt Konstanz, Amt fuer Stadtplanung und Umwelt
01.05.2023 09:00;125;70;55;Bedeckt;11;12;0;Stadt Konstanz, Amt fuer Stadtplanung und Umwelt
01.05.2023 10:00;170;83;87;Bedeckt;13;13;0;Stadt Konstanz, Amt fuer Stadtplanung und Umwelt
01.05.2023 11:00;229;110;119;Bedeckt;13;13;0;Stadt Konstanz, Amt fuer Stadtplanung und Umwelt
01.05.2023 12:00;198;74;124;Bedeckt;14;14;0;Stadt Konstanz, Amt fuer Stadtplanung und Umwelt
01.05.2023 13:00;231;116;115;Stellenweiser Regenfall;14;15;0.1;Stadt Konstanz, Amt fuer Stadtplanung und Umwelt
01.05.2023 14:00;261;119;142;Stellenweiser Regenfall;14;15;0.1;Stadt Konstanz, Amt fuer Stadtplanung und Umwelt
01.05.2023 15:00;154;70;84;Stellenweiser Regenfall;13;14;0.1;Stadt Konstanz, Amt fuer Stadtplanung und Umwelt
01.05.2023 16:00;260;130;130;Leichter Regenschauer;12;12;0.3;Stadt Konstanz, Amt fuer Stadtplanung und Umwelt
01.05.2023 17:00;239;139;100;Bedeckt;12;12;0;Stadt Konstanz, Amt fuer Stadtplanung und Umwelt
01.05.2023 18:00;255;107;148;Stellenweiser Regenfall;12;12;0.1;Stadt Konstanz, Amt fuer Stadtplanung und Umwelt
01.05.2023 19:00;147;78;69;Leichter Regenschauer;11;11;0.5;Stadt Konstanz, Amt fuer Stadtplanung und Umwelt
01.05.2023 20:00;132;53;79;Stellenweiser Regenfall;9;9;0.1;Stadt Konstanz, Amt fuer Stadtplanung und Umwelt
01.05.2023 21:00;116;57;59;Leichter Nebel;8;8;0;Stadt Konstanz, Amt fuer Stadtplanung und Umwelt
01.05.2023 22:00;92;51;41;Leichter Nebel;7;7;0.1;Stadt Konstanz, Amt fuer Stadtplanung und Umwelt
01.05.2023 23:00;60;20;40;Leichter Nebel;7;6;0;Stadt Konstanz, Amt fuer Stadtplanung und Umwelt
02.05.2023 00:00;28;14;14;Stellenweiser Regenfall;7;7;0.2;Stadt Konstanz, Amt fuer Stadtplanung und Umwelt
02.05.2023 01:00;12;8;4;Leichter Regenschauer;6;6;1.1;Stadt Konstanz, Amt fuer Stadtplanung und Umwelt
02.05.2023 02:00;5;4;1;Leichter Nebel;6;6;0;Stadt Konstanz, Amt fuer Stadtplanung und Umwelt
02.05.2023 03:00;2;0;2;Leichter Nebel;7;7;0;Stadt Konstanz, Amt fuer Stadtplanung und Umwelt
02.05.2023 04:00;10;6;4;Leichter Nebel;6;6;0;Stadt Konstanz, Amt fuer Stadtplanung und Umwelt
02.05.2023 05:00;48;33;15;Leichter Nebel;5;5;0;Stadt Konstanz, Amt fuer Stadtplanung und Umwelt
02.05.2023 06:00;196;95;101;Leichter Nebel;6;6;0;Stadt Konstanz, Amt fuer Stadtplanung und Umwelt
02.05.2023 07:00;975;625;350;Leicht bewoelkt;9;9;0;Stadt Konstanz, Amt fuer Stadtplanung und Umwelt
02.05.2023 08:00;759;399;360;Leicht bewoelkt;11;11;0;Stadt Konstanz, Amt fuer Stadtplanung und Umwelt
02.05.2023 09:00;734;409;325;Leicht bewoelkt;12;12;0;Stadt Konstanz, Amt fuer Stadtplanung und Umwelt
02.05.2023 10:00;490;256;234;Stellenweiser Regenfall;14;14;0.1;Stadt Konstanz, Amt fuer Stadtplanung und Umwelt
02.05.2023 11:00;634;290;344;Leicht bewoelkt;15;15;0;Stadt Konstanz, Amt fuer Stadtplanung und Umwelt
02.05.2023 12:00;676;291;385;Stellenweiser Regenfall;17;17;0.1;Stadt Konstanz, Amt fuer Stadtplanung und Umwelt
02.05.2023 13:00;972;399;573;Stellenweiser Regenfall;18;18;0.1;Stadt Konstanz, Amt fuer Stadtplanung und Umwelt
02.05.2023 14:00;623;323;300;Sonnig;18;18;0;Stadt Konstanz, Amt fuer Stadtplanung und Umwelt
02.05.2023 15:00;956;472;484;Sonnig;17;17;0;Stadt Konstanz, Amt fuer Stadtplanung und Umwelt
02.05.2023 16:00;942;407;535;Stellenweiser Regenfall;17;17;0.1;Stadt Konstanz, Amt fuer Stadtplanung und Umwelt
02.05.2023 17:00;1138;515;623;Sonnig;16;16;0;Stadt Konstanz, Amt fuer Stadtplanung und Umwelt
02.05.2023 18:00;886;398;488;Sonnig;15;15;0;Stadt Konstanz, Amt fuer Stadtplanung und Umwelt
02.05.2023 19:00;653;309;344;Sonnig;11;11;0;Stadt Konstanz, Amt fuer Stadtplanung und Umwelt
02.05.2023 20:00;445;172;273;Sonnig;8;7;0;Stadt Konstanz, Amt fuer Stadtplanung und Umwelt
02.05.2023 21:00;284;115;169;Leicht bewoelkt;8;7;0;Stadt Konstanz, Amt fuer Stadtplanung und Umwelt
02.05.2023 22:00;233;102;131;Leicht bewoelkt;7;6;0;Stadt Konstanz, Amt fuer Stadtplanung und Umwelt
02.05.2023 23:00;120;49;71;Sonnig;7;5;0;Stadt Konstanz, Amt fuer Stadtplanung und Umwelt
03.05.2023 00:00;54;24;30;Leicht bewoelkt;7;6;0;Stadt Konstanz, Amt fuer Stadtplanung und Umwelt
03.05.2023 01:00;19;13;6;Leicht bewoelkt;7;5;0;Stadt Konstanz, Amt fuer Stadtplanung und Umwelt
03.05.2023 02:00;6;4;2;Sonnig;5;3;0;Stadt Konstanz, Amt fuer Stadtplanung und Umwelt
03.05.2023 03:00;4;2;2;Leichter Nebel;3;1;0;Stadt Konstanz, Amt fuer Stadtplanung und Umwelt
03.05.2023 04:00;14;6;8;Leichter Nebel;3;0;0;Stadt Konstanz, Amt fuer Stadtplanung und Umwelt
03.05.2023 05:00;60;37;23;Nebel;2;0;0;Stadt Konstanz, Amt fuer Stadtplanung und Umwelt
03.05.2023 06:00;187;89;98;Leichter Nebel;4;1;0;Stadt Konstanz, Amt fuer Stadtplanung und Umwelt
03.05.2023 07:00;1110;674;436;Sonnig;6;4;0;Stadt Konstanz, Amt fuer Stadtplanung und Umwelt
03.05.2023 08:00;944;526;418;Leicht bewoelkt;9;6;0;Stadt Konstanz, Amt fuer Stadtplanung und Umwelt
03.05.2023 09:00;783;432;351;Leicht bewoelkt;11;9;0;Stadt Konstanz, Amt fuer Stadtplanung und Umwelt
03.05.2023 10:00;559;300;259;Bewoelkt;12;11;0;Stadt Konstanz, Amt fuer Stadtplanung und Umwelt
03.05.2023 11:00;691;312;379;Bewoelkt;13;12;0;Stadt Konstanz, Amt fuer Stadtplanung und Umwelt
03.05.2023 12:00;801;341;460;Leicht bewoelkt;14;13;0;Stadt Konstanz, Amt fuer Stadtplanung und Umwelt
03.05.2023 13:00;1064;511;553;Sonnig;16;16;0;Stadt Konstanz, Amt fuer Stadtplanung und Umwelt
03.05.2023 14:00;865;427;438;Sonnig;16;16;0;Stadt Konstanz, Amt fuer Stadtplanung und Umwelt
03.05.2023 15:00;1057;487;570;Sonnig;16;16;0;Stadt Konstanz, Amt fuer Stadtplanung und Umwelt
03.05.2023 16:00;1091;505;586;Sonnig;16;16;0;Stadt Konstanz, Amt fuer Stadtplanung und Umwelt
03.05.2023 17:00;1251;591;660;Sonnig;18;18;0;Stadt Konstanz, Amt fuer Stadtplanung und Umwelt
03.05.2023 18:00;1180;539;641;Sonnig;17;17;0;Stadt Konstanz, Amt fuer Stadtplanung und Umwelt
03.05.2023 19:00;843;375;468;Sonnig;13;12;0;Stadt Konstanz, Amt fuer Stadtplanung und Umwelt
03.05.2023 20:00;680;363;317;Sonnig;8;6;0;Stadt Konstanz, Amt fuer Stadtplanung und Umwelt
03.05.2023 21:00;507;239;268;Bewoelkt;6;4;0;Stadt Konstanz, Amt fuer Stadtplanung und Umwelt
03.05.2023 22:00;385;161;224;Bedeckt;5;3;0;Stadt Konstanz, Amt fuer Stadtplanung und Umwelt
03.05.2023 23:00;200;58;142;Bedeckt;5;3;0;Stadt Konstanz, Amt fuer Stadtplanung und Umwelt
04.05.2023 00:00;90;25;65;Leichter Nebel;5;3;0;Stadt Konstanz, Amt fuer Stadtplanung und Umwelt
04.05.2023 01:00;31;11;20;Leichter Nebel;5;3;0;Stadt Konstanz, Amt fuer Stadtplanung und Umwelt
04.05.2023 02:00;21;8;13;Leicht bewoelkt;4;3;0;Stadt Konstanz, Amt fuer Stadtplanung und Umwelt
04.05.2023 03:00;19;16;3;Bewoelkt;4;3;0;Stadt Konstanz, Amt fuer Stadtplanung und Umwelt
04.05.2023 04:00;13;9;4;Sonnig;4;3;0;Stadt Konstanz, Amt fuer Stadtplanung und Umwelt
04.05.2023 05:00;63;40;23;Leichter Nebel;3;2;0;Stadt Konstanz, Amt fuer Stadtplanung und Umwelt
04.05.2023 06:00;228;126;102;Sonnig;5;4;0;Stadt Konstanz, Amt fuer Stadtplanung und Umwelt
04.05.2023 07:00;1124;694;430;Sonnig;8;8;0;Stadt Konstanz, Amt fuer Stadtplanung und Umwelt
04.05.2023 08:00;880;498;382;Sonnig;11;11;0;Stadt Konstanz, Amt fuer Stadtplanung und Umwelt
04.05.2023 09:00;875;453;422;Sonnig;13;13;0;Stadt Konstanz, Amt fuer Stadtplanung und Umwelt
04.05.2023 10:00;601;316;285;Sonnig;15;15;0;Stadt Konstanz, Amt fuer Stadtplanung und Umwelt
04.05.2023 11:00;758;400;358;Bewoelkt;18;18;0;Stadt Konstanz, Amt fuer Stadtplanung und Umwelt
04.05.2023 12:00;769;319;450;Sonnig;19;19;0;Stadt Konstanz, Amt fuer Stadtplanung und Umwelt
04.05.2023 13:00;1051;418;633;Sonnig;22;22;0;Stadt Konstanz, Amt fuer Stadtplanung und Umwelt
04.05.2023 14:00;805;392;413;Sonnig;23;25;0;Stadt Konstanz, Amt fuer Stadtplanung und Umwelt
04.05.2023 15:00;1167;575;592;Sonnig;23;25;0;Stadt Konstanz, Amt fuer Stadtplanung und Umwelt
04.05.2023 16:00;1159;591;568;Sonnig;23;25;0;Stadt Konstanz, Amt fuer Stadtplanung und Umwelt
04.05.2023 17:00;1331;627;704;Sonnig;23;25;0;Stadt Konstanz, Amt fuer Stadtplanung und Umwelt
04.05.2023 18:00;1180;550;630;Sonnig;20;20;0;Stadt Konstanz, Amt fuer Stadtplanung und Umwelt
04.05.2023 19:00;800;386;414;Sonnig;15;15;0;Stadt Konstanz, Amt fuer Stadtplanung und Umwelt
04.05.2023 20:00;646;278;368;Sonnig;11;11;0;Stadt Konstanz, Amt fuer Stadtplanung und Umwelt
04.05.2023 21:00;482;203;279;Leichter Nebel;10;10;0;Stadt Konstanz, Amt fuer Stadtplanung und Umwelt
04.05.2023 22:00;415;185;230;Leichter Nebel;9;9;0;Stadt Konstanz, Amt fuer Stadtplanung und Umwelt
04.05.2023 23:00;213;80;133;Sonnig;9;9;0;Stadt Konstanz, Amt fuer Stadtplanung und Umwelt
05.05.2023 00:00;94;26;68;Sonnig;9;9;0;Stadt Konstanz, Amt fuer Stadtplanung und Umwelt
05.05.2023 01:00;37;13;24;Leicht bewoelkt;9;9;0;Stadt Konstanz, Amt fuer Stadtplanung und Umwelt
05.05.2023 02:00;16;6;10;Leicht bewoelkt;9;9;0;Stadt Konstanz, Amt fuer Stadtplanung und Umwelt
05.05.2023 03:00;9;4;5;Sonnig;8;8;0;Stadt Konstanz, Amt fuer Stadtplanung und Umwelt
05.05.2023 04:00;9;7;2;Sonnig;8;8;0;Stadt Konstanz, Amt fuer Stadtplanung und Umwelt
05.05.2023 05:00;58;39;19;Leicht bewoelkt;8;8;0;Stadt Konstanz, Amt fuer Stadtplanung und Umwelt
05.05.2023 06:00;201;111;90;Bedeckt;9;9;0;Stadt Konstanz, Amt fuer Stadtplanung und Umwelt
05.05.2023 07:00;883;544;339;Bedeckt;12;12;0;Stadt Konstanz, Amt fuer Stadtplanung und Umwelt
05.05.2023 08:00;826;482;344;Leicht bewoelkt;14;14;0;Stadt Konstanz, Amt fuer Stadtplanung und Umwelt
05.05.2023 09:00;766;450;316;Bedeckt;16;16;0;Stadt Konstanz, Amt fuer Stadtplanung und Umwelt
05.05.2023 10:00;607;326;281;Leicht bewoelkt;16;16;0;Stadt Konstanz, Amt fuer Stadtplanung und Umwelt
05.05.2023 11:00;792;392;400;Leicht bewoelkt;19;19;0;Stadt Konstanz, Amt fuer Stadtplanung und Umwelt
05.05.2023 12:00;891;380;511;Leicht bewoelkt;20;20;0;Stadt Konstanz, Amt fuer Stadtplanung und Umwelt
05.05.2023 13:00;1024;386;638;Stellenweise Gewitter und Niederschlaege;21;21;0;Stadt Konstanz, Amt fuer Stadtplanung und Umwelt
05.05.2023 14:00;828;394;434;Nieselregen mit Gewitter;22;22;0.2;Stadt Konstanz, Amt fuer Stadtplanung und Umwelt
05.05.2023 15:00;866;438;428;Stellenweise Gewitter und Niederschlaege;21;21;0;Stadt Konstanz, Amt fuer Stadtplanung und Umwelt
05.05.2023 16:00;933;431;502;Leichter Regenschauer;20;20;0.8;Stadt Konstanz, Amt fuer Stadtplanung und Umwelt
05.05.2023 17:00;922;444;478;Stellenweise Gewitter und Niederschlaege;19;19;0;Stadt Konstanz, Amt fuer Stadtplanung und Umwelt
05.05.2023 18:00;612;279;333;Stellenweiser Regenfall;17;17;0.4;Stadt Konstanz, Amt fuer Stadtplanung und Umwelt
05.05.2023 19:00;583;386;197;Sonnig;15;15;0;Stadt Konstanz, Amt fuer Stadtplanung und Umwelt
05.05.2023 20:00;418;259;159;Leicht bewoelkt;12;12;0;Stadt Konstanz, Amt fuer Stadtplanung und Umwelt
05.05.2023 21:00;400;180;220;Sonnig;11;11;0;Stadt Konstanz, Amt fuer Stadtplanung und Umwelt
05.05.2023 22:00;366;113;253;Leichter Nebel;11;10;0;Stadt Konstanz, Amt fuer Stadtplanung und Umwelt
05.05.2023 23:00;304;82;222;Leichter Nebel;10;10;0;Stadt Konstanz, Amt fuer Stadtplanung und Umwelt
06.05.2023 00:00;179;39;140;Leichter Nebel;11;11;0.1;Stadt Konstanz, Amt fuer Stadtplanung und Umwelt
06.05.2023 01:00;147;32;115;Leichter Nebel;10;11;0;Stadt Konstanz, Amt fuer Stadtplanung und Umwelt
06.05.2023 02:00;84;22;62;Leichter Nebel;11;11;0;Stadt Konstanz, Amt fuer Stadtplanung und Umwelt
06.05.2023 03:00;78;27;51;Bewoelkt;10;10;0;Stadt Konstanz, Amt fuer Stadtplanung und Umwelt
06.05.2023 04:00;29;13;16;Nebel;11;11;0.1;Stadt Konstanz, Amt fuer Stadtplanung und Umwelt
06.05.2023 05:00;30;15;15;Nebel;10;10;0;Stadt Konstanz, Amt fuer Stadtplanung und Umwelt
06.05.2023 06:00;54;31;23;Nebel;11;11;0;Stadt Konstanz, Amt fuer Stadtplanung und Umwelt
06.05.2023 07:00;107;51;56;Leichter Nebel;13;13;0;Stadt Konstanz, Amt fuer Stadtplanung und Umwelt
06.05.2023 08:00;262;145;117;Bewoelkt;14;14;0;Stadt Konstanz, Amt fuer Stadtplanung und Umwelt
06.05.2023 09:00;481;280;201;Leicht bewoelkt;16;16;0;Stadt Konstanz, Amt fuer Stadtplanung und Umwelt
06.05.2023 10:00;648;325;323;Stellenweiser Regenfall;18;18;0.1;Stadt Konstanz, Amt fuer Stadtplanung und Umwelt
06.05.2023 11:00;710;403;307;Leicht bewoelkt;21;21;0;Stadt Konstanz, Amt fuer Stadtplanung und Umwelt
06.05.2023 12:00;707;357;350;Stellenweiser Regenfall;22;22;0.1;Stadt Konstanz, Amt fuer Stadtplanung und Umwelt
06.05.2023 13:00;760;356;404;Stellenweise Gewitter und Niederschlaege;23;25;0;Stadt Konstanz, Amt fuer Stadtplanung und Umwelt
06.05.2023 14:00;813;366;447;Nieselregen mit Gewitter;22;25;0.3;Stadt Konstanz, Amt fuer Stadtplanung und Umwelt
06.05.2023 15:00;858;433;425;Sonnig;22;25;0;Stadt Konstanz, Amt fuer Stadtplanung und Umwelt
06.05.2023 16:00;744;358;386;Nieselregen mit Gewitter;22;22;0.6;Stadt Konstanz, Amt fuer Stadtplanung und Umwelt
06.05.2023 17:00;788;395;393;Sonnig;21;21;0;Stadt Konstanz, Amt fuer Stadtplanung und Umwelt
06.05.2023 18:00;731;316;415;Nieselregen mit Gewitter;18;18;0.2;Stadt Konstanz, Amt fuer Stadtplanung und Umwelt
06.05.2023 19:00;549;263;286;Stellenweise Gewitter und Niederschlaege;15;15;0;Stadt Konstanz, Amt fuer Stadtplanung und Umwelt
06.05.2023 20:00;533;242;291;Leicht bewoelkt;13;13;0;Stadt Konstanz, Amt fuer Stadtplanung und Umwelt
06.05.2023 21:00;402;161;241;Sonnig;12;12;0;Stadt Konstanz, Amt fuer Stadtplanung und Umwelt
06.05.2023 22:00;242;95;147;Sonnig;11;12;0;Stadt Konstanz, Amt fuer Stadtplanung und Umwelt
06.05.2023 23:00;267;71;196;Leichter Nebel;11;11;0;Stadt Konstanz, Amt fuer Stadtplanung und Umwelt
07.05.2023 00:00;183;51;132;Sonnig;10;9;0;Stadt Konstanz, Amt fuer Stadtplanung und Umwelt
07.05.2023 01:00;135;51;84;Leichter Nebel;10;9;0;Stadt Konstanz, Amt fuer Stadtplanung und Umwelt
07.05.2023 02:00;77;32;45;Leichter Nebel;9;9;0;Stadt Konstanz, Amt fuer Stadtplanung und Umwelt
07.05.2023 03:00;62;32;30;Leichter Nebel;9;9;0;Stadt Konstanz, Amt fuer Stadtplanung und Umwelt
07.05.2023 04:00;46;33;13;Leichter Nebel;9;9;0;Stadt Konstanz, Amt fuer Stadtplanung und Umwelt
07.05.2023 05:00;25;16;9;Leichter Nebel;8;8;0;Stadt Konstanz, Amt fuer Stadtplanung und Umwelt
07.05.2023 06:00;30;18;12;Leichter Nebel;9;9;0;Stadt Konstanz, Amt fuer Stadtplanung und Umwelt
07.05.2023 07:00;43;20;23;Leicht bewoelkt;13;13;0;Stadt Konstanz, Amt fuer Stadtplanung und Umwelt
07.05.2023 08:00;102;51;51;Sonnig;15;15;0;Stadt Konstanz, Amt fuer Stadtplanung und Umwelt
07.05.2023 09:00;332;157;175;Sonnig;17;17;0;Stadt Konstanz, Amt fuer Stadtplanung und Umwelt
07.05.2023 10:00;422;189;233;Sonnig;19;19;0;Stadt Konstanz, Amt fuer Stadtplanung und Umwelt
07.05.2023 11:00;514;233;281;Leicht bewoelkt;20;20;0;Stadt Konstanz, Amt fuer Stadtplanung und Umwelt
07.05.2023 12:00;546;288;258;Leicht bewoelkt;21;21;0;Stadt Konstanz, Amt fuer Stadtplanung und Umwelt
07.05.2023 13:00;654;319;335;Leichter Regenschauer;22;22;0.3;Stadt Konstanz, Amt fuer Stadtplanung und Umwelt
07.05.2023 14:00;621;313;308;Leichter Regenschauer;21;21;0.4;Stadt Konstanz, Amt fuer Stadtplanung und Umwelt
07.05.2023 15:00;632;328;304;Stellenweise Gewitter und Niederschlaege;20;20;0.1;Stadt Konstanz, Amt fuer Stadtplanung und Umwelt
07.05.2023 16:00;648;345;303;Leichter Regenschauer;18;18;2.5;Stadt Konstanz, Amt fuer Stadtplanung und Umwelt
07.05.2023 17:00;494;245;249;Stellenweiser Regenfall;16;16;0.1;Stadt Konstanz, Amt fuer Stadtplanung und Umwelt
07.05.2023 18:00;442;195;247;Leichter Regenschauer;16;16;0.8;Stadt Konstanz, Amt fuer Stadtplanung und Umwelt
07.05.2023 19:00;248;115;133;Bedeckt;14;14;0;Stadt Konstanz, Amt fuer Stadtplanung und Umwelt
07.05.2023 20:00;166;72;94;Leichter Regenschauer;13;13;1.1;Stadt Konstanz, Amt fuer Stadtplanung und Umwelt
07.05.2023 21:00;98;48;50;Nebel;13;13;0.1;Stadt Konstanz, Amt fuer Stadtplanung und Umwelt
07.05.2023 22:00;98;40;58;Maeßiger Regenfall;13;13;3.5;Stadt Konstanz, Amt fuer Stadtplanung und Umwelt
07.05.2023 23:00;57;21;36;Nebel;13;13;0.1;Stadt Konstanz, Amt fuer Stadtplanung und Umwelt
08.05.2023 00:00;17;8;9;Maeßiger Regenfall;12;12;2.6;Stadt Konstanz, Amt fuer Stadtplanung und Umwelt
08.05.2023 01:00;9;4;5;Starker Regenfall;12;12;9.2;Stadt Konstanz, Amt fuer Stadtplanung und Umwelt
08.05.2023 02:00;3;2;1;Nieselregen;12;12;0.4;Stadt Konstanz, Amt fuer Stadtplanung und Umwelt
08.05.2023 03:00;3;1;2;Nebel;12;12;0;Stadt Konstanz, Amt fuer Stadtplanung und Umwelt
08.05.2023 04:00;5;4;1;Leichter Regenfall;12;12;1;Stadt Konstanz, Amt fuer Stadtplanung und Umwelt
08.05.2023 05:00;50;34;16;Nebel;12;12;0;Stadt Konstanz, Amt fuer Stadtplanung und Umwelt
08.05.2023 06:00;172;91;81;Leichter Regenschauer;12;12;0.3;Stadt Konstanz, Amt fuer Stadtplanung und Umwelt
08.05.2023 07:00;904;541;363;Nebel;12;12;0;Stadt Konstanz, Amt fuer Stadtplanung und Umwelt
08.05.2023 08:00;774;418;356;Nieselregen;12;12;0.6;Stadt Konstanz, Amt fuer Stadtplanung und Umwelt
08.05.2023 09:00;748;440;308;Nieselregen;12;12;0.3;Stadt Konstanz, Amt fuer Stadtplanung und Umwelt
08.05.2023 10:00;372;185;187;Leichter Regenfall;12;12;1.7;Stadt Konstanz, Amt fuer Stadtplanung und Umwelt
08.05.2023 11:00;595;265;330;Nieselregen;13;13;0.2;Stadt Konstanz, Amt fuer Stadtplanung und Umwelt
08.05.2023 12:00;584;281;303;Nieselregen;13;13;0.4;Stadt Konstanz, Amt fuer Stadtplanung und Umwelt
08.05.2023 13:00;870;385;485;Leichter Regenfall;13;13;0.9;Stadt Konstanz, Amt fuer Stadtplanung und Umwelt
08.05.2023 14:00;578;300;278;Leichter Nebel;14;14;0;Stadt Konstanz, Amt fuer Stadtplanung und Umwelt
08.05.2023 15:00;961;469;492;Bedeckt;14;15;0;Stadt Konstanz, Amt fuer Stadtplanung und Umwelt
08.05.2023 16:00;798;350;448;Stellenweiser Regenfall;15;15;0.1;Stadt Konstanz, Amt fuer Stadtplanung und Umwelt
08.05.2023 17:00;1018;434;584;Bedeckt;15;15;0;Stadt Konstanz, Amt fuer Stadtplanung und Umwelt
08.05.2023 18:00;844;412;432;Bewoelkt;15;15;0;Stadt Konstanz, Amt fuer Stadtplanung und Umwelt
08.05.2023 19:00;642;277;365;Leicht bewoelkt;13;13;0;Stadt Konstanz, Amt fuer Stadtplanung und Umwelt
08.05.2023 20:00;487;199;288;Leichter Nebel;11;11;0;Stadt Konstanz, Amt fuer Stadtplanung und Umwelt
08.05.2023 21:00;335;133;202;Leichter Nebel;10;10;0;Stadt Konstanz, Amt fuer Stadtplanung und Umwelt
08.05.2023 22:00;259;101;158;Leichter Nebel;9;10;0;Stadt Konstanz, Amt fuer Stadtplanung und Umwelt
08.05.2023 23:00;106;60;46;Leichter Nebel;9;9;0;Stadt Konstanz, Amt fuer Stadtplanung und Umwelt
09.05.2023 00:00;49;25;24;Nebel;11;11;0;Stadt Konstanz, Amt fuer Stadtplanung und Umwelt
09.05.2023 01:00;21;4;17;Nebel;10;10;0;Stadt Konstanz, Amt fuer Stadtplanung und Umwelt
09.05.2023 02:00;13;9;4;Nebel;10;10;0;Stadt Konstanz, Amt fuer Stadtplanung und Umwelt
09.05.2023 03:00;6;1;5;Nebel;10;10;0;Stadt Konstanz, Amt fuer Stadtplanung und Umwelt
09.05.2023 04:00;12;8;4;Nebel;10;10;0;Stadt Konstanz, Amt fuer Stadtplanung und Umwelt
09.05.2023 05:00;65;40;25;Nebel;10;10;0;Stadt Konstanz, Amt fuer Stadtplanung und Umwelt
09.05.2023 06:00;204;110;94;Nebel;10;11;0;Stadt Konstanz, Amt fuer Stadtplanung und Umwelt
09.05.2023 07:00;1105;672;433;Nebel;12;12;0.1;Stadt Konstanz, Amt fuer Stadtplanung und Umwelt
09.05.2023 08:00;897;490;407;Leichter Nebel;13;13;0;Stadt Konstanz, Amt fuer Stadtplanung und Umwelt
09.05.2023 09:00;935;566;369;Bedeckt;14;14;0;Stadt Konstanz, Amt fuer Stadtplanung und Umwelt
09.05.2023 10:00;563;294;269;Bedeckt;15;15;0;Stadt Konstanz, Amt fuer Stadtplanung und Umwelt
09.05.2023 11:00;726;353;373;Bewoelkt;17;17;0;Stadt Konstanz, Amt fuer Stadtplanung und Umwelt
09.05.2023 12:00;721;337;384;Bedeckt;19;19;0;Stadt Konstanz, Amt fuer Stadtplanung und Umwelt
09.05.2023 13:00;994;418;576;Leicht bewoelkt;20;20;0;Stadt Konstanz, Amt fuer Stadtplanung und Umwelt
09.05.2023 14:00;828;400;428;Leicht bewoelkt;21;21;0;Stadt Konstanz, Amt fuer Stadtplanung und Umwelt
09.05.2023 15:00;1078;538;540;Leicht bewoelkt;21;21;0;Stadt Konstanz, Amt fuer Stadtplanung und Umwelt
09.05.2023 16:00;1007;471;536;Stellenweiser Regenfall;20;20;0.1;Stadt Konstanz, Amt fuer Stadtplanung und Umwelt
09.05.2023 17:00;1249;567;682;Leicht bewoelkt;18;18;0;Stadt Konstanz, Amt fuer Stadtplanung und Umwelt
09.05.2023 18:00;912;409;503;Leichter Regenschauer;14;14;0.2;Stadt Konstanz, Amt fuer Stadtplanung und Umwelt
09.05.2023 19:00;618;292;326;Nebel;13;12;0;Stadt Konstanz, Amt fuer Stadtplanung und Umwelt
09.05.2023 20:00;358;155;203;Leichter Regenfall;12;11;2;Stadt Konstanz, Amt fuer Stadtplanung und Umwelt
09.05.2023 21:00;278;115;163;Leichter Regenfall;12;11;1.9;Stadt Konstanz, Amt fuer Stadtplanung und Umwelt
09.05.2023 22:00;199;80;119;Maeßiger Regenfall;12;11;7.3;Stadt Konstanz, Amt fuer Stadtplanung und Umwelt
09.05.2023 23:00;136;54;82;Leichter Regenfall;12;11;1;Stadt Konstanz, Amt fuer Stadtplanung und Umwelt
10.05.2023 00:00;64;26;38;Leichter Regenfall;12;10;1.6;Stadt Konstanz, Amt fuer Stadtplanung und Umwelt
10.05.2023 01:00;39;6;33;Leichter Regenfall;11;9;1.6;Stadt Konstanz, Amt fuer Stadtplanung und Umwelt
10.05.2023 02:00;40;3;37;Bedeckt;11;9;0;Stadt Konstanz, Amt fuer Stadtplanung und Umwelt
10.05.2023 03:00;14;3;11;Bedeckt;10;8;0;Stadt Konstanz, Amt fuer Stadtplanung und Umwelt
10.05.2023 04:00;4;2;2;Nieselregen;10;9;0.3;Stadt Konstanz, Amt fuer Stadtplanung und Umwelt
10.05.2023 05:00;53;31;22;Nebel;10;9;0;Stadt Konstanz, Amt fuer Stadtplanung und Umwelt
10.05.2023 06:00;195;100;95;Nieselregen;10;9;0.5;Stadt Konstanz, Amt fuer Stadtplanung und Umwelt
10.05.2023 07:00;1051;678;373;Maeßiger Regenfall;10;9;5.2;Stadt Konstanz, Amt fuer Stadtplanung und Umwelt
10.05.2023 08:00;830;458;372;Leichter Regenfall;10;9;1.2;Stadt Konstanz, Amt fuer Stadtplanung und Umwelt
10.05.2023 09:00;740;401;339;Leichter Regenfall;10;9;1.9;Stadt Konstanz, Amt fuer Stadtplanung und Umwelt
10.05.2023 10:00;451;250;201;Maeßiger Regenfall;11;10;5.5;Stadt Konstanz, Amt fuer Stadtplanung und Umwelt
10.05.2023 11:00;584;273;311;Stellenweiser leichter Regenfall;12;11;1.3;Stadt Konstanz, Amt fuer Stadtplanung und Umwelt
10.05.2023 12:00;693;301;392;Leichter Regenschauer;12;12;1.3;Stadt Konstanz, Amt fuer Stadtplanung und Umwelt
10.05.2023 13:00;999;456;543;Maeßiger Regenfall;12;12;6.3;Stadt Konstanz, Amt fuer Stadtplanung und Umwelt
10.05.2023 14:00;690;342;348;Leichter Regenschauer;12;12;0.4;Stadt Konstanz, Amt fuer Stadtplanung und Umwelt
10.05.2023 15:00;1048;475;573;Leichter Regenschauer;13;13;0.4;Stadt Konstanz, Amt fuer Stadtplanung und Umwelt
10.05.2023 16:00;998;464;534;Leichter Regenschauer;13;14;1;Stadt Konstanz, Amt fuer Stadtplanung und Umwelt
10.05.2023 17:00;1202;493;709;Leichter Regenschauer;13;13;0.3;Stadt Konstanz, Amt fuer Stadtplanung und Umwelt
10.05.2023 18:00;1022;418;604;Leichter Regenschauer;11;11;0.3;Stadt Konstanz, Amt fuer Stadtplanung und Umwelt
10.05.2023 19:00;693;290;403;Leichter Regenschauer;10;10;1.5;Stadt Konstanz, Amt fuer Stadtplanung und Umwelt
10.05.2023 20:00;518;266;252;Leicht bewoelkt;9;9;0;Stadt Konstanz, Amt fuer Stadtplanung und Umwelt
10.05.2023 21:00;377;200;177;Bedeckt;9;9;0;Stadt Konstanz, Amt fuer Stadtplanung und Umwelt
10.05.2023 22:00;292;142;150;Stellenweiser Regenfall;8;8;0.1;Stadt Konstanz, Amt fuer Stadtplanung und Umwelt
10.05.2023 23:00;167;73;94;Bedeckt;8;8;0;Stadt Konstanz, Amt fuer Stadtplanung und Umwelt
11.05.2023 00:00;66;19;47;Bedeckt;8;8;0;Stadt Konstanz, Amt fuer Stadtplanung und Umwelt
11.05.2023 01:00;28;11;17;Bewoelkt;7;7;0;Stadt Konstanz, Amt fuer Stadtplanung und Umwelt
11.05.2023 02:00;17;10;7;Bedeckt;7;7;0;Stadt Konstanz, Amt fuer Stadtplanung und Umwelt
11.05.2023 03:00;10;5;5;Bedeckt;7;7;0;Stadt Konstanz, Amt fuer Stadtplanung und Umwelt
11.05.2023 04:00;9;3;6;Bedeckt;7;7;0;Stadt Konstanz, Amt fuer Stadtplanung und Umwelt
11.05.2023 05:00;52;36;16;Bedeckt;7;7;0;Stadt Konstanz, Amt fuer Stadtplanung und Umwelt
11.05.2023 06:00;190;99;91;Bedeckt;8;8;0;Stadt Konstanz, Amt fuer Stadtplanung und Umwelt
11.05.2023 07:00;958;580;378;Bedeckt;8;8;0;Stadt Konstanz, Amt fuer Stadtplanung und Umwelt
11.05.2023 08:00;729;388;341;Nieselregen;9;9;0.2;Stadt Konstanz, Amt fuer Stadtplanung und Umwelt
11.05.2023 09:00;733;423;310;Bedeckt;9;9;0;Stadt Konstanz, Amt fuer Stadtplanung und Umwelt
11.05.2023 10:00;420;207;213;Leichter Regenschauer;9;9;0.7;Stadt Konstanz, Amt fuer Stadtplanung und Umwelt
11.05.2023 11:00;601;333;268;Bedeckt;10;10;0;Stadt Konstanz, Amt fuer Stadtplanung und Umwelt
11.05.2023 12:00;551;234;317;Leichter Regenschauer;10;10;0.2;Stadt Konstanz, Amt fuer Stadtplanung und Umwelt
11.05.2023 13:00;802;296;506;Bedeckt;10;10;0;Stadt Konstanz, Amt fuer Stadtplanung und Umwelt
11.05.2023 14:00;528;252;276;Leichter Regenschauer;10;10;0.2;Stadt Konstanz, Amt fuer Stadtplanung und Umwelt
11.05.2023 15:00;751;333;418;Bedeckt;10;10;0;Stadt Konstanz, Amt fuer Stadtplanung und Umwelt
11.05.2023 16:00;724;362;362;Leichter Regenschauer;10;10;0.4;Stadt Konstanz, Amt fuer Stadtplanung und Umwelt
11.05.2023 17:00;889;440;449;Bewoelkt;11;11;0;Stadt Konstanz, Amt fuer Stadtplanung und Umwelt
11.05.2023 18:00;790;333;457;Stellenweiser Regenfall;11;11;0.1;Stadt Konstanz, Amt fuer Stadtplanung und Umwelt
11.05.2023 19:00;584;291;293;Bewoelkt;10;10;0;Stadt Konstanz, Amt fuer Stadtplanung und Umwelt
11.05.2023 20:00;446;209;237;Leichter Nebel;9;9;0.1;Stadt Konstanz, Amt fuer Stadtplanung und Umwelt
11.05.2023 21:00;341;157;184;Leichter Nebel;9;9;0;Stadt Konstanz, Amt fuer Stadtplanung und Umwelt
11.05.2023 22:00;300;83;217;Nieselregen;8;8;0.3;Stadt Konstanz, Amt fuer Stadtplanung und Umwelt
11.05.2023 23:00;187;51;136;Leichter Nebel;8;8;0;Stadt Konstanz, Amt fuer Stadtplanung und Umwelt
12.05.2023 00:00;105;36;69;Leichter Regenschauer;9;9;0.2;Stadt Konstanz, Amt fuer Stadtplanung und Umwelt
12.05.2023 01:00;73;15;58;Leichter Regenschauer;9;9;1;Stadt Konstanz, Amt fuer Stadtplanung und Umwelt
12.05.2023 02:00;22;5;17;Leichter Nebel;9;9;0;Stadt Konstanz, Amt fuer Stadtplanung und Umwelt
12.05.2023 03:00;16;5;11;Leichter Nebel;9;9;0;Stadt Konstanz, Amt fuer Stadtplanung und Umwelt
12.05.2023 04:00;10;4;6;Leichter Regenschauer;9;9;0.2;Stadt Konstanz, Amt fuer Stadtplanung und Umwelt
12.05.2023 05:00;54;34;20;Leichter Nebel;9;9;0;Stadt Konstanz, Amt fuer Stadtplanung und Umwelt
12.05.2023 06:00;187;103;84;Leichter Nebel;9;9;0.1;Stadt Konstanz, Amt fuer Stadtplanung und Umwelt
12.05.2023 07:00;925;547;378;Leichter Regenschauer;9;9;0.4;Stadt Konstanz, Amt fuer Stadtplanung und Umwelt
12.05.2023 08:00;741;422;319;Nieselregen;9;9;0.5;Stadt Konstanz, Amt fuer Stadtplanung und Umwelt
12.05.2023 09:00;746;434;312;Nieselregen;9;9;0.4;Stadt Konstanz, Amt fuer Stadtplanung und Umwelt
12.05.2023 10:00;557;304;253;Leichter Regenfall;10;10;1;Stadt Konstanz, Amt fuer Stadtplanung und Umwelt
12.05.2023 11:00;850;436;414;Stellenweiser Nieselregen;11;11;0.2;Stadt Konstanz, Amt fuer Stadtplanung und Umwelt
12.05.2023 12:00;843;385;458;Leichter Regenschauer;13;13;0.3;Stadt Konstanz, Amt fuer Stadtplanung und Umwelt
12.05.2023 13:00;980;352;628;Leichter Regenfall;14;14;1.1;Stadt Konstanz, Amt fuer Stadtplanung und Umwelt
12.05.2023 14:00;897;411;486;Leichter Regenschauer;15;15;0.3;Stadt Konstanz, Amt fuer Stadtplanung und Umwelt
12.05.2023 15:00;1002;473;529;Leichter Regenschauer;15;15;0.2;Stadt Konstanz, Amt fuer Stadtplanung und Umwelt
12.05.2023 16:00;836;439;397;Leichter Regenschauer;14;14;1;Stadt Konstanz, Amt fuer Stadtplanung und Umwelt
12.05.2023 17:00;1009;484;525;Stellenweiser Regenfall;14;14;0.2;Stadt Konstanz, Amt fuer Stadtplanung und Umwelt
12.05.2023 18:00;857;427;430;Stellenweiser Regenfall;13;13;0.4;Stadt Konstanz, Amt fuer Stadtplanung und Umwelt
12.05.2023 19:00;636;307;329;Stellenweiser Regenfall;11;11;1.6;Stadt Konstanz, Amt fuer Stadtplanung und Umwelt
12.05.2023 20:00;484;207;277;Stellenweiser Regenfall;9;7;0.2;Stadt Konstanz, Amt fuer Stadtplanung und Umwelt
12.05.2023 21:00;356;172;184;Leichter Nebel;7;6;0.1;Stadt Konstanz, Amt fuer Stadtplanung und Umwelt
12.05.2023 22:00;275;96;179;Leichter Regenschauer;7;6;0.2;Stadt Konstanz, Amt fuer Stadtplanung und Umwelt
12.05.2023 23:00;204;81;123;Leichter Nebel;6;5;0;Stadt Konstanz, Amt fuer Stadtplanung und Umwelt
13.05.2023 00:00;177;66;111;Nebel;6;5;0;Stadt Konstanz, Amt fuer Stadtplanung und Umwelt
13.05.2023 01:00;118;48;70;Nebel;6;5;0;Stadt Konstanz, Amt fuer Stadtplanung und Umwelt
13.05.2023 02:00;85;49;36;Nebel;6;4;0;Stadt Konstanz, Amt fuer Stadtplanung und Umwelt
13.05.2023 03:00;57;21;36;Nebel;5;4;0;Stadt Konstanz, Amt fuer Stadtplanung und Umwelt
13.05.2023 04:00;22;11;11;Nebel;6;5;0;Stadt Konstanz, Amt fuer Stadtplanung und Umwelt
13.05.2023 05:00;35;15;20;Bedeckt;7;7;0;Stadt Konstanz, Amt fuer Stadtplanung und Umwelt
13.05.2023 06:00;48;23;25;Bedeckt;8;9;0;Stadt Konstanz, Amt fuer Stadtplanung und Umwelt
13.05.2023 07:00;89;49;40;Stellenweiser Regenfall;9;9;0.1;Stadt Konstanz, Amt fuer Stadtplanung und Umwelt
13.05.2023 08:00;223;133;90;Bedeckt;9;9;0;Stadt Konstanz, Amt fuer Stadtplanung und Umwelt
13.05.2023 09:00;447;275;172;Bedeckt;10;9;0;Stadt Konstanz, Amt fuer Stadtplanung und Umwelt
13.05.2023 10:00;517;296;221;Stellenweiser Regenfall;10;9;0.1;Stadt Konstanz, Amt fuer Stadtplanung und Umwelt
13.05.2023 11:00;598;310;288;Bedeckt;11;10;0;Stadt Konstanz, Amt fuer Stadtplanung und Umwelt
13.05.2023 12:00;583;310;273;Bedeckt;12;11;0;Stadt Konstanz, Amt fuer Stadtplanung und Umwelt
13.05.2023 13:00;569;257;312;Bedeckt;13;12;0;Stadt Konstanz, Amt fuer Stadtplanung und Umwelt
13.05.2023 14:00;679;333;346;Bedeckt;14;13;0;Stadt Konstanz, Amt fuer Stadtplanung und Umwelt
13.05.2023 15:00;613;282;331;Bedeckt;14;13;0;Stadt Konstanz, Amt fuer Stadtplanung und Umwelt
13.05.2023 16:00;635;274;361;Bedeckt;13;12;0;Stadt Konstanz, Amt fuer Stadtplanung und Umwelt
13.05.2023 17:00;621;272;349;Bedeckt;13;12;0;Stadt Konstanz, Amt fuer Stadtplanung und Umwelt
13.05.2023 18:00;518;216;302;Bedeckt;12;11;0;Stadt Konstanz, Amt fuer Stadtplanung und Umwelt
13.05.2023 19:00;467;224;243;Bewoelkt;11;11;0;Stadt Konstanz, Amt fuer Stadtplanung und Umwelt
13.05.2023 20:00;372;168;204;Bewoelkt;10;10;0;Stadt Konstanz, Amt fuer Stadtplanung und Umwelt
13.05.2023 21:00;308;140;168;Bewoelkt;10;10;0;Stadt Konstanz, Amt fuer Stadtplanung und Umwelt
13.05.2023 22:00;301;102;199;Bewoelkt;10;9;0;Stadt Konstanz, Amt fuer Stadtplanung und Umwelt
13.05.2023 23:00;164;64;100;Leicht bewoelkt;9;9;0;Stadt Konstanz, Amt fuer Stadtplanung und Umwelt
14.05.2023 00:00;124;44;80;Leicht bewoelkt;9;8;0;Stadt Konstanz, Amt fuer Stadtplanung und Umwelt
14.05.2023 01:00;150;59;91;Leichter Nebel;9;9;0.1;Stadt Konstanz, Amt fuer Stadtplanung und Umwelt
14.05.2023 02:00;74;37;37;Leichter Nebel;9;9;0;Stadt Konstanz, Amt fuer Stadtplanung und Umwelt
14.05.2023 03:00;54;23;31;Leichter Nebel;9;9;0;Stadt Konstanz, Amt fuer Stadtplanung und Umwelt
14.05.2023 04:00;42;27;15;Leichter Nebel;9;8;0;Stadt Konstanz, Amt fuer Stadtplanung und Umwelt
14.05.2023 05:00;32;23;9;Leichter Nebel;9;8;0;Stadt Konstanz, Amt fuer Stadtplanung und Umwelt
14.05.2023 06:00;19;8;11;Leichter Nebel;9;9;0;Stadt Konstanz, Amt fuer Stadtplanung und Umwelt
14.05.2023 07:00;29;13;16;Bewoelkt;10;10;0;Stadt Konstanz, Amt fuer Stadtplanung und Umwelt
14.05.2023 08:00;64;33;31;Bedeckt;11;11;0;Stadt Konstanz, Amt fuer Stadtplanung und Umwelt
14.05.2023 09:00;157;97;60;Bedeckt;12;12;0;Stadt Konstanz, Amt fuer Stadtplanung und Umwelt
14.05.2023 10:00;212;113;99;Stellenweiser Regenfall;14;13;0.1;Stadt Konstanz, Amt fuer Stadtplanung und Umwelt
14.05.2023 11:00;210;114;96;Bewoelkt;15;15;0;Stadt Konstanz, Amt fuer Stadtplanung und Umwelt
14.05.2023 12:00;283;145;138;Stellenweiser Regenfall;17;17;0.1;Stadt Konstanz, Amt fuer Stadtplanung und Umwelt
14.05.2023 13:00;275;142;133;Bedeckt;17;17;0;Stadt Konstanz, Amt fuer Stadtplanung und Umwelt
14.05.2023 14:00;376;203;173;Bedeckt;16;16;0;Stadt Konstanz, Amt fuer Stadtplanung und Umwelt
14.05.2023 15:00;385;203;182;Bewoelkt;17;17;0;Stadt Konstanz, Amt fuer Stadtplanung und Umwelt
14.05.2023 16:00;447;202;245;Stellenweiser Regenfall;15;15;0.5;Stadt Konstanz, Amt fuer Stadtplanung und Umwelt
14.05.2023 17:00;446;205;241;Leicht bewoelkt;15;14;0;Stadt Konstanz, Amt fuer Stadtplanung und Umwelt
14.05.2023 18:00;320;157;163;Stellenweiser Regenfall;14;13;0.2;Stadt Konstanz, Amt fuer Stadtplanung und Umwelt
14.05.2023 19:00;225;118;107;Bewoelkt;12;11;0;Stadt Konstanz, Amt fuer Stadtplanung und Umwelt
14.05.2023 20:00;163;90;73;Leicht bewoelkt;9;9;0;Stadt Konstanz, Amt fuer Stadtplanung und Umwelt
14.05.2023 21:00;128;62;66;Leicht bewoelkt;8;7;0;Stadt Konstanz, Amt fuer Stadtplanung und Umwelt
14.05.2023 22:00;107;44;63;Leicht bewoelkt;8;8;0;Stadt Konstanz, Amt fuer Stadtplanung und Umwelt
14.05.2023 23:00;46;17;29;Leichter Nebel;8;7;0;Stadt Konstanz, Amt fuer Stadtplanung und Umwelt
15.05.2023 00:00;34;12;22;Leichter Nebel;6;6;0;Stadt Konstanz, Amt fuer Stadtplanung und Umwelt
15.05.2023 01:00;13;8;5;Leichter Nebel;5;5;0.1;Stadt Konstanz, Amt fuer Stadtplanung und Umwelt
15.05.2023 02:00;10;4;6;Leichter Nebel;5;5;0;Stadt Konstanz, Amt fuer Stadtplanung und Umwelt
15.05.2023 03:00;5;2;3;Leichter Nebel;5;5;0;Stadt Konstanz, Amt fuer Stadtplanung und Umwelt
15.05.2023 04:00;17;10;7;Leichter Nebel;4;4;0;Stadt Konstanz, Amt fuer Stadtplanung und Umwelt
15.05.2023 05:00;55;37;18;Leichter Nebel;4;4;0;Stadt Konstanz, Amt fuer Stadtplanung und Umwelt
15.05.2023 06:00;214;122;92;Leichter Nebel;6;6;0;Stadt Konstanz, Amt fuer Stadtplanung und Umwelt
15.05.2023 07:00;962;586;376;Leichter Nebel;9;9;0;Stadt Konstanz, Amt fuer Stadtplanung und Umwelt
15.05.2023 08:00;644;354;290;Bedeckt;11;10;0;Stadt Konstanz, Amt fuer Stadtplanung und Umwelt
15.05.2023 09:00;705;434;271;Bewoelkt;12;12;0;Stadt Konstanz, Amt fuer Stadtplanung und Umwelt
15.05.2023 10:00;424;224;200;Leichter Regenschauer;14;14;0.3;Stadt Konstanz, Amt fuer Stadtplanung und Umwelt
15.05.2023 11:00;549;256;293;Bewoelkt;15;15;0;Stadt Konstanz, Amt fuer Stadtplanung und Umwelt
15.05.2023 12:00;618;280;338;Leichter Regenschauer;16;16;0.3;Stadt Konstanz, Amt fuer Stadtplanung und Umwelt
15.05.2023 13:00;861;368;493;Stellenweise Gewitter und Niederschlaege;16;16;0;Stadt Konstanz, Amt fuer Stadtplanung und Umwelt
15.05.2023 14:00;672;347;325;Stellenweiser Regenfall;17;17;0.6;Stadt Konstanz, Amt fuer Stadtplanung und Umwelt
15.05.2023 15:00;981;452;529;Stellenweiser Regenfall;17;17;0.2;Stadt Konstanz, Amt fuer Stadtplanung und Umwelt
15.05.2023 16:00;822;380;442;Stellenweiser Regenfall;17;17;1.3;Stadt Konstanz, Amt fuer Stadtplanung und Umwelt
15.05.2023 17:00;1016;447;569;Stellenweiser Regenfall;17;17;0.2;Stadt Konstanz, Amt fuer Stadtplanung und Umwelt
15.05.2023 18:00;850;367;483;Stellenweiser Regenfall;15;15;0.5;Stadt Konstanz, Amt fuer Stadtplanung und Umwelt
15.05.2023 19:00;624;255;369;Stellenweiser Regenfall;12;12;0.9;Stadt Konstanz, Amt fuer Stadtplanung und Umwelt
15.05.2023 20:00;483;203;280;Sonnig;9;8;0;Stadt Konstanz, Amt fuer Stadtplanung und Umwelt
15.05.2023 21:00;311;153;158;Leicht bewoelkt;8;7;0;Stadt Konstanz, Amt fuer Stadtplanung und Umwelt
15.05.2023 22:00;237;105;132;Leichter Nebel;7;6;0;Stadt Konstanz, Amt fuer Stadtplanung und Umwelt
15.05.2023 23:00;125;51;74;Leichter Nebel;7;6;0;Stadt Konstanz, Amt fuer Stadtplanung und Umwelt
16.05.2023 00:00;64;37;27;Stellenweiser Regenfall;6;6;0.1;Stadt Konstanz, Amt fuer Stadtplanung und Umwelt
16.05.2023 01:00;25;11;14;Leichter Regenschauer;6;5;0.4;Stadt Konstanz, Amt fuer Stadtplanung und Umwelt
16.05.2023 02:00;7;0;7;Leichter Nebel;6;5;0;Stadt Konstanz, Amt fuer Stadtplanung und Umwelt
16.05.2023 03:00;2;1;1;Leichter Nebel;6;6;0;Stadt Konstanz, Amt fuer Stadtplanung und Umwelt
16.05.2023 04:00;16;9;7;Leichter Nebel;6;6;0;Stadt Konstanz, Amt fuer Stadtplanung und Umwelt
16.05.2023 05:00;63;44;19;Leichter Nebel;6;5;0;Stadt Konstanz, Amt fuer Stadtplanung und Umwelt
16.05.2023 06:00;192;98;94;Leichter Nebel;9;8;0;Stadt Konstanz, Amt fuer Stadtplanung und Umwelt
16.05.2023 07:00;1071;693;378;Leichter Regenschauer;10;9;0.3;Stadt Konstanz, Amt fuer Stadtplanung und Umwelt
16.05.2023 08:00;867;502;365;Stellenweiser Regenfall;11;10;0.1;Stadt Konstanz, Amt fuer Stadtplanung und Umwelt
16.05.2023 09:00;783;417;366;Stellenweiser Regenfall;11;9;0.1;Stadt Konstanz, Amt fuer Stadtplanung und Umwelt
16.05.2023 10:00;560;321;239;Leichter Regenschauer;12;10;0.4;Stadt Konstanz, Amt fuer Stadtplanung und Umwelt
16.05.2023 11:00;640;323;317;Stellenweiser Regenfall;12;10;0.1;Stadt Konstanz, Amt fuer Stadtplanung und Umwelt
16.05.2023 12:00;590;232;358;Stellenweiser Regenfall;12;10;0.1;Stadt Konstanz, Amt fuer Stadtplanung und Umwelt
16.05.2023 13:00;805;328;477;Leichter Regenschauer;12;10;0.6;Stadt Konstanz, Amt fuer Stadtplanung und Umwelt
16.05.2023 14:00;575;267;308;Bedeckt;13;11;0;Stadt Konstanz, Amt fuer Stadtplanung und Umwelt
16.05.2023 15:00;851;387;464;Bedeckt;13;11;0;Stadt Konstanz, Amt fuer Stadtplanung und Umwelt
16.05.2023 16:00;735;333;402;Bedeckt;12;10;0;Stadt Konstanz, Amt fuer Stadtplanung und Umwelt
16.05.2023 17:00;955;394;561;Bewoelkt;12;10;0;Stadt Konstanz, Amt fuer Stadtplanung und Umwelt
16.05.2023 18:00;685;311;374;Bedeckt;11;9;0;Stadt Konstanz, Amt fuer Stadtplanung und Umwelt
16.05.2023 19:00;587;268;319;Nieselregen;11;8;0.3;Stadt Konstanz, Amt fuer Stadtplanung und Umwelt
16.05.2023 20:00;336;151;185;Stellenweiser Regenfall;10;7;0.1;Stadt Konstanz, Amt fuer Stadtplanung und Umwelt
16.05.2023 21:00;291;122;169;Stellenweiser Regenfall;10;7;0.1;Stadt Konstanz, Amt fuer Stadtplanung und Umwelt
16.05.2023 22:00;214;96;118;Stellenweiser Nieselregen;10;7;0.4;Stadt Konstanz, Amt fuer Stadtplanung und Umwelt
16.05.2023 23:00;120;42;78;Stellenweiser Regenfall;10;7;0.1;Stadt Konstanz, Amt fuer Stadtplanung und Umwelt
17.05.2023 00:00;44;19;25;Leicht bewoelkt;6;5;0;Stadt Konstanz, Amt fuer Stadtplanung und Umwelt
17.05.2023 01:00;27;8;19;Bedeckt;7;4;0;Stadt Konstanz, Amt fuer Stadtplanung und Umwelt
17.05.2023 02:00;9;5;4;Bedeckt;7;4;0;Stadt Konstanz, Amt fuer Stadtplanung und Umwelt
17.05.2023 03:00;3;1;2;Bedeckt;6;4;0;Stadt Konstanz, Amt fuer Stadtplanung und Umwelt
17.05.2023 04:00;14;8;6;Bedeckt;6;3;0;Stadt Konstanz, Amt fuer Stadtplanung und Umwelt
17.05.2023 05:00;67;41;26;Bedeckt;5;3;0;Stadt Konstanz, Amt fuer Stadtplanung und Umwelt
17.05.2023 06:00;203;100;103;Bedeckt;6;4;0;Stadt Konstanz, Amt fuer Stadtplanung und Umwelt
17.05.2023 07:00;1018;646;372;Bedeckt;7;5;0;Stadt Konstanz, Amt fuer Stadtplanung und Umwelt
17.05.2023 08:00;834;476;358;Bedeckt;8;6;0;Stadt Konstanz, Amt fuer Stadtplanung und Umwelt
17.05.2023 09:00;760;421;339;Bedeckt;10;7;0;Stadt Konstanz, Amt fuer Stadtplanung und Umwelt
17.05.2023 10:00;542;293;249;Bedeckt;10;8;0;Stadt Konstanz, Amt fuer Stadtplanung und Umwelt
17.05.2023 11:00;725;331;394;Bedeckt;11;9;0;Stadt Konstanz, Amt fuer Stadtplanung und Umwelt
17.05.2023 12:00;760;318;442;Bedeckt;11;9;0;Stadt Konstanz, Amt fuer Stadtplanung und Umwelt
17.05.2023 13:00;1113;503;610;Bewoelkt;12;9;0;Stadt Konstanz, Amt fuer Stadtplanung und Umwelt
17.05.2023 14:00;790;398;392;Leicht bewoelkt;11;9;0;Stadt Konstanz, Amt fuer Stadtplanung und Umwelt
17.05.2023 15:00;973;417;556;Leicht bewoelkt;12;10;0;Stadt Konstanz, Amt fuer Stadtplanung und Umwelt
17.05.2023 16:00;1008;432;576;Stellenweiser Regenfall;12;10;0.1;Stadt Konstanz, Amt fuer Stadtplanung und Umwelt
17.05.2023 17:00;1102;462;640;Bedeckt;12;10;0;Stadt Konstanz, Amt fuer Stadtplanung und Umwelt
17.05.2023 18:00;941;425;516;Leicht bewoelkt;12;10;0;Stadt Konstanz, Amt fuer Stadtplanung und Umwelt
17.05.2023 19:00;659;316;343;Leicht bewoelkt;10;8;0;Stadt Konstanz, Amt fuer Stadtplanung und Umwelt
17.05.2023 20:00;571;269;302;Leicht bewoelkt;8;5;0;Stadt Konstanz, Amt fuer Stadtplanung und Umwelt
17.05.2023 21:00;441;219;222;Leicht bewoelkt;7;4;0;Stadt Konstanz, Amt fuer Stadtplanung und Umwelt
17.05.2023 22:00;322;146;176;Leicht bewoelkt;6;3;0;Stadt Konstanz, Amt fuer Stadtplanung und Umwelt
17.05.2023 23:00;251;92;159;Leicht bewoelkt;6;3;0;Stadt Konstanz, Amt fuer Stadtplanung und Umwelt
18.05.2023 00:00;159;55;104;Sonnig;7;4;0;Stadt Konstanz, Amt fuer Stadtplanung und Umwelt
18.05.2023 01:00;93;35;58;Sonnig;7;4;0;Stadt Konstanz, Amt fuer Stadtplanung und Umwelt
18.05.2023 02:00;68;24;44;Leicht bewoelkt;6;3;0;Stadt Konstanz, Amt fuer Stadtplanung und Umwelt
18.05.2023 03:00;20;10;10;Sonnig;5;2;0;Stadt Konstanz, Amt fuer Stadtplanung und Umwelt
18.05.2023 04:00;32;15;17;Sonnig;4;1;0;Stadt Konstanz, Amt fuer Stadtplanung und Umwelt
18.05.2023 05:00;26;17;9;Sonnig;3;0;0;Stadt Konstanz, Amt fuer Stadtplanung und Umwelt
18.05.2023 06:00;38;20;18;Leicht bewoelkt;5;2;0;Stadt Konstanz, Amt fuer Stadtplanung und Umwelt
18.05.2023 07:00;76;41;35;Sonnig;8;5;0;Stadt Konstanz, Amt fuer Stadtplanung und Umwelt
18.05.2023 08:00;158;65;93;Leicht bewoelkt;10;7;0;Stadt Konstanz, Amt fuer Stadtplanung und Umwelt
18.05.2023 09:00;306;167;139;Sonnig;12;9;0;Stadt Konstanz, Amt fuer Stadtplanung und Umwelt
18.05.2023 10:00;443;189;254;Leicht bewoelkt;13;11;0;Stadt Konstanz, Amt fuer Stadtplanung und Umwelt
18.05.2023 11:00;492;263;229;Leicht bewoelkt;15;13;0;Stadt Konstanz, Amt fuer Stadtplanung und Umwelt
18.05.2023 12:00;558;262;296;Leicht bewoelkt;15;15;0;Stadt Konstanz, Amt fuer Stadtplanung und Umwelt
18.05.2023 13:00;508;237;271;Leicht bewoelkt;16;16;0;Stadt Konstanz, Amt fuer Stadtplanung und Umwelt
18.05.2023 14:00;643;352;291;Leicht bewoelkt;15;15;0;Stadt Konstanz, Amt fuer Stadtplanung und Umwelt
18.05.2023 15:00;584;299;285;Leicht bewoelkt;15;14;0;Stadt Konstanz, Amt fuer Stadtplanung und Umwelt
18.05.2023 16:00;500;255;245;Leicht bewoelkt;15;14;0;Stadt Konstanz, Amt fuer Stadtplanung und Umwelt
18.05.2023 17:00;524;261;263;Bewoelkt;14;13;0;Stadt Konstanz, Amt fuer Stadtplanung und Umwelt
18.05.2023 18:00;478;238;240;Leicht bewoelkt;14;12;0;Stadt Konstanz, Amt fuer Stadtplanung und Umwelt
18.05.2023 19:00;389;207;182;Leicht bewoelkt;12;11;0;Stadt Konstanz, Amt fuer Stadtplanung und Umwelt
18.05.2023 20:00;276;141;135;Leicht bewoelkt;11;9;0;Stadt Konstanz, Amt fuer Stadtplanung und Umwelt
18.05.2023 21:00;245;133;112;Bewoelkt;11;9;0;Stadt Konstanz, Amt fuer Stadtplanung und Umwelt
18.05.2023 22:00;206;95;111;Leicht bewoelkt;10;9;0;Stadt Konstanz, Amt fuer Stadtplanung und Umwelt
18.05.2023 23:00;194;92;102;Bewoelkt;10;8;0;Stadt Konstanz, Amt fuer Stadtplanung und Umwelt
19.05.2023 00:00;104;20;84;Leicht bewoelkt;8;6;0;Stadt Konstanz, Amt fuer Stadtplanung und Umwelt
19.05.2023 01:00;61;25;36;Bedeckt;8;5;0;Stadt Konstanz, Amt fuer Stadtplanung und Umwelt
19.05.2023 02:00;31;16;15;Bedeckt;7;4;0;Stadt Konstanz, Amt fuer Stadtplanung und Umwelt
19.05.2023 03:00;18;13;5;Bedeckt;6;4;0;Stadt Konstanz, Amt fuer Stadtplanung und Umwelt
19.05.2023 04:00;8;4;4;Bedeckt;6;4;0;Stadt Konstanz, Amt fuer Stadtplanung und Umwelt
19.05.2023 05:00;38;28;10;Bedeckt;6;4;0;Stadt Konstanz, Amt fuer Stadtplanung und Umwelt
19.05.2023 06:00;110;63;47;Leicht bewoelkt;7;5;0;Stadt Konstanz, Amt fuer Stadtplanung und Umwelt
19.05.2023 07:00;292;182;110;Leicht bewoelkt;8;6;0;Stadt Konstanz, Amt fuer Stadtplanung und Umwelt
19.05.2023 08:00;417;244;173;Bewoelkt;9;7;0;Stadt Konstanz, Amt fuer Stadtplanung und Umwelt
19.05.2023 09:00;587;357;230;Leicht bewoelkt;11;9;0;Stadt Konstanz, Amt fuer Stadtplanung und Umwelt
19.05.2023 10:00;698;403;295;Bewoelkt;13;11;0;Stadt Konstanz, Amt fuer Stadtplanung und Umwelt
19.05.2023 11:00;814;442;372;Bedeckt;14;13;0;Stadt Konstanz, Amt fuer Stadtplanung und Umwelt
19.05.2023 12:00;962;436;526;Bedeckt;15;15;0;Stadt Konstanz, Amt fuer Stadtplanung und Umwelt
19.05.2023 13:00;1005;420;585;Bewoelkt;16;16;0;Stadt Konstanz, Amt fuer Stadtplanung und Umwelt
19.05.2023 14:00;988;445;543;Bedeckt;15;15;0;Stadt Konstanz, Amt fuer Stadtplanung und Umwelt
19.05.2023 15:00;982;405;577;Bedeckt;15;13;0;Stadt Konstanz, Amt fuer Stadtplanung und Umwelt
19.05.2023 16:00;734;315;419;Bedeckt;15;14;0;Stadt Konstanz, Amt fuer Stadtplanung und Umwelt
19.05.2023 17:00;677;272;405;Bedeckt;15;14;0;Stadt Konstanz, Amt fuer Stadtplanung und Umwelt
19.05.2023 18:00;547;225;322;Leicht bewoelkt;14;13;0;Stadt Konstanz, Amt fuer Stadtplanung und Umwelt
19.05.2023 19:00;427;194;233;Bewoelkt;13;12;0;Stadt Konstanz, Amt fuer Stadtplanung und Umwelt
19.05.2023 20:00;293;127;166;Bedeckt;12;10;0;Stadt Konstanz, Amt fuer Stadtplanung und Umwelt
19.05.2023 21:00;235;111;124;Leicht bewoelkt;12;10;0;Stadt Konstanz, Amt fuer Stadtplanung und Umwelt
19.05.2023 22:00;184;74;110;Leicht bewoelkt;11;10;0;Stadt Konstanz, Amt fuer Stadtplanung und Umwelt
19.05.2023 23:00;263;187;76;Bewoelkt;11;9;0;Stadt Konstanz, Amt fuer Stadtplanung und Umwelt
20.05.2023 00:00;231;144;87;Bedeckt;11;11;0;Stadt Konstanz, Amt fuer Stadtplanung und Umwelt
20.05.2023 01:00;105;56;49;Bedeckt;11;11;0;Stadt Konstanz, Amt fuer Stadtplanung und Umwelt
20.05.2023 02:00;55;23;32;Stellenweiser Regenfall;11;10;0.1;Stadt Konstanz, Amt fuer Stadtplanung und Umwelt
20.05.2023 03:00;23;6;17;Bedeckt;11;10;0;Stadt Konstanz, Amt fuer Stadtplanung und Umwelt
20.05.2023 04:00;16;8;8;Stellenweiser Regenfall;11;10;0.1;Stadt Konstanz, Amt fuer Stadtplanung und Umwelt
20.05.2023 05:00;30;18;12;Bedeckt;11;10;0;Stadt Konstanz, Amt fuer Stadtplanung und Umwelt
20.05.2023 06:00;60;32;28;Bedeckt;11;10;0;Stadt Konstanz, Amt fuer Stadtplanung und Umwelt
20.05.2023 07:00;106;57;49;Stellenweiser Regenfall;11;10;0.1;Stadt Konstanz, Amt fuer Stadtplanung und Umwelt
20.05.2023 08:00;186;110;76;Bedeckt;11;10;0;Stadt Konstanz, Amt fuer Stadtplanung und Umwelt
20.05.2023 09:00;422;216;206;Bedeckt;12;11;0;Stadt Konstanz, Amt fuer Stadtplanung und Umwelt
20.05.2023 10:00;540;288;252;Bedeckt;12;11;0;Stadt Konstanz, Amt fuer Stadtplanung und Umwelt
20.05.2023 11:00;764;431;333;Bedeckt;14;13;0;Stadt Konstanz, Amt fuer Stadtplanung und Umwelt
20.05.2023 12:00;753;398;355;Bedeckt;15;14;0;Stadt Konstanz, Amt fuer Stadtplanung und Umwelt
20.05.2023 13:00;917;467;450;Stellenweiser Regenfall;16;16;0.1;Stadt Konstanz, Amt fuer Stadtplanung und Umwelt
20.05.2023 14:00;946;438;508;Bedeckt;16;16;0;Stadt Konstanz, Amt fuer Stadtplanung und Umwelt
20.05.2023 15:00;994;423;571;Bedeckt;16;16;0;Stadt Konstanz, Amt fuer Stadtplanung und Umwelt
20.05.2023 16:00;791;328;463;Bedeckt;16;16;0;Stadt Konstanz, Amt fuer Stadtplanung und Umwelt
20.05.2023 17:00;640;283;357;Leicht bewoelkt;16;16;0;Stadt Konstanz, Amt fuer Stadtplanung und Umwelt
20.05.2023 18:00;489;203;286;Leicht bewoelkt;15;15;0;Stadt Konstanz, Amt fuer Stadtplanung und Umwelt
20.05.2023 19:00;386;177;209;Bedeckt;14;14;0;Stadt Konstanz, Amt fuer Stadtplanung und Umwelt
20.05.2023 20:00;316;136;180;Bedeckt;12;12;0;Stadt Konstanz, Amt fuer Stadtplanung und Umwelt
20.05.2023 21:00;205;89;116;Bewoelkt;12;11;0;Stadt Konstanz, Amt fuer Stadtplanung und Umwelt
20.05.2023 22:00;172;66;106;Bewoelkt;11;11;0;Stadt Konstanz, Amt fuer Stadtplanung und Umwelt
20.05.2023 23:00;292;167;125;Leichter Nebel;10;10;0;Stadt Konstanz, Amt fuer Stadtplanung und Umwelt
21.05.2023 00:00;228;153;75;Leicht bewoelkt;10;10;0;Stadt Konstanz, Amt fuer Stadtplanung und Umwelt
21.05.2023 01:00;159;76;83;Leichter Nebel;10;10;0;Stadt Konstanz, Amt fuer Stadtplanung und Umwelt
21.05.2023 02:00;109;69;40;Leichter Nebel;10;10;0;Stadt Konstanz, Amt fuer Stadtplanung und Umwelt
21.05.2023 03:00;89;59;30;Leichter Nebel;9;10;0;Stadt Konstanz, Amt fuer Stadtplanung und Umwelt
21.05.2023 04:00;40;27;13;Leichter Nebel;9;9;0;Stadt Konstanz, Amt fuer Stadtplanung und Umwelt
21.05.2023 05:00;31;19;12;Leichter Nebel;9;9;0;Stadt Konstanz, Amt fuer Stadtplanung und Umwelt
21.05.2023 06:00;27;13;14;Leicht bewoelkt;11;11;0;Stadt Konstanz, Amt fuer Stadtplanung und Umwelt
21.05.2023 07:00;58;36;22;Leicht bewoelkt;13;13;0;Stadt Konstanz, Amt fuer Stadtplanung und Umwelt
21.05.2023 08:00;125;61;64;Leicht bewoelkt;15;15;0;Stadt Konstanz, Amt fuer Stadtplanung und Umwelt
21.05.2023 09:00;308;160;148;Leicht bewoelkt;17;17;0;Stadt Konstanz, Amt fuer Stadtplanung und Umwelt
21.05.2023 10:00;380;179;201;Sonnig;19;19;0;Stadt Konstanz, Amt fuer Stadtplanung und Umwelt
21.05.2023 11:00;572;277;295;Leicht bewoelkt;22;22;0;Stadt Konstanz, Amt fuer Stadtplanung und Umwelt
21.05.2023 12:00;599;302;297;Sonnig;23;25;0;Stadt Konstanz, Amt fuer Stadtplanung und Umwelt
21.05.2023 13:00;678;354;324;Leicht bewoelkt;24;25;0;Stadt Konstanz, Amt fuer Stadtplanung und Umwelt
21.05.2023 14:00;698;352;346;Stellenweiser Regenfall;23;25;0.2;Stadt Konstanz, Amt fuer Stadtplanung und Umwelt
21.05.2023 15:00;711;352;359;Stellenweiser Regenfall;22;25;0.2;Stadt Konstanz, Amt fuer Stadtplanung und Umwelt
21.05.2023 16:00;689;347;342;Stellenweiser Regenfall;21;21;1;Stadt Konstanz, Amt fuer Stadtplanung und Umwelt
21.05.2023 17:00;694;371;323;Stellenweiser Regenfall;20;20;0.5;Stadt Konstanz, Amt fuer Stadtplanung und Umwelt
21.05.2023 18:00;595;293;302;Stellenweiser Regenfall;19;19;0.6;Stadt Konstanz, Amt fuer Stadtplanung und Umwelt
21.05.2023 19:00;528;226;302;Maeßiger bis starker Regenschauer;17;17;3.7;Stadt Konstanz, Amt fuer Stadtplanung und Umwelt
21.05.2023 20:00;385;181;204;Stellenweiser Regenfall;14;15;0.1;Stadt Konstanz, Amt fuer Stadtplanung und Umwelt
21.05.2023 21:00;237;91;146;Leichter Nebel;13;13;0.1;Stadt Konstanz, Amt fuer Stadtplanung und Umwelt
21.05.2023 22:00;137;47;90;Stellenweiser Regenfall;13;13;0.5;Stadt Konstanz, Amt fuer Stadtplanung und Umwelt
21.05.2023 23:00;71;29;42;Stellenweiser Regenfall;12;12;0.2;Stadt Konstanz, Amt fuer Stadtplanung und Umwelt
22.05.2023 00:00;28;10;18;Nieselregen mit Gewitter;12;13;0.2;Stadt Konstanz, Amt fuer Stadtplanung und Umwelt
22.05.2023 01:00;12;5;7;Leichter Regenschauer;11;11;2.2;Stadt Konstanz, Amt fuer Stadtplanung und Umwelt
22.05.2023 02:00;4;3;1;Leichter Regenschauer;11;11;0.6;Stadt Konstanz, Amt fuer Stadtplanung und Umwelt
22.05.2023 03:00;5;2;3;Leichter Regenschauer;11;11;0.5;Stadt Konstanz, Amt fuer Stadtplanung und Umwelt
22.05.2023 04:00;12;7;5;Leichter Regenschauer;10;10;1.2;Stadt Konstanz, Amt fuer Stadtplanung und Umwelt
22.05.2023 05:00;59;41;18;Leichter Regenschauer;10;10;0.3;Stadt Konstanz, Amt fuer Stadtplanung und Umwelt
22.05.2023 06:00;228;129;99;Leichter Regenschauer;12;12;0.2;Stadt Konstanz, Amt fuer Stadtplanung und Umwelt
22.05.2023 07:00;962;586;376;Leichter Regenschauer;14;15;1.2;Stadt Konstanz, Amt fuer Stadtplanung und Umwelt
22.05.2023 08:00;861;484;377;Bedeckt;16;16;0;Stadt Konstanz, Amt fuer Stadtplanung und Umwelt
22.05.2023 09:00;814;486;328;Bedeckt;16;16;0;Stadt Konstanz, Amt fuer Stadtplanung und Umwelt
22.05.2023 10:00;623;304;319;Stellenweiser Regenfall;18;18;0.1;Stadt Konstanz, Amt fuer Stadtplanung und Umwelt
22.05.2023 11:00;840;399;441;Leicht bewoelkt;20;20;0;Stadt Konstanz, Amt fuer Stadtplanung und Umwelt
22.05.2023 12:00;861;366;495;Sonnig;23;25;0;Stadt Konstanz, Amt fuer Stadtplanung und Umwelt
22.05.2023 13:00;1186;564;622;Stellenweiser Regenfall;25;26;0.4;Stadt Konstanz, Amt fuer Stadtplanung und Umwelt
22.05.2023 14:00;877;439;438;Nieselregen mit Gewitter;24;26;0.4;Stadt Konstanz, Amt fuer Stadtplanung und Umwelt
22.05.2023 15:00;1211;642;569;Stellenweise Gewitter und Niederschlaege;24;25;0.1;Stadt Konstanz, Amt fuer Stadtplanung und Umwelt
22.05.2023 16:00;1178;572;606;Nieselregen mit Gewitter;23;25;1;Stadt Konstanz, Amt fuer Stadtplanung und Umwelt
22.05.2023 17:00;1225;583;642;Stellenweiser Regenfall;22;25;0.1;Stadt Konstanz, Amt fuer Stadtplanung und Umwelt
22.05.2023 18:00;1117;527;590;Nieselregen mit Gewitter;21;21;0.5;Stadt Konstanz, Amt fuer Stadtplanung und Umwelt
22.05.2023 19:00;775;356;419;Nieselregen mit Gewitter;18;18;1.2;Stadt Konstanz, Amt fuer Stadtplanung und Umwelt
22.05.2023 20:00;661;273;388;Stellenweiser Regenfall;15;15;0.1;Stadt Konstanz, Amt fuer Stadtplanung und Umwelt
22.05.2023 21:00;419;169;250;Sonnig;14;15;0;Stadt Konstanz, Amt fuer Stadtplanung und Umwelt
22.05.2023 22:00;267;108;159;Nieselregen mit Gewitter;14;14;0.2;Stadt Konstanz, Amt fuer Stadtplanung und Umwelt
22.05.2023 23:00;133;55;78;Leichter Nebel;13;14;0;Stadt Konstanz, Amt fuer Stadtplanung und Umwelt
23.05.2023 00:00;65;29;36;Stellenweiser Regenfall;13;13;0.4;Stadt Konstanz, Amt fuer Stadtplanung und Umwelt
23.05.2023 01:00;16;6;10;Stellenweiser Regenfall;12;13;0.5;Stadt Konstanz, Amt fuer Stadtplanung und Umwelt
23.05.2023 02:00;6;1;5;Leichter Nebel;12;13;0;Stadt Konstanz, Amt fuer Stadtplanung und Umwelt
23.05.2023 03:00;8;3;5;Leichter Nebel;12;13;0;Stadt Konstanz, Amt fuer Stadtplanung und Umwelt
23.05.2023 04:00;14;6;8;Leichter Nebel;12;13;0.1;Stadt Konstanz, Amt fuer Stadtplanung und Umwelt
23.05.2023 05:00;71;53;18;Leichter Nebel;13;13;0;Stadt Konstanz, Amt fuer Stadtplanung und Umwelt
23.05.2023 06:00;218;110;108;Leichter Nebel;14;14;0.1;Stadt Konstanz, Amt fuer Stadtplanung und Umwelt
23.05.2023 07:00;1040;648;392;Leichter Nebel;15;15;0;Stadt Konstanz, Amt fuer Stadtplanung und Umwelt
23.05.2023 08:00;931;531;400;Leichter Regenschauer;15;15;0.2;Stadt Konstanz, Amt fuer Stadtplanung und Umwelt
23.05.2023 09:00;878;468;410;Leichter Regenschauer;16;16;0.2;Stadt Konstanz, Amt fuer Stadtplanung und Umwelt
23.05.2023 10:00;564;315;249;Leichter Regenschauer;16;16;1.2;Stadt Konstanz, Amt fuer Stadtplanung und Umwelt
23.05.2023 11:00;703;339;364;Leichter Regenschauer;16;16;0.3;Stadt Konstanz, Amt fuer Stadtplanung und Umwelt
23.05.2023 12:00;761;336;425;Leichter Regenschauer;15;15;0.5;Stadt Konstanz, Amt fuer Stadtplanung und Umwelt
23.05.2023 13:00;955;412;543;Maeßiger bis starker Regenschauer;15;15;2.6;Stadt Konstanz, Amt fuer Stadtplanung und Umwelt
23.05.2023 14:00;709;349;360;Leichter Regenschauer;15;15;0.3;Stadt Konstanz, Amt fuer Stadtplanung und Umwelt
23.05.2023 15:00;810;362;448;Leichter Regenschauer;16;16;0.2;Stadt Konstanz, Amt fuer Stadtplanung und Umwelt
23.05.2023 16:00;832;373;459;Leichter Regenschauer;16;16;0.6;Stadt Konstanz, Amt fuer Stadtplanung und Umwelt
23.05.2023 17:00;1068;471;597;Leichter Regenschauer;17;17;0.2;Stadt Konstanz, Amt fuer Stadtplanung und Umwelt
23.05.2023 18:00;879;380;499;Leichter Regenschauer;16;16;0.2;Stadt Konstanz, Amt fuer Stadtplanung und Umwelt
23.05.2023 19:00;695;345;350;Leichter Regenschauer;14;14;0.6;Stadt Konstanz, Amt fuer Stadtplanung und Umwelt
23.05.2023 20:00;427;190;237;Bewoelkt;13;12;0;Stadt Konstanz, Amt fuer Stadtplanung und Umwelt
23.05.2023 21:00;370;127;243;Leicht bewoelkt;12;11;0;Stadt Konstanz, Amt fuer Stadtplanung und Umwelt
23.05.2023 22:00;270;122;148;Bewoelkt;11;11;0;Stadt Konstanz, Amt fuer Stadtplanung und Umwelt
23.05.2023 23:00;130;61;69;Bedeckt;11;11;0;Stadt Konstanz, Amt fuer Stadtplanung und Umwelt
24.05.2023 00:00;54;21;33;Bewoelkt;12;12;0;Stadt Konstanz, Amt fuer Stadtplanung und Umwelt
24.05.2023 01:00;41;17;24;Bewoelkt;12;11;0;Stadt Konstanz, Amt fuer Stadtplanung und Umwelt
24.05.2023 02:00;6;4;2;Leicht bewoelkt;12;11;0;Stadt Konstanz, Amt fuer Stadtplanung und Umwelt
24.05.2023 03:00;9;2;7;Leicht bewoelkt;12;11;0;Stadt Konstanz, Amt fuer Stadtplanung und Umwelt
24.05.2023 04:00;13;7;6;Bewoelkt;11;11;0;Stadt Konstanz, Amt fuer Stadtplanung und Umwelt
24.05.2023 05:00;61;43;18;Leicht bewoelkt;11;11;0;Stadt Konstanz, Amt fuer Stadtplanung und Umwelt
24.05.2023 06:00;173;91;82;Bewoelkt;11;11;0;Stadt Konstanz, Amt fuer Stadtplanung und Umwelt
24.05.2023 07:00;806;484;322;Bewoelkt;12;11;0;Stadt Konstanz, Amt fuer Stadtplanung und Umwelt
24.05.2023 08:00;836;517;319;Bewoelkt;12;11;0;Stadt Konstanz, Amt fuer Stadtplanung und Umwelt
24.05.2023 09:00;733;421;312;Bewoelkt;13;12;0;Stadt Konstanz, Amt fuer Stadtplanung und Umwelt
24.05.2023 10:00;440;224;216;Leicht bewoelkt;13;13;0;Stadt Konstanz, Amt fuer Stadtplanung und Umwelt
24.05.2023 11:00;582;270;312;Bedeckt;14;14;0;Stadt Konstanz, Amt fuer Stadtplanung und Umwelt
24.05.2023 12:00;668;316;352;Bedeckt;15;15;0;Stadt Konstanz, Amt fuer Stadtplanung und Umwelt
24.05.2023 13:00;947;456;491;Bewoelkt;15;15;0;Stadt Konstanz, Amt fuer Stadtplanung und Umwelt
24.05.2023 14:00;676;321;355;Leicht bewoelkt;15;14;0;Stadt Konstanz, Amt fuer Stadtplanung und Umwelt
24.05.2023 15:00;936;415;521;Bewoelkt;14;14;0;Stadt Konstanz, Amt fuer Stadtplanung und Umwelt
24.05.2023 16:00;956;437;519;Stellenweiser Regenfall;14;14;0.1;Stadt Konstanz, Amt fuer Stadtplanung und Umwelt
24.05.2023 17:00;1074;415;659;Leicht bewoelkt;14;14;0;Stadt Konstanz, Amt fuer Stadtplanung und Umwelt
24.05.2023 18:00;855;352;503;Stellenweiser Regenfall;14;13;0.1;Stadt Konstanz, Amt fuer Stadtplanung und Umwelt
24.05.2023 19:00;630;292;338;Leichter Regenschauer;12;11;0.6;Stadt Konstanz, Amt fuer Stadtplanung und Umwelt
24.05.2023 20:00;422;210;212;Stellenweiser Regenfall;10;9;0.1;Stadt Konstanz, Amt fuer Stadtplanung und Umwelt
24.05.2023 21:00;405;220;185;Stellenweiser Regenfall;10;8;0.1;Stadt Konstanz, Amt fuer Stadtplanung und Umwelt
24.05.2023 22:00;293;145;148;Stellenweiser Regenfall;9;8;0.1;Stadt Konstanz, Amt fuer Stadtplanung und Umwelt
24.05.2023 23:00;139;53;86;Bewoelkt;9;7;0;Stadt Konstanz, Amt fuer Stadtplanung und Umwelt
25.05.2023 00:00;78;28;50;Bewoelkt;8;6;0;Stadt Konstanz, Amt fuer Stadtplanung und Umwelt
25.05.2023 01:00;39;9;30;Leichter Regenschauer;8;6;0.2;Stadt Konstanz, Amt fuer Stadtplanung und Umwelt
25.05.2023 02:00;16;7;9;Stellenweiser Regenfall;8;6;0.1;Stadt Konstanz, Amt fuer Stadtplanung und Umwelt
25.05.2023 03:00;4;3;1;Stellenweiser Regenfall;7;5;0.1;Stadt Konstanz, Amt fuer Stadtplanung und Umwelt
25.05.2023 04:00;11;8;3;Stellenweiser Nieselregen;5;4;0.2;Stadt Konstanz, Amt fuer Stadtplanung und Umwelt
25.05.2023 05:00;58;41;17;Stellenweiser Regenfall;5;3;0.1;Stadt Konstanz, Amt fuer Stadtplanung und Umwelt
25.05.2023 06:00;229;124;105;Leicht bewoelkt;8;6;0;Stadt Konstanz, Amt fuer Stadtplanung und Umwelt
25.05.2023 07:00;1001;615;386;Nieselregen;11;9;0.2;Stadt Konstanz, Amt fuer Stadtplanung und Umwelt
25.05.2023 08:00;912;508;404;Bewoelkt;13;11;0;Stadt Konstanz, Amt fuer Stadtplanung und Umwelt
25.05.2023 09:00;873;499;374;Sonnig;15;14;0;Stadt Konstanz, Amt fuer Stadtplanung und Umwelt
25.05.2023 10:00;581;324;257;Bedeckt;17;17;0;Stadt Konstanz, Amt fuer Stadtplanung und Umwelt
25.05.2023 11:00;759;363;396;Bewoelkt;18;18;0;Stadt Konstanz, Amt fuer Stadtplanung und Umwelt
25.05.2023 12:00;822;356;466;Bewoelkt;19;19;0;Stadt Konstanz, Amt fuer Stadtplanung und Umwelt
25.05.2023 13:00;1011;416;595;Leicht bewoelkt;19;19;0;Stadt Konstanz, Amt fuer Stadtplanung und Umwelt
25.05.2023 14:00;813;408;405;Leicht bewoelkt;20;20;0;Stadt Konstanz, Amt fuer Stadtplanung und Umwelt
25.05.2023 15:00;1083;503;580;Bewoelkt;19;19;0;Stadt Konstanz, Amt fuer Stadtplanung und Umwelt
25.05.2023 16:00;1089;514;575;Bewoelkt;19;19;0;Stadt Konstanz, Amt fuer Stadtplanung und Umwelt
25.05.2023 17:00;1228;562;666;Bedeckt;18;18;0;Stadt Konstanz, Amt fuer Stadtplanung und Umwelt
25.05.2023 18:00;1040;482;558;Leicht bewoelkt;17;17;0;Stadt Konstanz, Amt fuer Stadtplanung und Umwelt
25.05.2023 19:00;678;357;321;Leicht bewoelkt;16;16;0;Stadt Konstanz, Amt fuer Stadtplanung und Umwelt
25.05.2023 20:00;532;256;276;Bewoelkt;14;13;0;Stadt Konstanz, Amt fuer Stadtplanung und Umwelt
25.05.2023 21:00;419;198;221;Bewoelkt;13;13;0;Stadt Konstanz, Amt fuer Stadtplanung und Umwelt
25.05.2023 22:00;387;138;249;Leicht bewoelkt;13;12;0;Stadt Konstanz, Amt fuer Stadtplanung und Umwelt
25.05.2023 23:00;214;66;148;Leicht bewoelkt;13;13;0;Stadt Konstanz, Amt fuer Stadtplanung und Umwelt
26.05.2023 00:00;95;41;54;Leicht bewoelkt;12;11;0;Stadt Konstanz, Amt fuer Stadtplanung und Umwelt
26.05.2023 01:00;57;24;33;Leicht bewoelkt;12;11;0;Stadt Konstanz, Amt fuer Stadtplanung und Umwelt
26.05.2023 02:00;25;8;17;Leicht bewoelkt;12;11;0;Stadt Konstanz, Amt fuer Stadtplanung und Umwelt
26.05.2023 03:00;11;4;7;Leicht bewoelkt;12;11;0;Stadt Konstanz, Amt fuer Stadtplanung und Umwelt
26.05.2023 04:00;17;11;6;Leicht bewoelkt;12;11;0;Stadt Konstanz, Amt fuer Stadtplanung und Umwelt
26.05.2023 05:00;68;51;17;Leicht bewoelkt;12;11;0;Stadt Konstanz, Amt fuer Stadtplanung und Umwelt
26.05.2023 06:00;189;97;92;Leicht bewoelkt;13;12;0;Stadt Konstanz, Amt fuer Stadtplanung und Umwelt
26.05.2023 07:00;894;549;345;Leicht bewoelkt;14;13;0;Stadt Konstanz, Amt fuer Stadtplanung und Umwelt
26.05.2023 08:00;785;443;342;Leicht bewoelkt;14;14;0;Stadt Konstanz, Amt fuer Stadtplanung und Umwelt
26.05.2023 09:00;786;446;340;Leicht bewoelkt;15;15;0;Stadt Konstanz, Amt fuer Stadtplanung und Umwelt
26.05.2023 10:00;671;353;318;Leicht bewoelkt;16;16;0;Stadt Konstanz, Amt fuer Stadtplanung und Umwelt
26.05.2023 11:00;779;352;427;Leicht bewoelkt;18;18;0;Stadt Konstanz, Amt fuer Stadtplanung und Umwelt
26.05.2023 12:00;978;473;505;Leicht bewoelkt;19;19;0;Stadt Konstanz, Amt fuer Stadtplanung und Umwelt
26.05.2023 13:00;1070;429;641;Leicht bewoelkt;21;21;0;Stadt Konstanz, Amt fuer Stadtplanung und Umwelt
26.05.2023 14:00;938;421;517;Sonnig;22;25;0;Stadt Konstanz, Amt fuer Stadtplanung und Umwelt
26.05.2023 15:00;942;454;488;Leicht bewoelkt;22;22;0;Stadt Konstanz, Amt fuer Stadtplanung und Umwelt
26.05.2023 16:00;932;466;466;Bewoelkt;21;21;0;Stadt Konstanz, Amt fuer Stadtplanung und Umwelt
26.05.2023 17:00;981;490;491;Leicht bewoelkt;21;21;0;Stadt Konstanz, Amt fuer Stadtplanung und Umwelt
26.05.2023 18:00;905;430;475;Leicht bewoelkt;19;19;0;Stadt Konstanz, Amt fuer Stadtplanung und Umwelt
26.05.2023 19:00;780;386;394;Stellenweiser Regenfall;17;17;0.2;Stadt Konstanz, Amt fuer Stadtplanung und Umwelt
26.05.2023 20:00;527;292;235;Leicht bewoelkt;14;13;0;Stadt Konstanz, Amt fuer Stadtplanung und Umwelt
26.05.2023 21:00;408;187;221;Leicht bewoelkt;12;11;0;Stadt Konstanz, Amt fuer Stadtplanung und Umwelt
26.05.2023 22:00;378;116;262;Leicht bewoelkt;11;10;0;Stadt Konstanz, Amt fuer Stadtplanung und Umwelt
26.05.2023 23:00;282;69;213;Sonnig;11;10;0;Stadt Konstanz, Amt fuer Stadtplanung und Umwelt
27.05.2023 00:00;193;57;136;Sonnig;12;12;0;Stadt Konstanz, Amt fuer Stadtplanung und Umwelt
27.05.2023 01:00;90;23;67;Sonnig;10;10;0;Stadt Konstanz, Amt fuer Stadtplanung und Umwelt
27.05.2023 02:00;45;17;28;Sonnig;9;8;0;Stadt Konstanz, Amt fuer Stadtplanung und Umwelt
27.05.2023 03:00;30;7;23;Leichter Nebel;8;7;0;Stadt Konstanz, Amt fuer Stadtplanung und Umwelt
27.05.2023 04:00;28;17;11;Leichter Nebel;8;7;0;Stadt Konstanz, Amt fuer Stadtplanung und Umwelt
27.05.2023 05:00;44;27;17;Nebel;8;7;0;Stadt Konstanz, Amt fuer Stadtplanung und Umwelt
27.05.2023 06:00;62;33;29;Leicht bewoelkt;10;10;0;Stadt Konstanz, Amt fuer Stadtplanung und Umwelt
27.05.2023 07:00;95;46;49;Bewoelkt;13;12;0;Stadt Konstanz, Amt fuer Stadtplanung und Umwelt
27.05.2023 08:00;268;130;138;Leicht bewoelkt;15;14;0;Stadt Konstanz, Amt fuer Stadtplanung und Umwelt
27.05.2023 09:00;501;268;233;Sonnig;17;17;0;Stadt Konstanz, Amt fuer Stadtplanung und Umwelt
27.05.2023 10:00;665;379;286;Sonnig;19;19;0;Stadt Konstanz, Amt fuer Stadtplanung und Umwelt
27.05.2023 11:00;787;443;344;Sonnig;21;21;0;Stadt Konstanz, Amt fuer Stadtplanung und Umwelt
27.05.2023 12:00;798;424;374;Leicht bewoelkt;21;21;0;Stadt Konstanz, Amt fuer Stadtplanung und Umwelt
27.05.2023 13:00;787;383;404;Leicht bewoelkt;22;22;0;Stadt Konstanz, Amt fuer Stadtplanung und Umwelt
27.05.2023 14:00;916;480;436;Leicht bewoelkt;22;24;0;Stadt Konstanz, Amt fuer Stadtplanung und Umwelt
27.05.2023 15:00;839;421;418;Leicht bewoelkt;22;24;0;Stadt Konstanz, Amt fuer Stadtplanung und Umwelt
27.05.2023 16:00;810;449;361;Leicht bewoelkt;22;22;0;Stadt Konstanz, Amt fuer Stadtplanung und Umwelt
27.05.2023 17:00;716;353;363;Leicht bewoelkt;21;21;0;Stadt Konstanz, Amt fuer Stadtplanung und Umwelt
27.05.2023 18:00;765;334;431;Sonnig;20;20;0;Stadt Konstanz, Amt fuer Stadtplanung und Umwelt
27.05.2023 19:00;651;329;322;Sonnig;18;18;0;Stadt Konstanz, Amt fuer Stadtplanung und Umwelt
27.05.2023 20:00;506;256;250;Sonnig;13;13;0;Stadt Konstanz, Amt fuer Stadtplanung und Umwelt
27.05.2023 21:00;430;178;252;Sonnig;12;11;0;Stadt Konstanz, Amt fuer Stadtplanung und Umwelt
27.05.2023 22:00;358;111;247;Sonnig;12;11;0;Stadt Konstanz, Amt fuer Stadtplanung und Umwelt
27.05.2023 23:00;264;52;212;Sonnig;11;10;0;Stadt Konstanz, Amt fuer Stadtplanung und Umwelt
28.05.2023 00:00;183;51;132;Leichter Nebel;9;8;0;Stadt Konstanz, Amt fuer Stadtplanung und Umwelt
28.05.2023 01:00;145;53;92;Leichter Nebel;9;7;0;Stadt Konstanz, Amt fuer Stadtplanung und Umwelt
28.05.2023 02:00;60;22;38;Leichter Nebel;8;7;0;Stadt Konstanz, Amt fuer Stadtplanung und Umwelt
28.05.2023 03:00;58;24;34;Leichter Nebel;8;6;0;Stadt Konstanz, Amt fuer Stadtplanung und Umwelt
28.05.2023 04:00;20;12;8;Leichter Nebel;7;6;0;Stadt Konstanz, Amt fuer Stadtplanung und Umwelt
28.05.2023 05:00;31;19;12;Leichter Nebel;7;6;0;Stadt Konstanz, Amt fuer Stadtplanung und Umwelt
28.05.2023 06:00;45;20;25;Sonnig;9;8;0;Stadt Konstanz, Amt fuer Stadtplanung und Umwelt
28.05.2023 07:00;64;30;34;Sonnig;12;11;0;Stadt Konstanz, Amt fuer Stadtplanung und Umwelt
28.05.2023 08:00;121;67;54;Sonnig;14;14;0;Stadt Konstanz, Amt fuer Stadtplanung und Umwelt
28.05.2023 09:00;301;151;150;Sonnig;16;16;0;Stadt Konstanz, Amt fuer Stadtplanung und Umwelt
28.05.2023 10:00;465;221;244;Sonnig;18;18;0;Stadt Konstanz, Amt fuer Stadtplanung und Umwelt
28.05.2023 11:00;531;251;280;Sonnig;21;21;0;Stadt Konstanz, Amt fuer Stadtplanung und Umwelt
28.05.2023 12:00;598;281;317;Sonnig;22;24;0;Stadt Konstanz, Amt fuer Stadtplanung und Umwelt
28.05.2023 13:00;612;282;330;Sonnig;23;25;0;Stadt Konstanz, Amt fuer Stadtplanung und Umwelt
28.05.2023 14:00;694;338;356;Sonnig;23;25;0;Stadt Konstanz, Amt fuer Stadtplanung und Umwelt
28.05.2023 15:00;641;353;288;Sonnig;22;24;0;Stadt Konstanz, Amt fuer Stadtplanung und Umwelt
28.05.2023 16:00;605;344;261;Sonnig;22;25;0;Stadt Konstanz, Amt fuer Stadtplanung und Umwelt
28.05.2023 17:00;665;343;322;Sonnig;23;25;0;Stadt Konstanz, Amt fuer Stadtplanung und Umwelt
28.05.2023 18:00;572;292;280;Sonnig;22;25;0;Stadt Konstanz, Amt fuer Stadtplanung und Umwelt
28.05.2023 19:00;534;270;264;Sonnig;19;19;0;Stadt Konstanz, Amt fuer Stadtplanung und Umwelt
28.05.2023 20:00;440;205;235;Sonnig;13;12;0;Stadt Konstanz, Amt fuer Stadtplanung und Umwelt
28.05.2023 21:00;341;156;185;Sonnig;11;10;0;Stadt Konstanz, Amt fuer Stadtplanung und Umwelt
28.05.2023 22:00;269;98;171;Sonnig;10;9;0;Stadt Konstanz, Amt fuer Stadtplanung und Umwelt
28.05.2023 23:00;198;51;147;Sonnig;10;8;0;Stadt Konstanz, Amt fuer Stadtplanung und Umwelt
29.05.2023 00:00;107;34;73;Sonnig;9;8;0;Stadt Konstanz, Amt fuer Stadtplanung und Umwelt
29.05.2023 01:00;50;16;34;Sonnig;9;8;0;Stadt Konstanz, Amt fuer Stadtplanung und Umwelt
29.05.2023 02:00;27;8;19;Sonnig;8;7;0;Stadt Konstanz, Amt fuer Stadtplanung und Umwelt
29.05.2023 03:00;16;6;10;Sonnig;8;6;0;Stadt Konstanz, Amt fuer Stadtplanung und Umwelt
29.05.2023 04:00;20;11;9;Sonnig;8;6;0;Stadt Konstanz, Amt fuer Stadtplanung und Umwelt
29.05.2023 05:00;27;16;11;Sonnig;8;6;0;Stadt Konstanz, Amt fuer Stadtplanung und Umwelt
29.05.2023 06:00;32;19;13;Sonnig;10;9;0;Stadt Konstanz, Amt fuer Stadtplanung und Umwelt
29.05.2023 07:00;49;19;30;Sonnig;13;13;0;Stadt Konstanz, Amt fuer Stadtplanung und Umwelt
29.05.2023 08:00;158;93;65;Sonnig;16;16;0;Stadt Konstanz, Amt fuer Stadtplanung und Umwelt
29.05.2023 09:00;362;184;178;Sonnig;18;18;0;Stadt Konstanz, Amt fuer Stadtplanung und Umwelt
29.05.2023 10:00;483;224;259;Sonnig;19;19;0;Stadt Konstanz, Amt fuer Stadtplanung und Umwelt
29.05.2023 11:00;555;252;303;Sonnig;21;21;0;Stadt Konstanz, Amt fuer Stadtplanung und Umwelt
29.05.2023 12:00;654;314;340;Sonnig;22;24;0;Stadt Konstanz, Amt fuer Stadtplanung und Umwelt
29.05.2023 13:00;574;287;287;Sonnig;23;24;0;Stadt Konstanz, Amt fuer Stadtplanung und Umwelt
29.05.2023 14:00;645;361;284;Sonnig;23;25;0;Stadt Konstanz, Amt fuer Stadtplanung und Umwelt
29.05.2023 15:00;706;386;320;Sonnig;23;25;0;Stadt Konstanz, Amt fuer Stadtplanung und Umwelt
29.05.2023 16:00;686;311;375;Leicht bewoelkt;22;24;0;Stadt Konstanz, Amt fuer Stadtplanung und Umwelt
29.05.2023 17:00;639;348;291;Leicht bewoelkt;22;22;0;Stadt Konstanz, Amt fuer Stadtplanung und Umwelt
29.05.2023 18:00;639;331;308;Sonnig;21;21;0;Stadt Konstanz, Amt fuer Stadtplanung und Umwelt
29.05.2023 19:00;485;231;254;Sonnig;19;19;0;Stadt Konstanz, Amt fuer Stadtplanung und Umwelt
29.05.2023 20:00;394;165;229;Sonnig;14;14;0;Stadt Konstanz, Amt fuer Stadtplanung und Umwelt
29.05.2023 21:00;325;138;187;Sonnig;13;13;0;Stadt Konstanz, Amt fuer Stadtplanung und Umwelt
29.05.2023 22:00;223;79;144;Sonnig;14;13;0;Stadt Konstanz, Amt fuer Stadtplanung und Umwelt
29.05.2023 23:00;94;41;53;Sonnig;13;12;0;Stadt Konstanz, Amt fuer Stadtplanung und Umwelt
30.05.2023 00:00;59;22;37;Sonnig;11;10;0;Stadt Konstanz, Amt fuer Stadtplanung und Umwelt
30.05.2023 01:00;28;13;15;Sonnig;12;11;0;Stadt Konstanz, Amt fuer Stadtplanung und Umwelt
30.05.2023 02:00;5;2;3;Sonnig;11;10;0;Stadt Konstanz, Amt fuer Stadtplanung und Umwelt
30.05.2023 03:00;7;3;4;Sonnig;10;9;0;Stadt Konstanz, Amt fuer Stadtplanung und Umwelt
30.05.2023 04:00;10;5;5;Sonnig;9;8;0;Stadt Konstanz, Amt fuer Stadtplanung und Umwelt
30.05.2023 05:00;64;48;16;Leichter Nebel;9;8;0;Stadt Konstanz, Amt fuer Stadtplanung und Umwelt
30.05.2023 06:00;183;105;78;Leicht bewoelkt;11;10;0;Stadt Konstanz, Amt fuer Stadtplanung und Umwelt
30.05.2023 07:00;453;234;219;Leicht bewoelkt;13;12;0;Stadt Konstanz, Amt fuer Stadtplanung und Umwelt
30.05.2023 08:00;613;330;283;Leicht bewoelkt;15;14;0;Stadt Konstanz, Amt fuer Stadtplanung und Umwelt
30.05.2023 09:00;633;327;306;Leicht bewoelkt;17;17;0;Stadt Konstanz, Amt fuer Stadtplanung und Umwelt
30.05.2023 10:00;605;327;278;Leicht bewoelkt;18;18;0;Stadt Konstanz, Amt fuer Stadtplanung und Umwelt
30.05.2023 11:00;682;339;343;Bewoelkt;19;19;0;Stadt Konstanz, Amt fuer Stadtplanung und Umwelt
30.05.2023 12:00;721;324;397;Leicht bewoelkt;20;20;0;Stadt Konstanz, Amt fuer Stadtplanung und Umwelt
30.05.2023 13:00;684;345;339;Leicht bewoelkt;21;21;0;Stadt Konstanz, Amt fuer Stadtplanung und Umwelt
30.05.2023 14:00;703;320;383;Leicht bewoelkt;21;21;0;Stadt Konstanz, Amt fuer Stadtplanung und Umwelt
30.05.2023 15:00;759;360;399;Leicht bewoelkt;21;21;0;Stadt Konstanz, Amt fuer Stadtplanung und Umwelt
30.05.2023 16:00;925;431;494;Leicht bewoelkt;20;20;0;Stadt Konstanz, Amt fuer Stadtplanung und Umwelt
30.05.2023 17:00;1040;533;507;Sonnig;21;21;0;Stadt Konstanz, Amt fuer Stadtplanung und Umwelt
30.05.2023 18:00;927;434;493;Sonnig;20;20;0;Stadt Konstanz, Amt fuer Stadtplanung und Umwelt
30.05.2023 19:00;714;375;339;Leicht bewoelkt;18;18;0;Stadt Konstanz, Amt fuer Stadtplanung und Umwelt
30.05.2023 20:00;571;262;309;Leicht bewoelkt;14;14;0;Stadt Konstanz, Amt fuer Stadtplanung und Umwelt
30.05.2023 21:00;409;164;245;Sonnig;13;12;0;Stadt Konstanz, Amt fuer Stadtplanung und Umwelt
30.05.2023 22:00;302;102;200;Sonnig;12;11;0;Stadt Konstanz, Amt fuer Stadtplanung und Umwelt
30.05.2023 23:00;153;32;121;Sonnig;11;9;0;Stadt Konstanz, Amt fuer Stadtplanung und Umwelt
31.05.2023 00:00;54;27;27;Sonnig;11;9;0;Stadt Konstanz, Amt fuer Stadtplanung und Umwelt
31.05.2023 01:00;31;7;24;Sonnig;11;9;0;Stadt Konstanz, Amt fuer Stadtplanung und Umwelt
31.05.2023 02:00;10;1;9;Sonnig;11;9;0;Stadt Konstanz, Amt fuer Stadtplanung und Umwelt
31.05.2023 03:00;4;2;2;Sonnig;10;8;0;Stadt Konstanz, Amt fuer Stadtplanung und Umwelt
31.05.2023 04:00;9;7;2;Sonnig;10;7;0;Stadt Konstanz, Amt fuer Stadtplanung und Umwelt
31.05.2023 05:00;70;48;22;Sonnig;9;7;0;Stadt Konstanz, Amt fuer Stadtplanung und Umwelt
31.05.2023 06:00;185;99;86;Sonnig;11;9;0;Stadt Konstanz, Amt fuer Stadtplanung und Umwelt
31.05.2023 07:00;464;235;229;Sonnig;13;11;0;Stadt Konstanz, Amt fuer Stadtplanung und Umwelt
31.05.2023 08:00;660;358;302;Sonnig;15;13;0;Stadt Konstanz, Amt fuer Stadtplanung und Umwelt
31.05.2023 09:00;625;332;293;Sonnig;16;16;0;Stadt Konstanz, Amt fuer Stadtplanung und Umwelt
31.05.2023 10:00;674;379;295;Sonnig;18;18;0;Stadt Konstanz, Amt fuer Stadtplanung und Umwelt
31.05.2023 11:00;684;345;339;Sonnig;20;20;0;Stadt Konstanz, Amt fuer Stadtplanung und Umwelt
31.05.2023 12:00;685;325;360;Sonnig;21;21;0;Stadt Konstanz, Amt fuer Stadtplanung und Umwelt
31.05.2023 13:00;657;324;333;Leicht bewoelkt;21;21;0;Stadt Konstanz, Amt fuer Stadtplanung und Umwelt
31.05.2023 14:00;724;393;331;Leicht bewoelkt;21;21;0;Stadt Konstanz, Amt fuer Stadtplanung und Umwelt
31.05.2023 15:00;847;417;430;Leicht bewoelkt;22;22;0;Stadt Konstanz, Amt fuer Stadtplanung und Umwelt
31.05.2023 16:00;961;501;460;Leicht bewoelkt;22;22;0;Stadt Konstanz, Amt fuer Stadtplanung und Umwelt
31.05.2023 17:00;1009;481;528;Sonnig;22;22;0;Stadt Konstanz, Amt fuer Stadtplanung und Umwelt
31.05.2023 18:00;892;368;524;Sonnig;21;21;0;Stadt Konstanz, Amt fuer Stadtplanung und Umwelt
31.05.2023 19:00;695;359;336;Sonnig;19;19;0;Stadt Konstanz, Amt fuer Stadtplanung und Umwelt
31.05.2023 20:00;578;273;305;Sonnig;16;16;0;Stadt Konstanz, Amt fuer Stadtplanung und Umwelt
31.05.2023 21:00;501;263;238;Sonnig;14;13;0;Stadt Konstanz, Amt fuer Stadtplanung und Umwelt
31.05.2023 22:00;410;205;205;Sonnig;12;11;0;Stadt Konstanz, Amt fuer Stadtplanung und Umwelt
31.05.2023 23:00;251;90;161;Sonnig;12;11;0;Stadt Konstanz, Amt fuer Stadtplanung und Umwelt
01.06.2023 00:00;170;31;139;Sonnig;11;10;0;Stadt Konstanz, Amt fuer Stadtplanung und Umwelt
01.06.2023 01:00;48;18;30;Sonnig;10;9;0;Stadt Konstanz, Amt fuer Stadtplanung und Umwelt
01.06.2023 02:00;17;6;11;Sonnig;9;8;0;Stadt Konstanz, Amt fuer Stadtplanung und Umwelt
01.06.2023 03:00;15;5;10;Sonnig;9;8;0;Stadt Konstanz, Amt fuer Stadtplanung und Umwelt
01.06.2023 04:00;15;5;10;Leichter Nebel;8;8;0;Stadt Konstanz, Amt fuer Stadtplanung und Umwelt
01.06.2023 05:00;60;35;25;Leichter Nebel;9;8;0;Stadt Konstanz, Amt fuer Stadtplanung und Umwelt
01.06.2023 06:00;204;123;81;Leicht bewoelkt;11;11;0;Stadt Konstanz, Amt fuer Stadtplanung und Umwelt
01.06.2023 07:00;458;235;223;Leicht bewoelkt;14;14;0;Stadt Konstanz, Amt fuer Stadtplanung und Umwelt
01.06.2023 08:00;604;311;293;Leicht bewoelkt;16;16;0;Stadt Konstanz, Amt fuer Stadtplanung und Umwelt
01.06.2023 09:00;665;368;297;Sonnig;18;18;0;Stadt Konstanz, Amt fuer Stadtplanung und Umwelt
01.06.2023 10:00;565;316;249;Leicht bewoelkt;20;20;0;Stadt Konstanz, Amt fuer Stadtplanung und Umwelt
01.06.2023 11:00;641;309;332;Leicht bewoelkt;22;22;0;Stadt Konstanz, Amt fuer Stadtplanung und Umwelt
01.06.2023 12:00;678;304;374;Leicht bewoelkt;23;25;0;Stadt Konstanz, Amt fuer Stadtplanung und Umwelt
01.06.2023 13:00;793;360;433;Leicht bewoelkt;24;25;0;Stadt Konstanz, Amt fuer Stadtplanung und Umwelt
01.06.2023 14:00;720;371;349;Leicht bewoelkt;24;25;0;Stadt Konstanz, Amt fuer Stadtplanung und Umwelt
01.06.2023 15:00;817;442;375;Leicht bewoelkt;24;25;0;Stadt Konstanz, Amt fuer Stadtplanung und Umwelt
01.06.2023 16:00;943;464;479;Leicht bewoelkt;24;25;0;Stadt Konstanz, Amt fuer Stadtplanung und Umwelt
01.06.2023 17:00;1022;508;514;Leicht bewoelkt;23;25;0;Stadt Konstanz, Amt fuer Stadtplanung und Umwelt
01.06.2023 18:00;905;406;499;Sonnig;22;22;0;Stadt Konstanz, Amt fuer Stadtplanung und Umwelt
01.06.2023 19:00;755;336;419;Sonnig;18;18;0;Stadt Konstanz, Amt fuer Stadtplanung und Umwelt
01.06.2023 20:00;598;250;348;Sonnig;14;15;0;Stadt Konstanz, Amt fuer Stadtplanung und Umwelt
01.06.2023 21:00;423;174;249;Sonnig;13;13;0;Stadt Konstanz, Amt fuer Stadtplanung und Umwelt
01.06.2023 22:00;316;145;171;Sonnig;12;12;0;Stadt Konstanz, Amt fuer Stadtplanung und Umwelt
01.06.2023 23:00;221;93;128;Sonnig;12;11;0;Stadt Konstanz, Amt fuer Stadtplanung und Umwelt
02.06.2023 00:00;87;33;54;Sonnig;11;11;0;Stadt Konstanz, Amt fuer Stadtplanung und Umwelt
02.06.2023 01:00;48;24;24;Leicht bewoelkt;11;11;0;Stadt Konstanz, Amt fuer Stadtplanung und Umwelt
02.06.2023 02:00;31;16;15;Leicht bewoelkt;11;10;0;Stadt Konstanz, Amt fuer Stadtplanung und Umwelt
02.06.2023 03:00;19;13;6;Sonnig;10;10;0;Stadt Konstanz, Amt fuer Stadtplanung und Umwelt
02.06.2023 04:00;20;15;5;Sonnig;10;10;0;Stadt Konstanz, Amt fuer Stadtplanung und Umwelt
02.06.2023 05:00;55;38;17;Sonnig;10;10;0;Stadt Konstanz, Amt fuer Stadtplanung und Umwelt
02.06.2023 06:00;180;104;76;Sonnig;13;14;0;Stadt Konstanz, Amt fuer Stadtplanung und Umwelt
02.06.2023 07:00;384;220;164;Sonnig;15;15;0;Stadt Konstanz, Amt fuer Stadtplanung und Umwelt
02.06.2023 08:00;569;304;265;Sonnig;17;17;0;Stadt Konstanz, Amt fuer Stadtplanung und Umwelt
02.06.2023 09:00;592;349;243;Sonnig;19;19;0;Stadt Konstanz, Amt fuer Stadtplanung und Umwelt
02.06.2023 10:00;664;358;306;Sonnig;21;21;0;Stadt Konstanz, Amt fuer Stadtplanung und Umwelt
02.06.2023 11:00;672;358;314;Sonnig;22;22;0;Stadt Konstanz, Amt fuer Stadtplanung und Umwelt
02.06.2023 12:00;713;308;405;Sonnig;23;25;0;Stadt Konstanz, Amt fuer Stadtplanung und Umwelt
02.06.2023 13:00;766;341;425;Sonnig;24;25;0;Stadt Konstanz, Amt fuer Stadtplanung und Umwelt
02.06.2023 14:00;775;391;384;Sonnig;25;25;0;Stadt Konstanz, Amt fuer Stadtplanung und Umwelt
02.06.2023 15:00;816;410;406;Leicht bewoelkt;24;25;0;Stadt Konstanz, Amt fuer Stadtplanung und Umwelt
02.06.2023 16:00;791;374;417;Leicht bewoelkt;23;25;0;Stadt Konstanz, Amt fuer Stadtplanung und Umwelt
02.06.2023 17:00;849;418;431;Sonnig;22;25;0;Stadt Konstanz, Amt fuer Stadtplanung und Umwelt
02.06.2023 18:00;950;558;392;Sonnig;22;22;0;Stadt Konstanz, Amt fuer Stadtplanung und Umwelt
02.06.2023 19:00;829;525;304;Sonnig;20;20;0;Stadt Konstanz, Amt fuer Stadtplanung und Umwelt
02.06.2023 20:00;610;341;269;Sonnig;15;14;0;Stadt Konstanz, Amt fuer Stadtplanung und Umwelt
02.06.2023 21:00;468;210;258;Sonnig;13;12;0;Stadt Konstanz, Amt fuer Stadtplanung und Umwelt
02.06.2023 22:00;469;106;363;Sonnig;12;11;0;Stadt Konstanz, Amt fuer Stadtplanung und Umwelt
02.06.2023 23:00;369;71;298;Sonnig;11;10;0;Stadt Konstanz, Amt fuer Stadtplanung und Umwelt
03.06.2023 00:00;284;39;245;Sonnig;10;10;0;Stadt Konstanz, Amt fuer Stadtplanung und Umwelt
03.06.2023 01:00;144;19;125;Sonnig;10;9;0;Stadt Konstanz, Amt fuer Stadtplanung und Umwelt
03.06.2023 02:00;66;9;57;Leichter Nebel;9;8;0;Stadt Konstanz, Amt fuer Stadtplanung und Umwelt
03.06.2023 03:00;62;23;39;Nebel;8;7;0;Stadt Konstanz, Amt fuer Stadtplanung und Umwelt
03.06.2023 04:00;42;19;23;Nebel;8;7;0;Stadt Konstanz, Amt fuer Stadtplanung und Umwelt
03.06.2023 05:00;32;18;14;Nebel;9;8;0;Stadt Konstanz, Amt fuer Stadtplanung und Umwelt
03.06.2023 06:00;61;38;23;Leicht bewoelkt;11;10;0;Stadt Konstanz, Amt fuer Stadtplanung und Umwelt
03.06.2023 07:00;107;55;52;Bewoelkt;12;12;0;Stadt Konstanz, Amt fuer Stadtplanung und Umwelt
03.06.2023 08:00;251;131;120;Bewoelkt;14;14;0;Stadt Konstanz, Amt fuer Stadtplanung und Umwelt
03.06.2023 09:00;478;290;188;Bewoelkt;16;16;0;Stadt Konstanz, Amt fuer Stadtplanung und Umwelt
03.06.2023 10:00;565;307;258;Leicht bewoelkt;17;17;0;Stadt Konstanz, Amt fuer Stadtplanung und Umwelt
03.06.2023 11:00;740;374;366;Sonnig;19;19;0;Stadt Konstanz, Amt fuer Stadtplanung und Umwelt
03.06.2023 12:00;684;345;339;Sonnig;21;21;0;Stadt Konstanz, Amt fuer Stadtplanung und Umwelt
03.06.2023 13:00;734;354;380;Leicht bewoelkt;23;25;0;Stadt Konstanz, Amt fuer Stadtplanung und Umwelt
03.06.2023 14:00;709;336;373;Leicht bewoelkt;23;25;0;Stadt Konstanz, Amt fuer Stadtplanung und Umwelt
03.06.2023 15:00;774;400;374;Leicht bewoelkt;23;25;0;Stadt Konstanz, Amt fuer Stadtplanung und Umwelt
03.06.2023 16:00;646;316;330;Leicht bewoelkt;22;24;0;Stadt Konstanz, Amt fuer Stadtplanung und Umwelt
03.06.2023 17:00;696;356;340;Leicht bewoelkt;21;21;0;Stadt Konstanz, Amt fuer Stadtplanung und Umwelt
03.06.2023 18:00;740;357;383;Sonnig;21;21;0;Stadt Konstanz, Amt fuer Stadtplanung und Umwelt
03.06.2023 19:00;554;252;302;Sonnig;19;19;0;Stadt Konstanz, Amt fuer Stadtplanung und Umwelt
03.06.2023 20:00;393;169;224;Sonnig;14;14;0;Stadt Konstanz, Amt fuer Stadtplanung und Umwelt
03.06.2023 21:00;409;187;222;Sonnig;12;12;0;Stadt Konstanz, Amt fuer Stadtplanung und Umwelt
03.06.2023 22:00;338;161;177;Leicht bewoelkt;11;11;0;Stadt Konstanz, Amt fuer Stadtplanung und Umwelt
03.06.2023 23:00;205;75;130;Leicht bewoelkt;11;10;0;Stadt Konstanz, Amt fuer Stadtplanung und Umwelt
04.06.2023 00:00;157;60;97;Sonnig;10;9;0;Stadt Konstanz, Amt fuer Stadtplanung und Umwelt
04.06.2023 01:00;91;22;69;Sonnig;10;9;0;Stadt Konstanz, Amt fuer Stadtplanung und Umwelt
04.06.2023 02:00;74;22;52;Sonnig;9;8;0;Stadt Konstanz, Amt fuer Stadtplanung und Umwelt
04.06.2023 03:00;44;12;32;Leichter Nebel;9;8;0;Stadt Konstanz, Amt fuer Stadtplanung und Umwelt
04.06.2023 04:00;33;18;15;Leichter Nebel;8;7;0;Stadt Konstanz, Amt fuer Stadtplanung und Umwelt
04.06.2023 05:00;44;22;22;Leicht bewoelkt;8;7;0;Stadt Konstanz, Amt fuer Stadtplanung und Umwelt
04.06.2023 06:00;30;20;10;Sonnig;11;11;0;Stadt Konstanz, Amt fuer Stadtplanung und Umwelt
04.06.2023 07:00;57;27;30;Sonnig;13;13;0;Stadt Konstanz, Amt fuer Stadtplanung und Umwelt
04.06.2023 08:00;132;74;58;Sonnig;15;15;0;Stadt Konstanz, Amt fuer Stadtplanung und Umwelt
04.06.2023 09:00;335;171;164;Sonnig;17;17;0;Stadt Konstanz, Amt fuer Stadtplanung und Umwelt
04.06.2023 10:00;453;215;238;Sonnig;19;19;0;Stadt Konstanz, Amt fuer Stadtplanung und Umwelt
04.06.2023 11:00;547;302;245;Sonnig;21;21;0;Stadt Konstanz, Amt fuer Stadtplanung und Umwelt
04.06.2023 12:00;568;315;253;Sonnig;22;22;0;Stadt Konstanz, Amt fuer Stadtplanung und Umwelt
04.06.2023 13:00;626;334;292;Leicht bewoelkt;22;24;0;Stadt Konstanz, Amt fuer Stadtplanung und Umwelt
04.06.2023 14:00;716;398;318;Leicht bewoelkt;22;24;0;Stadt Konstanz, Amt fuer Stadtplanung und Umwelt
04.06.2023 15:00;701;351;350;Leicht bewoelkt;22;25;0;Stadt Konstanz, Amt fuer Stadtplanung und Umwelt
04.06.2023 16:00;694;324;370;Stellenweiser Regenfall;22;22;0.1;Stadt Konstanz, Amt fuer Stadtplanung und Umwelt
04.06.2023 17:00;780;345;435;Stellenweiser Regenfall;21;21;0.1;Stadt Konstanz, Amt fuer Stadtplanung und Umwelt
04.06.2023 18:00;618;270;348;Stellenweiser Regenfall;20;20;0.1;Stadt Konstanz, Amt fuer Stadtplanung und Umwelt
04.06.2023 19:00;534;243;291;Stellenweiser Regenfall;18;18;0.5;Stadt Konstanz, Amt fuer Stadtplanung und Umwelt
04.06.2023 20:00;425;164;261;Leicht bewoelkt;14;14;0;Stadt Konstanz, Amt fuer Stadtplanung und Umwelt
04.06.2023 21:00;274;110;164;Leicht bewoelkt;13;13;0;Stadt Konstanz, Amt fuer Stadtplanung und Umwelt
04.06.2023 22:00;203;79;124;Leicht bewoelkt;12;12;0;Stadt Konstanz, Amt fuer Stadtplanung und Umwelt
04.06.2023 23:00;74;25;49;Leicht bewoelkt;12;12;0;Stadt Konstanz, Amt fuer Stadtplanung und Umwelt
05.06.2023 00:00;37;21;16;Sonnig;10;9;0;Stadt Konstanz, Amt fuer Stadtplanung und Umwelt
05.06.2023 01:00;14;3;11;Sonnig;10;9;0;Stadt Konstanz, Amt fuer Stadtplanung und Umwelt
05.06.2023 02:00;16;10;6;Sonnig;9;8;0;Stadt Konstanz, Amt fuer Stadtplanung und Umwelt
05.06.2023 03:00;4;2;2;Sonnig;9;8;0;Stadt Konstanz, Amt fuer Stadtplanung und Umwelt
05.06.2023 04:00;7;4;3;Sonnig;8;7;0;Stadt Konstanz, Amt fuer Stadtplanung und Umwelt
05.06.2023 05:00;61;42;19;Sonnig;8;8;0;Stadt Konstanz, Amt fuer Stadtplanung und Umwelt
05.06.2023 06:00;192;119;73;Sonnig;11;11;0;Stadt Konstanz, Amt fuer Stadtplanung und Umwelt
05.06.2023 07:00;433;253;180;Sonnig;14;14;0;Stadt Konstanz, Amt fuer Stadtplanung und Umwelt
05.06.2023 08:00;595;344;251;Leicht bewoelkt;16;16;0;Stadt Konstanz, Amt fuer Stadtplanung und Umwelt
05.06.2023 09:00;651;409;242;Sonnig;18;18;0;Stadt Konstanz, Amt fuer Stadtplanung und Umwelt
05.06.2023 10:00;525;292;233;Leicht bewoelkt;20;20;0;Stadt Konstanz, Amt fuer Stadtplanung und Umwelt
05.06.2023 11:00;669;360;309;Leicht bewoelkt;22;22;0;Stadt Konstanz, Amt fuer Stadtplanung und Umwelt
05.06.2023 12:00;698;326;372;Leicht bewoelkt;23;25;0;Stadt Konstanz, Amt fuer Stadtplanung und Umwelt
05.06.2023 13:00;706;350;356;Sonnig;23;25;0;Stadt Konstanz, Amt fuer Stadtplanung und Umwelt
05.06.2023 14:00;729;379;350;Sonnig;24;25;0;Stadt Konstanz, Amt fuer Stadtplanung und Umwelt
05.06.2023 15:00;843;411;432;Sonnig;24;25;0;Stadt Konstanz, Amt fuer Stadtplanung und Umwelt
05.06.2023 16:00;892;407;485;Sonnig;23;25;0;Stadt Konstanz, Amt fuer Stadtplanung und Umwelt
05.06.2023 17:00;1086;497;589;Sonnig;23;25;0;Stadt Konstanz, Amt fuer Stadtplanung und Umwelt
05.06.2023 18:00;921;407;514;Sonnig;21;21;0;Stadt Konstanz, Amt fuer Stadtplanung und Umwelt
05.06.2023 19:00;685;266;419;Stellenweiser Regenfall;18;18;0.1;Stadt Konstanz, Amt fuer Stadtplanung und Umwelt
05.06.2023 20:00;522;230;292;Sonnig;14;14;0;Stadt Konstanz, Amt fuer Stadtplanung und Umwelt
05.06.2023 21:00;346;136;210;Sonnig;13;12;0;Stadt Konstanz, Amt fuer Stadtplanung und Umwelt
05.06.2023 22:00;244;103;141;Sonnig;12;11;0;Stadt Konstanz, Amt fuer Stadtplanung und Umwelt
05.06.2023 23:00;132;54;78;Sonnig;11;10;0;Stadt Konstanz, Amt fuer Stadtplanung und Umwelt
06.06.2023 00:00;37;18;19;Sonnig;10;10;0;Stadt Konstanz, Amt fuer Stadtplanung und Umwelt
06.06.2023 01:00;24;11;13;Leichter Nebel;10;9;0.1;Stadt Konstanz, Amt fuer Stadtplanung und Umwelt
06.06.2023 02:00;6;2;4;Leichter Nebel;10;9;0;Stadt Konstanz, Amt fuer Stadtplanung und Umwelt
06.06.2023 03:00;11;6;5;Nebel;9;8;0;Stadt Konstanz, Amt fuer Stadtplanung und Umwelt
06.06.2023 04:00;17;9;8;Nebel;9;8;0;Stadt Konstanz, Amt fuer Stadtplanung und Umwelt
06.06.2023 05:00;58;39;19;Nebel;9;8;0;Stadt Konstanz, Amt fuer Stadtplanung und Umwelt
06.06.2023 06:00;200;121;79;Leichter Nebel;12;12;0;Stadt Konstanz, Amt fuer Stadtplanung und Umwelt
06.06.2023 07:00;487;320;167;Leicht bewoelkt;14;14;0;Stadt Konstanz, Amt fuer Stadtplanung und Umwelt
06.06.2023 08:00;673;410;263;Leicht bewoelkt;16;16;0;Stadt Konstanz, Amt fuer Stadtplanung und Umwelt
06.06.2023 09:00;719;465;254;Sonnig;18;18;0;Stadt Konstanz, Amt fuer Stadtplanung und Umwelt
06.06.2023 10:00;584;348;236;Sonnig;20;20;0;Stadt Konstanz, Amt fuer Stadtplanung und Umwelt
06.06.2023 11:00;670;357;313;Sonnig;22;22;0;Stadt Konstanz, Amt fuer Stadtplanung und Umwelt
06.06.2023 12:00;722;344;378;Leicht bewoelkt;22;24;0;Stadt Konstanz, Amt fuer Stadtplanung und Umwelt
06.06.2023 13:00;850;406;444;Sonnig;23;25;0;Stadt Konstanz, Amt fuer Stadtplanung und Umwelt
06.06.2023 14:00;762;375;387;Sonnig;24;25;0;Stadt Konstanz, Amt fuer Stadtplanung und Umwelt
06.06.2023 15:00;842;398;444;Sonnig;24;25;0;Stadt Konstanz, Amt fuer Stadtplanung und Umwelt
06.06.2023 16:00;939;435;504;Sonnig;23;25;0;Stadt Konstanz, Amt fuer Stadtplanung und Umwelt
06.06.2023 17:00;1139;537;602;Sonnig;22;22;0;Stadt Konstanz, Amt fuer Stadtplanung und Umwelt
06.06.2023 18:00;907;366;541;Sonnig;20;20;0;Stadt Konstanz, Amt fuer Stadtplanung und Umwelt
06.06.2023 19:00;749;281;468;Sonnig;18;18;0;Stadt Konstanz, Amt fuer Stadtplanung und Umwelt
06.06.2023 20:00;501;223;278;Leicht bewoelkt;16;16;0;Stadt Konstanz, Amt fuer Stadtplanung und Umwelt
06.06.2023 21:00;453;169;284;Leicht bewoelkt;15;15;0;Stadt Konstanz, Amt fuer Stadtplanung und Umwelt
06.06.2023 22:00;296;123;173;Leicht bewoelkt;14;14;0;Stadt Konstanz, Amt fuer Stadtplanung und Umwelt
06.06.2023 23:00;136;46;90;Sonnig;13;13;0;Stadt Konstanz, Amt fuer Stadtplanung und Umwelt
07.06.2023 00:00;68;21;47;Leichter Nebel;9;8;0;Stadt Konstanz, Amt fuer Stadtplanung und Umwelt
07.06.2023 01:00;40;19;21;Sonnig;9;8;0;Stadt Konstanz, Amt fuer Stadtplanung und Umwelt
07.06.2023 02:00;13;3;10;Leichter Nebel;8;7;0;Stadt Konstanz, Amt fuer Stadtplanung und Umwelt
07.06.2023 03:00;6;1;5;Leichter Nebel;8;7;0;Stadt Konstanz, Amt fuer Stadtplanung und Umwelt
07.06.2023 04:00;17;10;7;Leichter Nebel;8;7;0;Stadt Konstanz, Amt fuer Stadtplanung und Umwelt
07.06.2023 05:00;75;53;22;Leichter Nebel;8;7;0;Stadt Konstanz, Amt fuer Stadtplanung und Umwelt
07.06.2023 06:00;174;107;67;Sonnig;11;11;0;Stadt Konstanz, Amt fuer Stadtplanung und Umwelt
07.06.2023 07:00;511;347;164;Sonnig;14;15;0;Stadt Konstanz, Amt fuer Stadtplanung und Umwelt
07.06.2023 08:00;677;384;293;Sonnig;16;16;0;Stadt Konstanz, Amt fuer Stadtplanung und Umwelt
07.06.2023 09:00;642;415;227;Sonnig;18;18;0;Stadt Konstanz, Amt fuer Stadtplanung und Umwelt
07.06.2023 10:00;610;357;253;Sonnig;20;20;0;Stadt Konstanz, Amt fuer Stadtplanung und Umwelt
07.06.2023 11:00;674;346;328;Sonnig;22;24;0;Stadt Konstanz, Amt fuer Stadtplanung und Umwelt
07.06.2023 12:00;735;363;372;Sonnig;24;25;0;Stadt Konstanz, Amt fuer Stadtplanung und Umwelt
07.06.2023 13:00;772;380;392;Sonnig;25;25;0;Stadt Konstanz, Amt fuer Stadtplanung und Umwelt
07.06.2023 14:00;708;360;348;Sonnig;25;25;0;Stadt Konstanz, Amt fuer Stadtplanung und Umwelt
07.06.2023 15:00;824;362;462;Sonnig;26;26;0;Stadt Konstanz, Amt fuer Stadtplanung und Umwelt
07.06.2023 16:00;932;444;488;Sonnig;25;25;0;Stadt Konstanz, Amt fuer Stadtplanung und Umwelt
07.06.2023 17:00;1101;495;606;Stellenweise Gewitter und Niederschlaege;24;25;0;Stadt Konstanz, Amt fuer Stadtplanung und Umwelt
07.06.2023 18:00;1018;503;515;Stellenweise Gewitter und Niederschlaege;20;20;0;Stadt Konstanz, Amt fuer Stadtplanung und Umwelt
07.06.2023 19:00;806;371;435;Stellenweise Gewitter und Niederschlaege;18;18;0;Stadt Konstanz, Amt fuer Stadtplanung und Umwelt
07.06.2023 20:00;589;273;316;Stellenweiser Regenfall;15;15;0.2;Stadt Konstanz, Amt fuer Stadtplanung und Umwelt
07.06.2023 21:00;492;204;288;Stellenweiser Regenfall;13;13;0.1;Stadt Konstanz, Amt fuer Stadtplanung und Umwelt
07.06.2023 22:00;357;129;228;Nieselregen mit Gewitter;12;12;0.2;Stadt Konstanz, Amt fuer Stadtplanung und Umwelt
07.06.2023 23:00;258;84;174;Stellenweiser Regenfall;12;11;0.1;Stadt Konstanz, Amt fuer Stadtplanung und Umwelt
08.06.2023 00:00;184;34;150;Sonnig;11;11;0;Stadt Konstanz, Amt fuer Stadtplanung und Umwelt
08.06.2023 01:00;67;21;46;Sonnig;11;11;0;Stadt Konstanz, Amt fuer Stadtplanung und Umwelt
08.06.2023 02:00;52;9;43;Sonnig;10;10;0;Stadt Konstanz, Amt fuer Stadtplanung und Umwelt
08.06.2023 03:00;44;13;31;Sonnig;10;10;0;Stadt Konstanz, Amt fuer Stadtplanung und Umwelt
08.06.2023 04:00;19;14;5;Sonnig;9;9;0;Stadt Konstanz, Amt fuer Stadtplanung und Umwelt
08.06.2023 05:00;40;30;10;Leicht bewoelkt;10;10;0;Stadt Konstanz, Amt fuer Stadtplanung und Umwelt
08.06.2023 06:00;68;55;13;Leicht bewoelkt;12;12;0;Stadt Konstanz, Amt fuer Stadtplanung und Umwelt
08.06.2023 07:00;146;109;37;Leicht bewoelkt;15;15;0;Stadt Konstanz, Amt fuer Stadtplanung und Umwelt
08.06.2023 08:00;240;135;105;Stellenweise Gewitter und Niederschlaege;18;18;0;Stadt Konstanz, Amt fuer Stadtplanung und Umwelt
08.06.2023 09:00;335;185;150;Stellenweise Gewitter und Niederschlaege;19;19;0;Stadt Konstanz, Amt fuer Stadtplanung und Umwelt
08.06.2023 10:00;424;219;205;Stellenweise Gewitter und Niederschlaege;21;21;0;Stadt Konstanz, Amt fuer Stadtplanung und Umwelt
08.06.2023 11:00;439;226;213;Sonnig;24;25;0;Stadt Konstanz, Amt fuer Stadtplanung und Umwelt
08.06.2023 12:00;525;261;264;Sonnig;28;28;0;Stadt Konstanz, Amt fuer Stadtplanung und Umwelt
08.06.2023 13:00;511;237;274;Sonnig;29;29;0;Stadt Konstanz, Amt fuer Stadtplanung und Umwelt
08.06.2023 14:00;558;259;299;Stellenweise Gewitter und Niederschlaege;27;27;0;Stadt Konstanz, Amt fuer Stadtplanung und Umwelt
08.06.2023 15:00;586;320;266;Leicht bewoelkt;27;26;0;Stadt Konstanz, Amt fuer Stadtplanung und Umwelt
08.06.2023 16:00;615;280;335;Stellenweise Gewitter und Niederschlaege;25;25;0;Stadt Konstanz, Amt fuer Stadtplanung und Umwelt
08.06.2023 17:00;687;322;365;Stellenweise Gewitter und Niederschlaege;21;21;0;Stadt Konstanz, Amt fuer Stadtplanung und Umwelt
08.06.2023 18:00;666;328;338;Sonnig;20;20;0;Stadt Konstanz, Amt fuer Stadtplanung und Umwelt
08.06.2023 19:00;574;267;307;Sonnig;18;18;0;Stadt Konstanz, Amt fuer Stadtplanung und Umwelt
08.06.2023 20:00;555;270;285;Leicht bewoelkt;14;14;0;Stadt Konstanz, Amt fuer Stadtplanung und Umwelt
08.06.2023 21:00;345;143;202;Sonnig;12;13;0;Stadt Konstanz, Amt fuer Stadtplanung und Umwelt
08.06.2023 22:00;282;96;186;Leichter Nebel;12;12;0;Stadt Konstanz, Amt fuer Stadtplanung und Umwelt
08.06.2023 23:00;186;82;104;Leichter Nebel;11;11;0;Stadt Konstanz, Amt fuer Stadtplanung und Umwelt
09.06.2023 00:00;79;28;51;Sonnig;11;11;0;Stadt Konstanz, Amt fuer Stadtplanung und Umwelt
09.06.2023 01:00;39;16;23;Sonnig;11;11;0;Stadt Konstanz, Amt fuer Stadtplanung und Umwelt
09.06.2023 02:00;19;5;14;Sonnig;10;10;0;Stadt Konstanz, Amt fuer Stadtplanung und Umwelt
09.06.2023 03:00;20;9;11;Sonnig;10;10;0;Stadt Konstanz, Amt fuer Stadtplanung und Umwelt
09.06.2023 04:00;18;5;13;Sonnig;9;10;0;Stadt Konstanz, Amt fuer Stadtplanung und Umwelt
09.06.2023 05:00;60;43;17;Sonnig;9;9;0;Stadt Konstanz, Amt fuer Stadtplanung und Umwelt
09.06.2023 06:00;128;79;49;Sonnig;12;13;0;Stadt Konstanz, Amt fuer Stadtplanung und Umwelt
09.06.2023 07:00;318;201;117;Sonnig;15;15;0;Stadt Konstanz, Amt fuer Stadtplanung und Umwelt
09.06.2023 08:00;525;298;227;Sonnig;18;18;0;Stadt Konstanz, Amt fuer Stadtplanung und Umwelt
09.06.2023 09:00;751;491;260;Sonnig;20;20;0;Stadt Konstanz, Amt fuer Stadtplanung und Umwelt
09.06.2023 10:00;732;406;326;Sonnig;22;25;0;Stadt Konstanz, Amt fuer Stadtplanung und Umwelt
09.06.2023 11:00;862;461;401;Sonnig;25;25;0;Stadt Konstanz, Amt fuer Stadtplanung und Umwelt
09.06.2023 12:00;848;380;468;Sonnig;29;29;0;Stadt Konstanz, Amt fuer Stadtplanung und Umwelt
09.06.2023 13:00;795;359;436;Sonnig;30;29;0;Stadt Konstanz, Amt fuer Stadtplanung und Umwelt
09.06.2023 14:00;812;403;409;Sonnig;30;29;0;Stadt Konstanz, Amt fuer Stadtplanung und Umwelt
09.06.2023 15:00;853;368;485;Sonnig;30;29;0;Stadt Konstanz, Amt fuer Stadtplanung und Umwelt
09.06.2023 16:00;838;394;444;Leicht bewoelkt;27;27;0;Stadt Konstanz, Amt fuer Stadtplanung und Umwelt
09.06.2023 17:00;908;427;481;Leicht bewoelkt;26;26;0;Stadt Konstanz, Amt fuer Stadtplanung und Umwelt
09.06.2023 18:00;825;375;450;Leicht bewoelkt;23;25;0;Stadt Konstanz, Amt fuer Stadtplanung und Umwelt
09.06.2023 19:00;677;318;359;Leicht bewoelkt;20;20;0;Stadt Konstanz, Amt fuer Stadtplanung und Umwelt
09.06.2023 20:00;600;292;308;Sonnig;18;18;0;Stadt Konstanz, Amt fuer Stadtplanung und Umwelt
09.06.2023 21:00;442;176;266;Sonnig;16;16;0;Stadt Konstanz, Amt fuer Stadtplanung und Umwelt
09.06.2023 22:00;342;140;202;Sonnig;15;15;0;Stadt Konstanz, Amt fuer Stadtplanung und Umwelt
09.06.2023 23:00;258;102;156;Sonnig;14;14;0;Stadt Konstanz, Amt fuer Stadtplanung und Umwelt
10.06.2023 00:00;172;53;119;Sonnig;13;12;0;Stadt Konstanz, Amt fuer Stadtplanung und Umwelt
10.06.2023 01:00;80;28;52;Sonnig;12;11;0;Stadt Konstanz, Amt fuer Stadtplanung und Umwelt
10.06.2023 02:00;51;10;41;Leichter Nebel;12;11;0;Stadt Konstanz, Amt fuer Stadtplanung und Umwelt
10.06.2023 03:00;29;13;16;Leichter Nebel;11;11;0;Stadt Konstanz, Amt fuer Stadtplanung und Umwelt
10.06.2023 04:00;44;11;33;Leichter Nebel;11;11;0;Stadt Konstanz, Amt fuer Stadtplanung und Umwelt
10.06.2023 05:00;32;16;16;Leichter Nebel;11;11;0;Stadt Konstanz, Amt fuer Stadtplanung und Umwelt
10.06.2023 06:00;65;36;29;Leicht bewoelkt;14;14;0;Stadt Konstanz, Amt fuer Stadtplanung und Umwelt
10.06.2023 07:00;115;55;60;Leicht bewoelkt;16;16;0;Stadt Konstanz, Amt fuer Stadtplanung und Umwelt
10.06.2023 08:00;267;150;117;Leicht bewoelkt;18;18;0;Stadt Konstanz, Amt fuer Stadtplanung und Umwelt
10.06.2023 09:00;508;310;198;Sonnig;20;20;0;Stadt Konstanz, Amt fuer Stadtplanung und Umwelt
10.06.2023 10:00;700;415;285;Leicht bewoelkt;22;22;0;Stadt Konstanz, Amt fuer Stadtplanung und Umwelt
10.06.2023 11:00;688;373;315;Leicht bewoelkt;24;25;0;Stadt Konstanz, Amt fuer Stadtplanung und Umwelt
10.06.2023 12:00;774;382;392;Leicht bewoelkt;25;26;0;Stadt Konstanz, Amt fuer Stadtplanung und Umwelt
10.06.2023 13:00;741;359;382;Sonnig;26;26;0;Stadt Konstanz, Amt fuer Stadtplanung und Umwelt
10.06.2023 14:00;738;338;400;Sonnig;26;26;0;Stadt Konstanz, Amt fuer Stadtplanung und Umwelt
10.06.2023 15:00;758;366;392;Sonnig;26;26;0;Stadt Konstanz, Amt fuer Stadtplanung und Umwelt
10.06.2023 16:00;702;321;381;Sonnig;26;26;0;Stadt Konstanz, Amt fuer Stadtplanung und Umwelt
10.06.2023 17:00;689;301;388;Sonnig;25;26;0;Stadt Konstanz, Amt fuer Stadtplanung und Umwelt
10.06.2023 18:00;748;337;411;Sonnig;22;22;0;Stadt Konstanz, Amt fuer Stadtplanung und Umwelt
10.06.2023 19:00;604;307;297;Sonnig;21;21;0;Stadt Konstanz, Amt fuer Stadtplanung und Umwelt
10.06.2023 20:00;545;256;289;Sonnig;19;19;0;Stadt Konstanz, Amt fuer Stadtplanung und Umwelt
10.06.2023 21:00;385;166;219;Sonnig;18;18;0;Stadt Konstanz, Amt fuer Stadtplanung und Umwelt
10.06.2023 22:00;289;133;156;Sonnig;17;17;0;Stadt Konstanz, Amt fuer Stadtplanung und Umwelt
10.06.2023 23:00;337;159;178;Sonnig;14;14;0;Stadt Konstanz, Amt fuer Stadtplanung und Umwelt
11.06.2023 00:00;253;101;152;Leichter Nebel;14;13;0;Stadt Konstanz, Amt fuer Stadtplanung und Umwelt
11.06.2023 01:00;98;36;62;Leichter Nebel;13;13;0.1;Stadt Konstanz, Amt fuer Stadtplanung und Umwelt
11.06.2023 02:00;107;28;79;Leichter Nebel;13;12;0;Stadt Konstanz, Amt fuer Stadtplanung und Umwelt
11.06.2023 03:00;50;19;31;Nebel;12;12;0;Stadt Konstanz, Amt fuer Stadtplanung und Umwelt
11.06.2023 04:00;31;11;20;Nebel;12;12;0;Stadt Konstanz, Amt fuer Stadtplanung und Umwelt
11.06.2023 05:00;28;13;15;Nebel;12;12;0;Stadt Konstanz, Amt fuer Stadtplanung und Umwelt
11.06.2023 06:00;58;27;31;Leichter Nebel;14;15;0;Stadt Konstanz, Amt fuer Stadtplanung und Umwelt
11.06.2023 07:00;68;44;24;Bewoelkt;16;16;0;Stadt Konstanz, Amt fuer Stadtplanung und Umwelt
11.06.2023 08:00;163;83;80;Bewoelkt;18;18;0;Stadt Konstanz, Amt fuer Stadtplanung und Umwelt
11.06.2023 09:00;407;225;182;Sonnig;20;20;0;Stadt Konstanz, Amt fuer Stadtplanung und Umwelt
11.06.2023 10:00;445;248;197;Leicht bewoelkt;21;21;0;Stadt Konstanz, Amt fuer Stadtplanung und Umwelt
11.06.2023 11:00;512;229;283;Leicht bewoelkt;22;25;0;Stadt Konstanz, Amt fuer Stadtplanung und Umwelt
11.06.2023 12:00;450;203;247;Leicht bewoelkt;22;25;0;Stadt Konstanz, Amt fuer Stadtplanung und Umwelt
11.06.2023 13:00;499;249;250;Leicht bewoelkt;23;25;0;Stadt Konstanz, Amt fuer Stadtplanung und Umwelt
11.06.2023 14:00;643;335;308;Sonnig;24;25;0;Stadt Konstanz, Amt fuer Stadtplanung und Umwelt
11.06.2023 15:00;597;305;292;Leicht bewoelkt;23;25;0;Stadt Konstanz, Amt fuer Stadtplanung und Umwelt
11.06.2023 16:00;611;321;290;Leicht bewoelkt;22;25;0;Stadt Konstanz, Amt fuer Stadtplanung und Umwelt
11.06.2023 17:00;683;345;338;Leicht bewoelkt;22;22;0;Stadt Konstanz, Amt fuer Stadtplanung und Umwelt
11.06.2023 18:00;662;333;329;Sonnig;22;25;0;Stadt Konstanz, Amt fuer Stadtplanung und Umwelt
11.06.2023 19:00;570;267;303;Sonnig;22;22;0;Stadt Konstanz, Amt fuer Stadtplanung und Umwelt
11.06.2023 20:00;399;176;223;Sonnig;16;16;0;Stadt Konstanz, Amt fuer Stadtplanung und Umwelt
11.06.2023 21:00;323;146;177;Sonnig;14;13;0;Stadt Konstanz, Amt fuer Stadtplanung und Umwelt
11.06.2023 22:00;243;76;167;Sonnig;13;12;0;Stadt Konstanz, Amt fuer Stadtplanung und Umwelt
11.06.2023 23:00;102;35;67;Sonnig;12;12;0;Stadt Konstanz, Amt fuer Stadtplanung und Umwelt
12.06.2023 00:00;46;21;25;Sonnig;14;13;0;Stadt Konstanz, Amt fuer Stadtplanung und Umwelt
12.06.2023 01:00;20;4;16;Sonnig;14;13;0;Stadt Konstanz, Amt fuer Stadtplanung und Umwelt
12.06.2023 02:00;12;8;4;Sonnig;13;12;0;Stadt Konstanz, Amt fuer Stadtplanung und Umwelt
12.06.2023 03:00;5;2;3;Sonnig;12;11;0;Stadt Konstanz, Amt fuer Stadtplanung und Umwelt
12.06.2023 04:00;13;6;7;Sonnig;11;10;0;Stadt Konstanz, Amt fuer Stadtplanung und Umwelt
12.06.2023 05:00;59;41;18;Sonnig;11;10;0;Stadt Konstanz, Amt fuer Stadtplanung und Umwelt
12.06.2023 06:00;247;147;100;Leicht bewoelkt;13;12;0;Stadt Konstanz, Amt fuer Stadtplanung und Umwelt
12.06.2023 07:00;1164;778;386;Leicht bewoelkt;15;14;0;Stadt Konstanz, Amt fuer Stadtplanung und Umwelt
12.06.2023 08:00;905;498;407;Leicht bewoelkt;17;17;0;Stadt Konstanz, Amt fuer Stadtplanung und Umwelt
12.06.2023 09:00;923;529;394;Sonnig;18;18;0;Stadt Konstanz, Amt fuer Stadtplanung und Umwelt
12.06.2023 10:00;697;410;287;Leicht bewoelkt;20;20;0;Stadt Konstanz, Amt fuer Stadtplanung und Umwelt
12.06.2023 11:00;853;422;431;Sonnig;22;25;0;Stadt Konstanz, Amt fuer Stadtplanung und Umwelt
12.06.2023 12:00;829;396;433;Sonnig;23;25;0;Stadt Konstanz, Amt fuer Stadtplanung und Umwelt
12.06.2023 13:00;1150;522;628;Sonnig;24;25;0;Stadt Konstanz, Amt fuer Stadtplanung und Umwelt
12.06.2023 14:00;895;467;428;Sonnig;24;25;0;Stadt Konstanz, Amt fuer Stadtplanung und Umwelt
12.06.2023 15:00;1235;595;640;Sonnig;24;25;0;Stadt Konstanz, Amt fuer Stadtplanung und Umwelt
12.06.2023 16:00;1153;536;617;Sonnig;24;25;0;Stadt Konstanz, Amt fuer Stadtplanung und Umwelt
12.06.2023 17:00;1368;614;754;Sonnig;24;25;0;Stadt Konstanz, Amt fuer Stadtplanung und Umwelt
12.06.2023 18:00;1136;534;602;Sonnig;23;25;0;Stadt Konstanz, Amt fuer Stadtplanung und Umwelt
12.06.2023 19:00;943;421;522;Sonnig;21;21;0;Stadt Konstanz, Amt fuer Stadtplanung und Umwelt
12.06.2023 20:00;656;285;371;Sonnig;17;17;0;Stadt Konstanz, Amt fuer Stadtplanung und Umwelt
12.06.2023 21:00;522;227;295;Sonnig;16;16;0;Stadt Konstanz, Amt fuer Stadtplanung und Umwelt
12.06.2023 22:00;319;130;189;Sonnig;15;14;0;Stadt Konstanz, Amt fuer Stadtplanung und Umwelt
12.06.2023 23:00;195;76;119;Sonnig;14;13;0;Stadt Konstanz, Amt fuer Stadtplanung und Umwelt
13.06.2023 00:00;136;48;88;Sonnig;13;11;0;Stadt Konstanz, Amt fuer Stadtplanung und Umwelt
13.06.2023 01:00;19;4;15;Sonnig;12;10;0;Stadt Konstanz, Amt fuer Stadtplanung und Umwelt
13.06.2023 02:00;7;4;3;Sonnig;11;9;0;Stadt Konstanz, Amt fuer Stadtplanung und Umwelt
13.06.2023 03:00;9;3;6;Sonnig;10;8;0;Stadt Konstanz, Amt fuer Stadtplanung und Umwelt
13.06.2023 04:00;10;7;3;Sonnig;9;7;0;Stadt Konstanz, Amt fuer Stadtplanung und Umwelt
13.06.2023 05:00;67;52;15;Sonnig;8;6;0;Stadt Konstanz, Amt fuer Stadtplanung und Umwelt
13.06.2023 06:00;237;143;94;Sonnig;10;9;0;Stadt Konstanz, Amt fuer Stadtplanung und Umwelt
13.06.2023 07:00;1249;790;459;Sonnig;12;11;0;Stadt Konstanz, Amt fuer Stadtplanung und Umwelt
13.06.2023 08:00;1042;600;442;Sonnig;14;13;0;Stadt Konstanz, Amt fuer Stadtplanung und Umwelt
13.06.2023 09:00;998;553;445;Sonnig;16;16;0;Stadt Konstanz, Amt fuer Stadtplanung und Umwelt
13.06.2023 10:00;736;412;324;Sonnig;18;18;0;Stadt Konstanz, Amt fuer Stadtplanung und Umwelt
13.06.2023 11:00;874;415;459;Sonnig;22;24;0;Stadt Konstanz, Amt fuer Stadtplanung und Umwelt
13.06.2023 12:00;828;369;459;Sonnig;23;24;0;Stadt Konstanz, Amt fuer Stadtplanung und Umwelt
13.06.2023 13:00;1156;513;643;Sonnig;23;24;0;Stadt Konstanz, Amt fuer Stadtplanung und Umwelt
13.06.2023 14:00;953;454;499;Sonnig;23;24;0;Stadt Konstanz, Amt fuer Stadtplanung und Umwelt
13.06.2023 15:00;1268;585;683;Sonnig;23;24;0;Stadt Konstanz, Amt fuer Stadtplanung und Umwelt
13.06.2023 16:00;1293;601;692;Sonnig;23;24;0;Stadt Konstanz, Amt fuer Stadtplanung und Umwelt
13.06.2023 17:00;1488;690;798;Sonnig;24;25;0;Stadt Konstanz, Amt fuer Stadtplanung und Umwelt
13.06.2023 18:00;1316;618;698;Sonnig;23;25;0;Stadt Konstanz, Amt fuer Stadtplanung und Umwelt
13.06.2023 19:00;1067;538;529;Sonnig;21;21;0;Stadt Konstanz, Amt fuer Stadtplanung und Umwelt
13.06.2023 20:00;743;354;389;Sonnig;15;15;0;Stadt Konstanz, Amt fuer Stadtplanung und Umwelt
13.06.2023 21:00;633;239;394;Sonnig;13;12;0;Stadt Konstanz, Amt fuer Stadtplanung und Umwelt
13.06.2023 22:00;459;170;289;Sonnig;11;10;0;Stadt Konstanz, Amt fuer Stadtplanung und Umwelt
13.06.2023 23:00;244;56;188;Sonnig;11;9;0;Stadt Konstanz, Amt fuer Stadtplanung und Umwelt
14.06.2023 00:00;92;33;59;Sonnig;9;8;0;Stadt Konstanz, Amt fuer Stadtplanung und Umwelt
14.06.2023 01:00;49;21;28;Sonnig;8;7;0;Stadt Konstanz, Amt fuer Stadtplanung und Umwelt
14.06.2023 02:00;22;6;16;Sonnig;8;6;0;Stadt Konstanz, Amt fuer Stadtplanung und Umwelt
14.06.2023 03:00;21;7;14;Sonnig;7;6;0;Stadt Konstanz, Amt fuer Stadtplanung und Umwelt
14.06.2023 04:00;17;9;8;Sonnig;7;6;0;Stadt Konstanz, Amt fuer Stadtplanung und Umwelt
14.06.2023 05:00;67;44;23;Sonnig;7;6;0;Stadt Konstanz, Amt fuer Stadtplanung und Umwelt
14.06.2023 06:00;231;137;94;Sonnig;10;10;0;Stadt Konstanz, Amt fuer Stadtplanung und Umwelt
14.06.2023 07:00;1170;769;401;Sonnig;13;13;0;Stadt Konstanz, Amt fuer Stadtplanung und Umwelt
14.06.2023 08:00;1043;581;462;Sonnig;16;16;0;Stadt Konstanz, Amt fuer Stadtplanung und Umwelt
14.06.2023 09:00;973;546;427;Sonnig;18;18;0;Stadt Konstanz, Amt fuer Stadtplanung und Umwelt
14.06.2023 10:00;710;408;302;Sonnig;20;20;0;Stadt Konstanz, Amt fuer Stadtplanung und Umwelt
14.06.2023 11:00;916;435;481;Sonnig;22;22;0;Stadt Konstanz, Amt fuer Stadtplanung und Umwelt
14.06.2023 12:00;923;407;516;Sonnig;23;24;0;Stadt Konstanz, Amt fuer Stadtplanung und Umwelt
14.06.2023 13:00;1293;555;738;Sonnig;23;24;0;Stadt Konstanz, Amt fuer Stadtplanung und Umwelt
14.06.2023 14:00;961;489;472;Sonnig;24;24;0;Stadt Konstanz, Amt fuer Stadtplanung und Umwelt
14.06.2023 15:00;1172;534;638;Sonnig;24;24;0;Stadt Konstanz, Amt fuer Stadtplanung und Umwelt
14.06.2023 16:00;1222;585;637;Sonnig;24;24;0;Stadt Konstanz, Amt fuer Stadtplanung und Umwelt
14.06.2023 17:00;1417;615;802;Sonnig;23;24;0;Stadt Konstanz, Amt fuer Stadtplanung und Umwelt
14.06.2023 18:00;1228;542;686;Sonnig;21;21;0;Stadt Konstanz, Amt fuer Stadtplanung und Umwelt
14.06.2023 19:00;961;467;494;Sonnig;20;20;0;Stadt Konstanz, Amt fuer Stadtplanung und Umwelt
14.06.2023 20:00;740;374;366;Sonnig;14;13;0;Stadt Konstanz, Amt fuer Stadtplanung und Umwelt
14.06.2023 21:00;622;276;346;Sonnig;11;11;0;Stadt Konstanz, Amt fuer Stadtplanung und Umwelt
14.06.2023 22:00;485;177;308;Sonnig;10;9;0;Stadt Konstanz, Amt fuer Stadtplanung und Umwelt
14.06.2023 23:00;264;74;190;Sonnig;9;8;0;Stadt Konstanz, Amt fuer Stadtplanung und Umwelt
15.06.2023 00:00;103;33;70;Sonnig;10;9;0;Stadt Konstanz, Amt fuer Stadtplanung und Umwelt
15.06.2023 01:00;49;12;37;Sonnig;10;9;0;Stadt Konstanz, Amt fuer Stadtplanung und Umwelt
15.06.2023 02:00;19;5;14;Sonnig;9;8;0;Stadt Konstanz, Amt fuer Stadtplanung und Umwelt
15.06.2023 03:00;15;9;6;Sonnig;9;8;0;Stadt Konstanz, Amt fuer Stadtplanung und Umwelt
15.06.2023 04:00;16;9;7;Sonnig;8;8;0;Stadt Konstanz, Amt fuer Stadtplanung und Umwelt
15.06.2023 05:00;80;52;28;Sonnig;9;8;0;Stadt Konstanz, Amt fuer Stadtplanung und Umwelt
15.06.2023 06:00;228;129;99;Sonnig;11;11;0;Stadt Konstanz, Amt fuer Stadtplanung und Umwelt
15.06.2023 07:00;1168;724;444;Sonnig;14;14;0;Stadt Konstanz, Amt fuer Stadtplanung und Umwelt
15.06.2023 08:00;999;582;417;Sonnig;16;16;0;Stadt Konstanz, Amt fuer Stadtplanung und Umwelt
15.06.2023 09:00;897;533;364;Sonnig;18;18;0;Stadt Konstanz, Amt fuer Stadtplanung und Umwelt
15.06.2023 10:00;675;325;350;Sonnig;20;20;0;Stadt Konstanz, Amt fuer Stadtplanung und Umwelt
15.06.2023 11:00;762;377;385;Leicht bewoelkt;22;22;0;Stadt Konstanz, Amt fuer Stadtplanung und Umwelt
15.06.2023 12:00;832;360;472;Sonnig;23;24;0;Stadt Konstanz, Amt fuer Stadtplanung und Umwelt
15.06.2023 13:00;1145;481;664;Leicht bewoelkt;23;24;0;Stadt Konstanz, Amt fuer Stadtplanung und Umwelt
15.06.2023 14:00;906;466;440;Leicht bewoelkt;21;21;0;Stadt Konstanz, Amt fuer Stadtplanung und Umwelt
15.06.2023 15:00;1284;625;659;Leicht bewoelkt;21;21;0;Stadt Konstanz, Amt fuer Stadtplanung und Umwelt
15.06.2023 16:00;1244;621;623;Leicht bewoelkt;21;21;0;Stadt Konstanz, Amt fuer Stadtplanung und Umwelt
15.06.2023 17:00;1372;585;787;Leicht bewoelkt;21;21;0;Stadt Konstanz, Amt fuer Stadtplanung und Umwelt
15.06.2023 18:00;1303;580;723;Leicht bewoelkt;20;20;0;Stadt Konstanz, Amt fuer Stadtplanung und Umwelt
15.06.2023 19:00;956;432;524;Leicht bewoelkt;18;18;0;Stadt Konstanz, Amt fuer Stadtplanung und Umwelt
15.06.2023 20:00;656;303;353;Bewoelkt;15;15;0;Stadt Konstanz, Amt fuer Stadtplanung und Umwelt
15.06.2023 21:00;537;225;312;Bewoelkt;15;15;0;Stadt Konstanz, Amt fuer Stadtplanung und Umwelt
15.06.2023 22:00;457;164;293;Leicht bewoelkt;14;14;0;Stadt Konstanz, Amt fuer Stadtplanung und Umwelt
15.06.2023 23:00;205;77;128;Sonnig;12;12;0;Stadt Konstanz, Amt fuer Stadtplanung und Umwelt
16.06.2023 00:00;117;48;69;Leicht bewoelkt;10;10;0;Stadt Konstanz, Amt fuer Stadtplanung und Umwelt
16.06.2023 01:00;48;24;24;Leicht bewoelkt;10;10;0;Stadt Konstanz, Amt fuer Stadtplanung und Umwelt
16.06.2023 02:00;20;9;11;Sonnig;10;10;0;Stadt Konstanz, Amt fuer Stadtplanung und Umwelt
16.06.2023 03:00;24;15;9;Sonnig;9;9;0;Stadt Konstanz, Amt fuer Stadtplanung und Umwelt
16.06.2023 04:00;14;8;6;Sonnig;9;9;0;Stadt Konstanz, Amt fuer Stadtplanung und Umwelt
16.06.2023 05:00;67;43;24;Sonnig;9;9;0;Stadt Konstanz, Amt fuer Stadtplanung und Umwelt
16.06.2023 06:00;197;97;100;Leicht bewoelkt;12;12;0;Stadt Konstanz, Amt fuer Stadtplanung und Umwelt
16.06.2023 07:00;1047;680;367;Leicht bewoelkt;15;15;0;Stadt Konstanz, Amt fuer Stadtplanung und Umwelt
16.06.2023 08:00;916;525;391;Sonnig;18;18;0;Stadt Konstanz, Amt fuer Stadtplanung und Umwelt
16.06.2023 09:00;942;554;388;Sonnig;20;20;0;Stadt Konstanz, Amt fuer Stadtplanung und Umwelt
16.06.2023 10:00;760;425;335;Sonnig;22;24;0;Stadt Konstanz, Amt fuer Stadtplanung und Umwelt
16.06.2023 11:00;811;396;415;Leicht bewoelkt;24;25;0;Stadt Konstanz, Amt fuer Stadtplanung und Umwelt
16.06.2023 12:00;1073;470;603;Leicht bewoelkt;23;24;0;Stadt Konstanz, Amt fuer Stadtplanung und Umwelt
16.06.2023 13:00;1244;490;754;Leicht bewoelkt;23;24;0;Stadt Konstanz, Amt fuer Stadtplanung und Umwelt
16.06.2023 14:00;893;456;437;Leicht bewoelkt;24;24;0;Stadt Konstanz, Amt fuer Stadtplanung und Umwelt
16.06.2023 15:00;1004;472;532;Leicht bewoelkt;25;25;0;Stadt Konstanz, Amt fuer Stadtplanung und Umwelt
16.06.2023 16:00;1093;525;568;Bewoelkt;24;25;0;Stadt Konstanz, Amt fuer Stadtplanung und Umwelt
16.06.2023 17:00;1070;509;561;Stellenweise Gewitter und Niederschlaege;22;22;0;Stadt Konstanz, Amt fuer Stadtplanung und Umwelt
16.06.2023 18:00;1037;510;527;Leicht bewoelkt;20;20;0;Stadt Konstanz, Amt fuer Stadtplanung und Umwelt
16.06.2023 19:00;862;430;432;Stellenweiser Regenfall;19;19;0.1;Stadt Konstanz, Amt fuer Stadtplanung und Umwelt
16.06.2023 20:00;615;311;304;Sonnig;14;14;0;Stadt Konstanz, Amt fuer Stadtplanung und Umwelt
16.06.2023 21:00;536;243;293;Sonnig;12;12;0;Stadt Konstanz, Amt fuer Stadtplanung und Umwelt
16.06.2023 22:00;479;191;288;Leicht bewoelkt;11;11;0;Stadt Konstanz, Amt fuer Stadtplanung und Umwelt
16.06.2023 23:00;351;104;247;Stellenweise Gewitter und Niederschlaege;11;10;0;Stadt Konstanz, Amt fuer Stadtplanung und Umwelt
17.06.2023 00:00;255;66;189;Sonnig;11;11;0;Stadt Konstanz, Amt fuer Stadtplanung und Umwelt
17.06.2023 01:00;138;40;98;Sonnig;10;11;0;Stadt Konstanz, Amt fuer Stadtplanung und Umwelt
17.06.2023 02:00;71;22;49;Sonnig;10;10;0;Stadt Konstanz, Amt fuer Stadtplanung und Umwelt
17.06.2023 03:00;67;29;38;Sonnig;9;9;0;Stadt Konstanz, Amt fuer Stadtplanung und Umwelt
17.06.2023 04:00;38;13;25;Sonnig;9;9;0;Stadt Konstanz, Amt fuer Stadtplanung und Umwelt
17.06.2023 05:00;44;26;18;Sonnig;9;9;0;Stadt Konstanz, Amt fuer Stadtplanung und Umwelt
17.06.2023 06:00;66;32;34;Sonnig;11;11;0;Stadt Konstanz, Amt fuer Stadtplanung und Umwelt
17.06.2023 07:00;137;73;64;Sonnig;15;15;0;Stadt Konstanz, Amt fuer Stadtplanung und Umwelt
17.06.2023 08:00;381;219;162;Sonnig;18;18;0;Stadt Konstanz, Amt fuer Stadtplanung und Umwelt
17.06.2023 09:00;590;316;274;Sonnig;21;21;0;Stadt Konstanz, Amt fuer Stadtplanung und Umwelt
17.06.2023 10:00;764;416;348;Sonnig;23;25;0;Stadt Konstanz, Amt fuer Stadtplanung und Umwelt
17.06.2023 11:00;739;388;351;Sonnig;26;25;0;Stadt Konstanz, Amt fuer Stadtplanung und Umwelt
17.06.2023 12:00;826;406;420;Sonnig;29;28;0;Stadt Konstanz, Amt fuer Stadtplanung und Umwelt
17.06.2023 13:00;804;396;408;Sonnig;27;26;0;Stadt Konstanz, Amt fuer Stadtplanung und Umwelt
17.06.2023 14:00;800;357;443;Leicht bewoelkt;27;26;0;Stadt Konstanz, Amt fuer Stadtplanung und Umwelt
17.06.2023 15:00;773;394;379;Leicht bewoelkt;27;26;0;Stadt Konstanz, Amt fuer Stadtplanung und Umwelt
17.06.2023 16:00;940;537;403;Leicht bewoelkt;24;25;0;Stadt Konstanz, Amt fuer Stadtplanung und Umwelt
17.06.2023 17:00;894;525;369;Leicht bewoelkt;24;25;0;Stadt Konstanz, Amt fuer Stadtplanung und Umwelt
17.06.2023 18:00;758;472;286;Leicht bewoelkt;24;25;0;Stadt Konstanz, Amt fuer Stadtplanung und Umwelt
17.06.2023 19:00;548;341;207;Leicht bewoelkt;21;21;0;Stadt Konstanz, Amt fuer Stadtplanung und Umwelt
17.06.2023 20:00;390;221;169;Leicht bewoelkt;17;17;0;Stadt Konstanz, Amt fuer Stadtplanung und Umwelt
17.06.2023 21:00;290;134;156;Sonnig;16;16;0;Stadt Konstanz, Amt fuer Stadtplanung und Umwelt
17.06.2023 22:00;272;111;161;Sonnig;14;15;0;Stadt Konstanz, Amt fuer Stadtplanung und Umwelt
17.06.2023 23:00;276;102;174;Sonnig;14;14;0;Stadt Konstanz, Amt fuer Stadtplanung und Umwelt
18.06.2023 00:00;262;84;178;Sonnig;13;13;0;Stadt Konstanz, Amt fuer Stadtplanung und Umwelt
18.06.2023 01:00;245;47;198;Sonnig;12;13;0;Stadt Konstanz, Amt fuer Stadtplanung und Umwelt
18.06.2023 02:00;197;47;150;Sonnig;12;12;0;Stadt Konstanz, Amt fuer Stadtplanung und Umwelt
18.06.2023 03:00;94;17;77;Sonnig;11;11;0;Stadt Konstanz, Amt fuer Stadtplanung und Umwelt
18.06.2023 04:00;51;10;41;Sonnig;10;10;0;Stadt Konstanz, Amt fuer Stadtplanung und Umwelt
18.06.2023 05:00;50;27;23;Sonnig;11;11;0;Stadt Konstanz, Amt fuer Stadtplanung und Umwelt
18.06.2023 06:00;83;43;40;Sonnig;13;13;0;Stadt Konstanz, Amt fuer Stadtplanung und Umwelt
18.06.2023 07:00;129;83;46;Sonnig;16;16;0;Stadt Konstanz, Amt fuer Stadtplanung und Umwelt
18.06.2023 08:00;286;163;123;Sonnig;19;19;0;Stadt Konstanz, Amt fuer Stadtplanung und Umwelt
18.06.2023 09:00;396;219;177;Sonnig;22;22;0;Stadt Konstanz, Amt fuer Stadtplanung und Umwelt
18.06.2023 10:00;443;273;170;Sonnig;24;25;0;Stadt Konstanz, Amt fuer Stadtplanung und Umwelt
18.06.2023 11:00;364;167;197;Sonnig;29;29;0;Stadt Konstanz, Amt fuer Stadtplanung und Umwelt
18.06.2023 12:00;335;147;188;Sonnig;31;30;0;Stadt Konstanz, Amt fuer Stadtplanung und Umwelt
18.06.2023 13:00;376;185;191;Sonnig;30;29;0;Stadt Konstanz, Amt fuer Stadtplanung und Umwelt
18.06.2023 14:00;418;191;227;Sonnig;30;29;0;Stadt Konstanz, Amt fuer Stadtplanung und Umwelt
18.06.2023 15:00;425;179;246;Sonnig;30;29;0;Stadt Konstanz, Amt fuer Stadtplanung und Umwelt
18.06.2023 16:00;450;205;245;Sonnig;29;28;0;Stadt Konstanz, Amt fuer Stadtplanung und Umwelt
18.06.2023 17:00;589;267;322;Sonnig;29;28;0;Stadt Konstanz, Amt fuer Stadtplanung und Umwelt
18.06.2023 18:00;558;258;300;Sonnig;26;27;0;Stadt Konstanz, Amt fuer Stadtplanung und Umwelt
18.06.2023 19:00;495;228;267;Leicht bewoelkt;22;25;0;Stadt Konstanz, Amt fuer Stadtplanung und Umwelt
18.06.2023 20:00;440;197;243;Sonnig;20;20;0;Stadt Konstanz, Amt fuer Stadtplanung und Umwelt
18.06.2023 21:00;338;126;212;Sonnig;18;18;0;Stadt Konstanz, Amt fuer Stadtplanung und Umwelt
18.06.2023 22:00;234;80;154;Sonnig;17;17;0;Stadt Konstanz, Amt fuer Stadtplanung und Umwelt
18.06.2023 23:00;113;37;76;Leicht bewoelkt;16;16;0;Stadt Konstanz, Amt fuer Stadtplanung und Umwelt
19.06.2023 00:00;59;25;34;Leicht bewoelkt;18;18;0;Stadt Konstanz, Amt fuer Stadtplanung und Umwelt
19.06.2023 01:00;21;2;19;Sonnig;17;17;0;Stadt Konstanz, Amt fuer Stadtplanung und Umwelt
19.06.2023 02:00;9;3;6;Sonnig;15;15;0;Stadt Konstanz, Amt fuer Stadtplanung und Umwelt
19.06.2023 03:00;9;4;5;Leicht bewoelkt;14;14;0;Stadt Konstanz, Amt fuer Stadtplanung und Umwelt
19.06.2023 04:00;16;7;9;Leichter Regenschauer;14;14;0.3;Stadt Konstanz, Amt fuer Stadtplanung und Umwelt
19.06.2023 05:00;60;40;20;Leichter Nebel;14;14;0.1;Stadt Konstanz, Amt fuer Stadtplanung und Umwelt
19.06.2023 06:00;238;153;85;Stellenweiser Regenfall;16;16;0.1;Stadt Konstanz, Amt fuer Stadtplanung und Umwelt
19.06.2023 07:00;926;570;356;Leichter Regenschauer;18;18;0.3;Stadt Konstanz, Amt fuer Stadtplanung und Umwelt
19.06.2023 08:00;701;386;315;Leicht bewoelkt;20;20;0;Stadt Konstanz, Amt fuer Stadtplanung und Umwelt
19.06.2023 09:00;824;498;326;Leicht bewoelkt;23;25;0;Stadt Konstanz, Amt fuer Stadtplanung und Umwelt
19.06.2023 10:00;583;334;249;Sonnig;25;26;0;Stadt Konstanz, Amt fuer Stadtplanung und Umwelt
19.06.2023 11:00;729;333;396;Sonnig;28;28;0;Stadt Konstanz, Amt fuer Stadtplanung und Umwelt
19.06.2023 12:00;769;365;404;Sonnig;31;31;0;Stadt Konstanz, Amt fuer Stadtplanung und Umwelt
19.06.2023 13:00;1098;511;587;Sonnig;32;33;0;Stadt Konstanz, Amt fuer Stadtplanung und Umwelt
19.06.2023 14:00;855;419;436;Sonnig;33;34;0;Stadt Konstanz, Amt fuer Stadtplanung und Umwelt
19.06.2023 15:00;1153;586;567;Sonnig;33;33;0;Stadt Konstanz, Amt fuer Stadtplanung und Umwelt
19.06.2023 16:00;1042;519;523;Sonnig;32;33;0;Stadt Konstanz, Amt fuer Stadtplanung und Umwelt
19.06.2023 17:00;1233;565;668;Sonnig;31;31;0;Stadt Konstanz, Amt fuer Stadtplanung und Umwelt
19.06.2023 18:00;1103;530;573;Sonnig;30;31;0;Stadt Konstanz, Amt fuer Stadtplanung und Umwelt
19.06.2023 19:00;870;376;494;Sonnig;25;27;0;Stadt Konstanz, Amt fuer Stadtplanung und Umwelt
19.06.2023 20:00;633;244;389;Sonnig;21;21;0;Stadt Konstanz, Amt fuer Stadtplanung und Umwelt
19.06.2023 21:00;517;200;317;Sonnig;19;19;0;Stadt Konstanz, Amt fuer Stadtplanung und Umwelt
19.06.2023 22:00;302;131;171;Sonnig;18;18;0;Stadt Konstanz, Amt fuer Stadtplanung und Umwelt
19.06.2023 23:00;168;62;106;Sonnig;17;17;0;Stadt Konstanz, Amt fuer Stadtplanung und Umwelt
20.06.2023 00:00;46;16;30;Leicht bewoelkt;16;16;0;Stadt Konstanz, Amt fuer Stadtplanung und Umwelt
20.06.2023 01:00;25;11;14;Leicht bewoelkt;16;16;0;Stadt Konstanz, Amt fuer Stadtplanung und Umwelt
20.06.2023 02:00;16;12;4;Leicht bewoelkt;17;17;0;Stadt Konstanz, Amt fuer Stadtplanung und Umwelt
20.06.2023 03:00;14;6;8;Leichter Nebel;16;16;0.1;Stadt Konstanz, Amt fuer Stadtplanung und Umwelt
20.06.2023 04:00;10;7;3;Leichter Regenschauer;15;15;0.5;Stadt Konstanz, Amt fuer Stadtplanung und Umwelt
20.06.2023 05:00;58;41;17;Leichter Regenschauer;16;16;0.3;Stadt Konstanz, Amt fuer Stadtplanung und Umwelt
20.06.2023 06:00;226;124;102;Leichter Regenschauer;17;17;0.3;Stadt Konstanz, Amt fuer Stadtplanung und Umwelt
20.06.2023 07:00;1111;726;385;Leichter Regenschauer;18;18;1.3;Stadt Konstanz, Amt fuer Stadtplanung und Umwelt
20.06.2023 08:00;1005;552;453;Leicht bewoelkt;20;20;0;Stadt Konstanz, Amt fuer Stadtplanung und Umwelt
20.06.2023 09:00;950;562;388;Sonnig;23;25;0;Stadt Konstanz, Amt fuer Stadtplanung und Umwelt
20.06.2023 10:00;690;339;351;Sonnig;25;26;0;Stadt Konstanz, Amt fuer Stadtplanung und Umwelt
20.06.2023 11:00;810;392;418;Sonnig;30;32;0;Stadt Konstanz, Amt fuer Stadtplanung und Umwelt
20.06.2023 12:00;882;361;521;Sonnig;30;30;0;Stadt Konstanz, Amt fuer Stadtplanung und Umwelt
20.06.2023 13:00;1099;504;595;Sonnig;30;31;0;Stadt Konstanz, Amt fuer Stadtplanung und Umwelt
20.06.2023 14:00;861;405;456;Sonnig;31;32;0;Stadt Konstanz, Amt fuer Stadtplanung und Umwelt
20.06.2023 15:00;1158;484;674;Sonnig;31;31;0;Stadt Konstanz, Amt fuer Stadtplanung und Umwelt
20.06.2023 16:00;1109;496;613;Sonnig;32;34;0;Stadt Konstanz, Amt fuer Stadtplanung und Umwelt
20.06.2023 17:00;1323;644;679;Sonnig;31;32;0;Stadt Konstanz, Amt fuer Stadtplanung und Umwelt
20.06.2023 18:00;1192;556;636;Sonnig;28;29;0;Stadt Konstanz, Amt fuer Stadtplanung und Umwelt
20.06.2023 19:00;872;415;457;Maeßiger bis starker Regen mit Gewitter;21;21;9.8;Stadt Konstanz, Amt fuer Stadtplanung und Umwelt
20.06.2023 20:00;566;257;309;Teilweise maeßiger Regenfall;18;18;4.4;Stadt Konstanz, Amt fuer Stadtplanung und Umwelt
20.06.2023 21:00;453;177;276;Leichter Nebel;18;18;0;Stadt Konstanz, Amt fuer Stadtplanung und Umwelt
20.06.2023 22:00;368;133;235;Teilweise maeßiger Regenfall;16;16;4.5;Stadt Konstanz, Amt fuer Stadtplanung und Umwelt
20.06.2023 23:00;195;62;133;Leichter Nebel;15;15;0;Stadt Konstanz, Amt fuer Stadtplanung und Umwelt
21.06.2023 00:00;86;27;59;Leichter Regenschauer;15;16;1.2;Stadt Konstanz, Amt fuer Stadtplanung und Umwelt
21.06.2023 01:00;34;17;17;Nebel;15;15;0;Stadt Konstanz, Amt fuer Stadtplanung und Umwelt
21.06.2023 02:00;13;4;9;Leichter Nebel;15;15;0.1;Stadt Konstanz, Amt fuer Stadtplanung und Umwelt
21.06.2023 03:00;4;0;4;Leichter Nebel;14;14;0;Stadt Konstanz, Amt fuer Stadtplanung und Umwelt
21.06.2023 04:00;12;8;4;Stellenweiser Regenfall;14;14;0.1;Stadt Konstanz, Amt fuer Stadtplanung und Umwelt
21.06.2023 05:00;74;51;23;Leichter Nebel;14;14;0;Stadt Konstanz, Amt fuer Stadtplanung und Umwelt
21.06.2023 06:00;252;122;130;Sonnig;16;16;0;Stadt Konstanz, Amt fuer Stadtplanung und Umwelt
21.06.2023 07:00;1129;708;421;Stellenweiser Regenfall;18;18;0.1;Stadt Konstanz, Amt fuer Stadtplanung und Umwelt
21.06.2023 08:00;1035;587;448;Sonnig;20;20;0;Stadt Konstanz, Amt fuer Stadtplanung und Umwelt
21.06.2023 09:00;916;512;404;Leicht bewoelkt;24;25;0;Stadt Konstanz, Amt fuer Stadtplanung und Umwelt
21.06.2023 10:00;369;182;187;Leicht bewoelkt;26;27;0;Stadt Konstanz, Amt fuer Stadtplanung und Umwelt
21.06.2023 11:00;706;328;378;Stellenweise Gewitter und Niederschlaege;29;31;0;Stadt Konstanz, Amt fuer Stadtplanung und Umwelt
21.06.2023 12:00;774;326;448;Stellenweise Gewitter und Niederschlaege;31;32;0;Stadt Konstanz, Amt fuer Stadtplanung und Umwelt
21.06.2023 13:00;1135;536;599;Stellenweise Gewitter und Niederschlaege;32;32;0;Stadt Konstanz, Amt fuer Stadtplanung und Umwelt
21.06.2023 14:00;826;409;417;Stellenweise Gewitter und Niederschlaege;32;33;0;Stadt Konstanz, Amt fuer Stadtplanung und Umwelt
21.06.2023 15:00;1034;450;584;Sonnig;33;33;0;Stadt Konstanz, Amt fuer Stadtplanung und Umwelt
21.06.2023 16:00;1108;543;565;Sonnig;32;33;0;Stadt Konstanz, Amt fuer Stadtplanung und Umwelt
21.06.2023 17:00;1326;633;693;Sonnig;33;34;0;Stadt Konstanz, Amt fuer Stadtplanung und Umwelt
21.06.2023 18:00;1203;548;655;Stellenweise Gewitter und Niederschlaege;29;30;0;Stadt Konstanz, Amt fuer Stadtplanung und Umwelt
21.06.2023 19:00;838;441;397;Stellenweise Gewitter und Niederschlaege;24;26;0;Stadt Konstanz, Amt fuer Stadtplanung und Umwelt
21.06.2023 20:00;616;319;297;Sonnig;20;20;0;Stadt Konstanz, Amt fuer Stadtplanung und Umwelt
21.06.2023 21:00;617;267;350;Sonnig;19;19;0;Stadt Konstanz, Amt fuer Stadtplanung und Umwelt
21.06.2023 22:00;424;199;225;Sonnig;18;18;0;Stadt Konstanz, Amt fuer Stadtplanung und Umwelt
21.06.2023 23:00;259;87;172;Sonnig;17;17;0;Stadt Konstanz, Amt fuer Stadtplanung und Umwelt
22.06.2023 00:00;146;32;114;Sonnig;18;18;0;Stadt Konstanz, Amt fuer Stadtplanung und Umwelt
22.06.2023 01:00;50;19;31;Leichter Nebel;17;17;0;Stadt Konstanz, Amt fuer Stadtplanung und Umwelt
22.06.2023 02:00;26;13;13;Leichter Nebel;17;17;0;Stadt Konstanz, Amt fuer Stadtplanung und Umwelt
22.06.2023 03:00;24;11;13;Leichter Nebel;16;16;0;Stadt Konstanz, Amt fuer Stadtplanung und Umwelt
22.06.2023 04:00;20;13;7;Leichter Nebel;16;16;0;Stadt Konstanz, Amt fuer Stadtplanung und Umwelt
22.06.2023 05:00;58;44;14;Leichter Nebel;16;16;0;Stadt Konstanz, Amt fuer Stadtplanung und Umwelt
22.06.2023 06:00;246;126;120;Leicht bewoelkt;18;18;0;Stadt Konstanz, Amt fuer Stadtplanung und Umwelt
22.06.2023 07:00;1078;665;413;Leicht bewoelkt;20;20;0;Stadt Konstanz, Amt fuer Stadtplanung und Umwelt
22.06.2023 08:00;990;515;475;Sonnig;22;22;0;Stadt Konstanz, Amt fuer Stadtplanung und Umwelt
22.06.2023 09:00;930;517;413;Sonnig;24;26;0;Stadt Konstanz, Amt fuer Stadtplanung und Umwelt
22.06.2023 10:00;618;331;287;Leicht bewoelkt;27;28;0;Stadt Konstanz, Amt fuer Stadtplanung und Umwelt
22.06.2023 11:00;793;412;381;Leicht bewoelkt;29;30;0;Stadt Konstanz, Amt fuer Stadtplanung und Umwelt
22.06.2023 12:00;893;420;473;Leicht bewoelkt;30;31;0;Stadt Konstanz, Amt fuer Stadtplanung und Umwelt
22.06.2023 13:00;1094;476;618;Leicht bewoelkt;31;32;0;Stadt Konstanz, Amt fuer Stadtplanung und Umwelt
22.06.2023 14:00;928;449;479;Stellenweise Gewitter und Niederschlaege;31;31;0;Stadt Konstanz, Amt fuer Stadtplanung und Umwelt
22.06.2023 15:00;1207;612;595;Stellenweise Gewitter und Niederschlaege;31;32;0;Stadt Konstanz, Amt fuer Stadtplanung und Umwelt
22.06.2023 16:00;1160;557;603;Stellenweise Gewitter und Niederschlaege;31;32;0;Stadt Konstanz, Amt fuer Stadtplanung und Umwelt
22.06.2023 17:00;1229;513;716;Sonnig;30;32;0;Stadt Konstanz, Amt fuer Stadtplanung und Umwelt
22.06.2023 18:00;1016;415;601;Leichter Regenschauer;21;21;0.9;Stadt Konstanz, Amt fuer Stadtplanung und Umwelt
22.06.2023 19:00;564;260;304;Starker Regenfall;17;17;8.1;Stadt Konstanz, Amt fuer Stadtplanung und Umwelt
22.06.2023 20:00;399;202;197;Leichter Regenschauer;17;17;0.8;Stadt Konstanz, Amt fuer Stadtplanung und Umwelt
22.06.2023 21:00;301;131;170;Nebel;16;16;0;Stadt Konstanz, Amt fuer Stadtplanung und Umwelt
22.06.2023 22:00;274;129;145;Leichter Regenschauer;16;16;1.6;Stadt Konstanz, Amt fuer Stadtplanung und Umwelt
22.06.2023 23:00;135;55;80;Nebel;17;17;0;Stadt Konstanz, Amt fuer Stadtplanung und Umwelt
23.06.2023 00:00;57;20;37;Leichter Regenschauer;15;13;0.2;Stadt Konstanz, Amt fuer Stadtplanung und Umwelt
23.06.2023 01:00;29;12;17;Bedeckt;15;14;0;Stadt Konstanz, Amt fuer Stadtplanung und Umwelt
23.06.2023 02:00;9;6;3;Bewoelkt;15;13;0;Stadt Konstanz, Amt fuer Stadtplanung und Umwelt
23.06.2023 03:00;5;2;3;Leicht bewoelkt;14;13;0;Stadt Konstanz, Amt fuer Stadtplanung und Umwelt
23.06.2023 04:00;10;4;6;Leicht bewoelkt;14;12;0;Stadt Konstanz, Amt fuer Stadtplanung und Umwelt
23.06.2023 05:00;30;23;7;Leicht bewoelkt;14;13;0;Stadt Konstanz, Amt fuer Stadtplanung und Umwelt
23.06.2023 06:00;165;87;78;Sonnig;15;15;0;Stadt Konstanz, Amt fuer Stadtplanung und Umwelt
23.06.2023 07:00;931;558;373;Sonnig;17;17;0;Stadt Konstanz, Amt fuer Stadtplanung und Umwelt
23.06.2023 08:00;892;502;390;Sonnig;19;19;0;Stadt Konstanz, Amt fuer Stadtplanung und Umwelt
23.06.2023 09:00;906;558;348;Sonnig;20;20;0;Stadt Konstanz, Amt fuer Stadtplanung und Umwelt
23.06.2023 10:00;658;366;292;Sonnig;21;21;0;Stadt Konstanz, Amt fuer Stadtplanung und Umwelt
23.06.2023 11:00;798;395;403;Leicht bewoelkt;23;24;0;Stadt Konstanz, Amt fuer Stadtplanung und Umwelt
23.06.2023 12:00;919;418;501;Sonnig;24;25;0;Stadt Konstanz, Amt fuer Stadtplanung und Umwelt
23.06.2023 13:00;1167;518;649;Sonnig;24;25;0;Stadt Konstanz, Amt fuer Stadtplanung und Umwelt
23.06.2023 14:00;932;486;446;Sonnig;24;25;0;Stadt Konstanz, Amt fuer Stadtplanung und Umwelt
23.06.2023 15:00;977;444;533;Sonnig;23;25;0;Stadt Konstanz, Amt fuer Stadtplanung und Umwelt
23.06.2023 16:00;969;455;514;Leicht bewoelkt;23;25;0;Stadt Konstanz, Amt fuer Stadtplanung und Umwelt
23.06.2023 17:00;1061;511;550;Leicht bewoelkt;23;25;0;Stadt Konstanz, Amt fuer Stadtplanung und Umwelt
23.06.2023 18:00;1001;484;517;Sonnig;21;21;0;Stadt Konstanz, Amt fuer Stadtplanung und Umwelt
23.06.2023 19:00;892;431;461;Sonnig;20;20;0;Stadt Konstanz, Amt fuer Stadtplanung und Umwelt
23.06.2023 20:00;611;321;290;Sonnig;17;17;0;Stadt Konstanz, Amt fuer Stadtplanung und Umwelt
23.06.2023 21:00;506;219;287;Sonnig;14;14;0;Stadt Konstanz, Amt fuer Stadtplanung und Umwelt
23.06.2023 22:00;385;156;229;Sonnig;13;12;0;Stadt Konstanz, Amt fuer Stadtplanung und Umwelt
23.06.2023 23:00;348;107;241;Leichter Nebel;12;12;0;Stadt Konstanz, Amt fuer Stadtplanung und Umwelt
24.06.2023 00:00;227;71;156;Sonnig;12;11;0;Stadt Konstanz, Amt fuer Stadtplanung und Umwelt
24.06.2023 01:00;150;37;113;Sonnig;11;11;0;Stadt Konstanz, Amt fuer Stadtplanung und Umwelt
24.06.2023 02:00;82;38;44;Sonnig;11;10;0;Stadt Konstanz, Amt fuer Stadtplanung und Umwelt
24.06.2023 03:00;62;29;33;Leichter Nebel;11;10;0;Stadt Konstanz, Amt fuer Stadtplanung und Umwelt
24.06.2023 04:00;37;21;16;Leichter Nebel;10;9;0;Stadt Konstanz, Amt fuer Stadtplanung und Umwelt
24.06.2023 05:00;36;24;12;Sonnig;10;9;0;Stadt Konstanz, Amt fuer Stadtplanung und Umwelt
24.06.2023 06:00;81;50;31;Sonnig;13;12;0;Stadt Konstanz, Amt fuer Stadtplanung und Umwelt
24.06.2023 07:00;126;73;53;Sonnig;16;16;0;Stadt Konstanz, Amt fuer Stadtplanung und Umwelt
24.06.2023 08:00;302;161;141;Sonnig;18;18;0;Stadt Konstanz, Amt fuer Stadtplanung und Umwelt
24.06.2023 09:00;603;358;245;Sonnig;20;20;0;Stadt Konstanz, Amt fuer Stadtplanung und Umwelt
24.06.2023 10:00;776;445;331;Sonnig;22;24;0;Stadt Konstanz, Amt fuer Stadtplanung und Umwelt
24.06.2023 11:00;763;418;345;Sonnig;24;25;0;Stadt Konstanz, Amt fuer Stadtplanung und Umwelt
24.06.2023 12:00;793;413;380;Sonnig;26;25;0;Stadt Konstanz, Amt fuer Stadtplanung und Umwelt
24.06.2023 13:00;767;397;370;Sonnig;26;26;0;Stadt Konstanz, Amt fuer Stadtplanung und Umwelt
24.06.2023 14:00;807;394;413;Sonnig;27;26;0;Stadt Konstanz, Amt fuer Stadtplanung und Umwelt
24.06.2023 15:00;848;440;408;Sonnig;27;26;0;Stadt Konstanz, Amt fuer Stadtplanung und Umwelt
24.06.2023 16:00;797;416;381;Sonnig;27;26;0;Stadt Konstanz, Amt fuer Stadtplanung und Umwelt
24.06.2023 17:00;868;442;426;Sonnig;27;27;0;Stadt Konstanz, Amt fuer Stadtplanung und Umwelt
24.06.2023 18:00;941;499;442;Sonnig;26;26;0;Stadt Konstanz, Amt fuer Stadtplanung und Umwelt
24.06.2023 19:00;746;411;335;Sonnig;23;25;0;Stadt Konstanz, Amt fuer Stadtplanung und Umwelt
24.06.2023 20:00;642;313;329;Sonnig;17;17;0;Stadt Konstanz, Amt fuer Stadtplanung und Umwelt
24.06.2023 21:00;557;241;316;Sonnig;15;14;0;Stadt Konstanz, Amt fuer Stadtplanung und Umwelt
24.06.2023 22:00;514;193;321;Sonnig;14;13;0;Stadt Konstanz, Amt fuer Stadtplanung und Umwelt
24.06.2023 23:00;419;96;323;Sonnig;13;12;0;Stadt Konstanz, Amt fuer Stadtplanung und Umwelt
25.06.2023 00:00;331;78;253;Sonnig;13;12;0;Stadt Konstanz, Amt fuer Stadtplanung und Umwelt
25.06.2023 01:00;173;46;127;Sonnig;12;12;0;Stadt Konstanz, Amt fuer Stadtplanung und Umwelt
25.06.2023 02:00;168;44;124;Sonnig;12;11;0;Stadt Konstanz, Amt fuer Stadtplanung und Umwelt
25.06.2023 03:00;80;26;54;Sonnig;11;11;0;Stadt Konstanz, Amt fuer Stadtplanung und Umwelt
25.06.2023 04:00;37;21;16;Sonnig;11;10;0;Stadt Konstanz, Amt fuer Stadtplanung und Umwelt
25.06.2023 05:00;31;24;7;Sonnig;11;10;0;Stadt Konstanz, Amt fuer Stadtplanung und Umwelt
25.06.2023 06:00;67;42;25;Sonnig;13;14;0;Stadt Konstanz, Amt fuer Stadtplanung und Umwelt
25.06.2023 07:00;82;48;34;Sonnig;17;17;0;Stadt Konstanz, Amt fuer Stadtplanung und Umwelt
25.06.2023 08:00;163;99;64;Sonnig;19;19;0;Stadt Konstanz, Amt fuer Stadtplanung und Umwelt
25.06.2023 09:00;344;191;153;Sonnig;21;21;0;Stadt Konstanz, Amt fuer Stadtplanung und Umwelt
25.06.2023 10:00;466;263;203;Sonnig;24;25;0;Stadt Konstanz, Amt fuer Stadtplanung und Umwelt
25.06.2023 11:00;554;276;278;Sonnig;28;28;0;Stadt Konstanz, Amt fuer Stadtplanung und Umwelt
25.06.2023 12:00;548;230;318;Sonnig;30;29;0;Stadt Konstanz, Amt fuer Stadtplanung und Umwelt
25.06.2023 13:00;600;286;314;Sonnig;30;30;0;Stadt Konstanz, Amt fuer Stadtplanung und Umwelt
25.06.2023 14:00;669;331;338;Sonnig;31;30;0;Stadt Konstanz, Amt fuer Stadtplanung und Umwelt
25.06.2023 15:00;656;330;326;Sonnig;31;31;0;Stadt Konstanz, Amt fuer Stadtplanung und Umwelt
25.06.2023 16:00;722;345;377;Sonnig;30;30;0;Stadt Konstanz, Amt fuer Stadtplanung und Umwelt
25.06.2023 17:00;639;299;340;Sonnig;29;29;0;Stadt Konstanz, Amt fuer Stadtplanung und Umwelt
25.06.2023 18:00;661;347;314;Sonnig;28;28;0;Stadt Konstanz, Amt fuer Stadtplanung und Umwelt
25.06.2023 19:00;621;335;286;Sonnig;24;25;0;Stadt Konstanz, Amt fuer Stadtplanung und Umwelt
25.06.2023 20:00;560;263;297;Sonnig;19;19;0;Stadt Konstanz, Amt fuer Stadtplanung und Umwelt
25.06.2023 21:00;459;178;281;Sonnig;17;17;0;Stadt Konstanz, Amt fuer Stadtplanung und Umwelt
25.06.2023 22:00;331;130;201;Sonnig;16;16;0;Stadt Konstanz, Amt fuer Stadtplanung und Umwelt
25.06.2023 23:00;163;54;109;Sonnig;15;15;0;Stadt Konstanz, Amt fuer Stadtplanung und Umwelt
26.06.2023 00:00;57;16;41;Sonnig;14;15;0;Stadt Konstanz, Amt fuer Stadtplanung und Umwelt
26.06.2023 01:00;26;13;13;Sonnig;14;14;0;Stadt Konstanz, Amt fuer Stadtplanung und Umwelt
26.06.2023 02:00;15;7;8;Sonnig;13;13;0;Stadt Konstanz, Amt fuer Stadtplanung und Umwelt
26.06.2023 03:00;6;0;6;Sonnig;13;13;0;Stadt Konstanz, Amt fuer Stadtplanung und Umwelt
26.06.2023 04:00;12;6;6;Sonnig;12;12;0;Stadt Konstanz, Amt fuer Stadtplanung und Umwelt
26.06.2023 05:00;69;50;19;Sonnig;12;12;0;Stadt Konstanz, Amt fuer Stadtplanung und Umwelt
26.06.2023 06:00;228;122;106;Sonnig;15;15;0;Stadt Konstanz, Amt fuer Stadtplanung und Umwelt
26.06.2023 07:00;924;544;380;Sonnig;18;18;0;Stadt Konstanz, Amt fuer Stadtplanung und Umwelt
26.06.2023 08:00;979;565;414;Sonnig;21;21;0;Stadt Konstanz, Amt fuer Stadtplanung und Umwelt
26.06.2023 09:00;1017;614;403;Sonnig;23;25;0;Stadt Konstanz, Amt fuer Stadtplanung und Umwelt
26.06.2023 10:00;625;334;291;Sonnig;25;26;0;Stadt Konstanz, Amt fuer Stadtplanung und Umwelt
26.06.2023 11:00;822;391;431;Sonnig;30;31;0;Stadt Konstanz, Amt fuer Stadtplanung und Umwelt
26.06.2023 12:00;891;370;521;Sonnig;31;32;0;Stadt Konstanz, Amt fuer Stadtplanung und Umwelt
26.06.2023 13:00;1079;483;596;Leicht bewoelkt;30;30;0;Stadt Konstanz, Amt fuer Stadtplanung und Umwelt
26.06.2023 14:00;870;460;410;Bewoelkt;29;29;0;Stadt Konstanz, Amt fuer Stadtplanung und Umwelt
26.06.2023 15:00;1103;550;553;Leicht bewoelkt;28;28;0;Stadt Konstanz, Amt fuer Stadtplanung und Umwelt
26.06.2023 16:00;1132;519;613;Leicht bewoelkt;28;28;0;Stadt Konstanz, Amt fuer Stadtplanung und Umwelt
26.06.2023 17:00;1206;596;610;Sonnig;27;28;0;Stadt Konstanz, Amt fuer Stadtplanung und Umwelt
26.06.2023 18:00;1132;522;610;Sonnig;26;27;0;Stadt Konstanz, Amt fuer Stadtplanung und Umwelt
26.06.2023 19:00;863;370;493;Sonnig;23;25;0;Stadt Konstanz, Amt fuer Stadtplanung und Umwelt
26.06.2023 20:00;706;323;383;Leicht bewoelkt;20;20;0;Stadt Konstanz, Amt fuer Stadtplanung und Umwelt
26.06.2023 21:00;564;230;334;Sonnig;19;19;0;Stadt Konstanz, Amt fuer Stadtplanung und Umwelt
26.06.2023 22:00;336;121;215;Stellenweiser Regenfall;18;18;0.1;Stadt Konstanz, Amt fuer Stadtplanung und Umwelt
26.06.2023 23:00;186;79;107;Leicht bewoelkt;17;17;0;Stadt Konstanz, Amt fuer Stadtplanung und Umwelt
27.06.2023 00:00;115;38;77;Leicht bewoelkt;15;15;0;Stadt Konstanz, Amt fuer Stadtplanung und Umwelt
27.06.2023 01:00;38;10;28;Stellenweiser Regenfall;15;15;0.1;Stadt Konstanz, Amt fuer Stadtplanung und Umwelt
27.06.2023 02:00;16;4;12;Bewoelkt;15;15;0;Stadt Konstanz, Amt fuer Stadtplanung und Umwelt
27.06.2023 03:00;12;5;7;Leicht bewoelkt;14;15;0;Stadt Konstanz, Amt fuer Stadtplanung und Umwelt
27.06.2023 04:00;12;7;5;Leicht bewoelkt;14;14;0;Stadt Konstanz, Amt fuer Stadtplanung und Umwelt
27.06.2023 05:00;73;43;30;Sonnig;14;14;0;Stadt Konstanz, Amt fuer Stadtplanung und Umwelt
27.06.2023 06:00;250;139;111;Sonnig;14;15;0;Stadt Konstanz, Amt fuer Stadtplanung und Umwelt
27.06.2023 07:00;946;594;352;Sonnig;17;17;0;Stadt Konstanz, Amt fuer Stadtplanung und Umwelt
27.06.2023 08:00;1149;681;468;Sonnig;19;19;0;Stadt Konstanz, Amt fuer Stadtplanung und Umwelt
27.06.2023 09:00;897;537;360;Leicht bewoelkt;20;20;0;Stadt Konstanz, Amt fuer Stadtplanung und Umwelt
27.06.2023 10:00;776;436;340;Leicht bewoelkt;22;22;0;Stadt Konstanz, Amt fuer Stadtplanung und Umwelt
27.06.2023 11:00;920;452;468;Leicht bewoelkt;23;24;0;Stadt Konstanz, Amt fuer Stadtplanung und Umwelt
27.06.2023 12:00;920;368;552;Sonnig;24;25;0;Stadt Konstanz, Amt fuer Stadtplanung und Umwelt
27.06.2023 13:00;1065;472;593;Sonnig;25;25;0;Stadt Konstanz, Amt fuer Stadtplanung und Umwelt
27.06.2023 14:00;898;449;449;Sonnig;26;26;0;Stadt Konstanz, Amt fuer Stadtplanung und Umwelt
27.06.2023 15:00;1083;473;610;Sonnig;26;26;0;Stadt Konstanz, Amt fuer Stadtplanung und Umwelt
27.06.2023 16:00;1260;578;682;Sonnig;26;25;0;Stadt Konstanz, Amt fuer Stadtplanung und Umwelt
27.06.2023 17:00;1359;664;695;Sonnig;24;25;0;Stadt Konstanz, Amt fuer Stadtplanung und Umwelt
27.06.2023 18:00;1121;542;579;Sonnig;24;25;0;Stadt Konstanz, Amt fuer Stadtplanung und Umwelt
27.06.2023 19:00;999;486;513;Sonnig;20;20;0;Stadt Konstanz, Amt fuer Stadtplanung und Umwelt
27.06.2023 20:00;673;305;368;Sonnig;16;16;0;Stadt Konstanz, Amt fuer Stadtplanung und Umwelt
27.06.2023 21:00;630;258;372;Sonnig;14;14;0;Stadt Konstanz, Amt fuer Stadtplanung und Umwelt
27.06.2023 22:00;466;183;283;Sonnig;13;13;0;Stadt Konstanz, Amt fuer Stadtplanung und Umwelt
27.06.2023 23:00;247;69;178;Sonnig;12;13;0;Stadt Konstanz, Amt fuer Stadtplanung und Umwelt
28.06.2023 00:00;111;46;65;Sonnig;11;12;0;Stadt Konstanz, Amt fuer Stadtplanung und Umwelt
28.06.2023 01:00;45;18;27;Sonnig;12;12;0;Stadt Konstanz, Amt fuer Stadtplanung und Umwelt
28.06.2023 02:00;21;5;16;Sonnig;12;12;0;Stadt Konstanz, Amt fuer Stadtplanung und Umwelt
28.06.2023 03:00;12;7;5;Leicht bewoelkt;11;11;0;Stadt Konstanz, Amt fuer Stadtplanung und Umwelt
28.06.2023 04:00;13;7;6;Leicht bewoelkt;11;11;0;Stadt Konstanz, Amt fuer Stadtplanung und Umwelt
28.06.2023 05:00;85;51;34;Leicht bewoelkt;11;11;0;Stadt Konstanz, Amt fuer Stadtplanung und Umwelt
28.06.2023 06:00;248;135;113;Bewoelkt;14;14;0;Stadt Konstanz, Amt fuer Stadtplanung und Umwelt
28.06.2023 07:00;1037;669;368;Bewoelkt;15;16;0;Stadt Konstanz, Amt fuer Stadtplanung und Umwelt
28.06.2023 08:00;1005;597;408;Bedeckt;15;15;0;Stadt Konstanz, Amt fuer Stadtplanung und Umwelt
28.06.2023 09:00;933;564;369;Bedeckt;16;16;0;Stadt Konstanz, Amt fuer Stadtplanung und Umwelt
28.06.2023 10:00;659;330;329;Leicht bewoelkt;16;16;0;Stadt Konstanz, Amt fuer Stadtplanung und Umwelt
28.06.2023 11:00;842;372;470;Bewoelkt;18;18;0;Stadt Konstanz, Amt fuer Stadtplanung und Umwelt
28.06.2023 12:00;949;393;556;Bewoelkt;18;18;0;Stadt Konstanz, Amt fuer Stadtplanung und Umwelt
28.06.2023 13:00;1222;595;627;Leicht bewoelkt;17;17;0;Stadt Konstanz, Amt fuer Stadtplanung und Umwelt
28.06.2023 14:00;944;479;465;Leicht bewoelkt;21;21;0;Stadt Konstanz, Amt fuer Stadtplanung und Umwelt
28.06.2023 15:00;1081;501;580;Leicht bewoelkt;21;21;0;Stadt Konstanz, Amt fuer Stadtplanung und Umwelt
28.06.2023 16:00;1214;550;664;Bewoelkt;18;18;0;Stadt Konstanz, Amt fuer Stadtplanung und Umwelt
28.06.2023 17:00;1293;613;680;Leicht bewoelkt;17;17;0;Stadt Konstanz, Amt fuer Stadtplanung und Umwelt
28.06.2023 18:00;1201;558;643;Leicht bewoelkt;19;19;0;Stadt Konstanz, Amt fuer Stadtplanung und Umwelt
28.06.2023 19:00;873;447;426;Leicht bewoelkt;19;19;0;Stadt Konstanz, Amt fuer Stadtplanung und Umwelt
28.06.2023 20:00;754;390;364;Leicht bewoelkt;15;15;0;Stadt Konstanz, Amt fuer Stadtplanung und Umwelt
28.06.2023 21:00;594;276;318;Leicht bewoelkt;13;14;0;Stadt Konstanz, Amt fuer Stadtplanung und Umwelt
28.06.2023 22:00;519;164;355;Leicht bewoelkt;12;12;0;Stadt Konstanz, Amt fuer Stadtplanung und Umwelt
28.06.2023 23:00;335;91;244;Sonnig;12;12;0;Stadt Konstanz, Amt fuer Stadtplanung und Umwelt
29.06.2023 00:00;188;57;131;Leicht bewoelkt;12;12;0;Stadt Konstanz, Amt fuer Stadtplanung und Umwelt
29.06.2023 01:00;74;31;43;Leicht bewoelkt;11;11;0;Stadt Konstanz, Amt fuer Stadtplanung und Umwelt
29.06.2023 02:00;32;13;19;Sonnig;11;11;0;Stadt Konstanz, Amt fuer Stadtplanung und Umwelt
29.06.2023 03:00;25;10;15;Sonnig;11;10;0;Stadt Konstanz, Amt fuer Stadtplanung und Umwelt
29.06.2023 04:00;22;15;7;Sonnig;10;10;0;Stadt Konstanz, Amt fuer Stadtplanung und Umwelt
29.06.2023 05:00;74;53;21;Sonnig;10;10;0;Stadt Konstanz, Amt fuer Stadtplanung und Umwelt
29.06.2023 06:00;243;131;112;Sonnig;13;14;0;Stadt Konstanz, Amt fuer Stadtplanung und Umwelt
29.06.2023 07:00;1122;706;416;Sonnig;16;16;0;Stadt Konstanz, Amt fuer Stadtplanung und Umwelt
29.06.2023 08:00;1055;616;439;Sonnig;19;19;0;Stadt Konstanz, Amt fuer Stadtplanung und Umwelt
29.06.2023 09:00;900;499;401;Sonnig;21;21;0;Stadt Konstanz, Amt fuer Stadtplanung und Umwelt
29.06.2023 10:00;659;381;278;Sonnig;23;25;0;Stadt Konstanz, Amt fuer Stadtplanung und Umwelt
29.06.2023 11:00;806;401;405;Sonnig;25;26;0;Stadt Konstanz, Amt fuer Stadtplanung und Umwelt
29.06.2023 12:00;855;373;482;Sonnig;30;30;0;Stadt Konstanz, Amt fuer Stadtplanung und Umwelt
29.06.2023 13:00;1090;477;613;Sonnig;31;31;0;Stadt Konstanz, Amt fuer Stadtplanung und Umwelt
29.06.2023 14:00;927;474;453;Leicht bewoelkt;29;29;0;Stadt Konstanz, Amt fuer Stadtplanung und Umwelt
29.06.2023 15:00;1287;610;677;Leicht bewoelkt;29;29;0;Stadt Konstanz, Amt fuer Stadtplanung und Umwelt
29.06.2023 16:00;1218;573;645;Leicht bewoelkt;29;29;0;Stadt Konstanz, Amt fuer Stadtplanung und Umwelt
29.06.2023 17:00;1354;614;740;Leicht bewoelkt;28;28;0;Stadt Konstanz, Amt fuer Stadtplanung und Umwelt
29.06.2023 18:00;1247;578;669;Leicht bewoelkt;27;28;0;Stadt Konstanz, Amt fuer Stadtplanung und Umwelt
29.06.2023 19:00;833;408;425;Leicht bewoelkt;24;26;0;Stadt Konstanz, Amt fuer Stadtplanung und Umwelt
29.06.2023 20:00;603;289;314;Leicht bewoelkt;20;20;0;Stadt Konstanz, Amt fuer Stadtplanung und Umwelt
29.06.2023 21:00;440;201;239;Leicht bewoelkt;19;19;0;Stadt Konstanz, Amt fuer Stadtplanung und Umwelt
29.06.2023 22:00;399;151;248;Leicht bewoelkt;18;18;0;Stadt Konstanz, Amt fuer Stadtplanung und Umwelt
29.06.2023 23:00;241;95;146;Leicht bewoelkt;18;18;0;Stadt Konstanz, Amt fuer Stadtplanung und Umwelt
30.06.2023 00:00;98;32;66;Leichter Regenschauer;15;15;0.2;Stadt Konstanz, Amt fuer Stadtplanung und Umwelt
30.06.2023 01:00;61;23;38;Nebel;15;15;0;Stadt Konstanz, Amt fuer Stadtplanung und Umwelt
30.06.2023 02:00;21;11;10;Nebel;15;16;0.1;Stadt Konstanz, Amt fuer Stadtplanung und Umwelt
30.06.2023 03:00;9;5;4;Nebel;15;15;0;Stadt Konstanz, Amt fuer Stadtplanung und Umwelt
30.06.2023 04:00;22;11;11;Leichter Regenschauer;15;15;0.8;Stadt Konstanz, Amt fuer Stadtplanung und Umwelt
30.06.2023 05:00;59;37;22;Nebel;15;15;0;Stadt Konstanz, Amt fuer Stadtplanung und Umwelt
30.06.2023 06:00;171;92;79;Leichter Regenschauer;16;16;0.5;Stadt Konstanz, Amt fuer Stadtplanung und Umwelt
30.06.2023 07:00;927;598;329;Nebel;16;16;0;Stadt Konstanz, Amt fuer Stadtplanung und Umwelt
30.06.2023 08:00;620;357;263;Leichter Regenfall;16;16;1.1;Stadt Konstanz, Amt fuer Stadtplanung und Umwelt
30.06.2023 09:00;629;381;248;Nieselregen;16;16;0.6;Stadt Konstanz, Amt fuer Stadtplanung und Umwelt
30.06.2023 10:00;591;346;245;Maeßiger Regenfall;17;17;2.9;Stadt Konstanz, Amt fuer Stadtplanung und Umwelt
30.06.2023 11:00;634;316;318;Nieselregen;17;17;0.5;Stadt Konstanz, Amt fuer Stadtplanung und Umwelt
30.06.2023 12:00;779;362;417;Leichter Regenschauer;18;18;0.9;Stadt Konstanz, Amt fuer Stadtplanung und Umwelt
30.06.2023 13:00;1065;373;692;Maeßiger Regenfall;18;18;3;Stadt Konstanz, Amt fuer Stadtplanung und Umwelt
30.06.2023 14:00;791;391;400;Leichter Regenschauer;17;17;2.2;Stadt Konstanz, Amt fuer Stadtplanung und Umwelt
30.06.2023 15:00;874;452;422;Leichter Regenschauer;17;17;1.2;Stadt Konstanz, Amt fuer Stadtplanung und Umwelt
30.06.2023 16:00;633;269;364;Maeßiger bis starker Regenschauer;18;18;4.5;Stadt Konstanz, Amt fuer Stadtplanung und Umwelt
30.06.2023 17:00;670;289;381;Leichter Regenschauer;18;18;0.9;Stadt Konstanz, Amt fuer Stadtplanung und Umwelt
30.06.2023 18:00;590;259;331;Leichter Regenschauer;17;17;1.2;Stadt Konstanz, Amt fuer Stadtplanung und Umwelt
30.06.2023 19:00;415;184;231;Maeßiger bis starker Regenschauer;16;16;4.3;Stadt Konstanz, Amt fuer Stadtplanung und Umwelt
30.06.2023 20:00;296;133;163;Bewoelkt;15;15;0;Stadt Konstanz, Amt fuer Stadtplanung und Umwelt
30.06.2023 21:00;274;120;154;Leicht bewoelkt;14;14;0;Stadt Konstanz, Amt fuer Stadtplanung und Umwelt
30.06.2023 22:00;254;90;164;Sonnig;12;13;0;Stadt Konstanz, Amt fuer Stadtplanung und Umwelt
30.06.2023 23:00;187;73;114;Leichter Nebel;11;11;0;Stadt Konstanz, Amt fuer Stadtplanung und Umwelt
01.07.2023 00:00;185;84;101;Leichter Regenschauer;14;13;0.6;Stadt Konstanz, Amt fuer Stadtplanung und Umwelt
01.07.2023 01:00;120;49;71;Maeßiger bis starker Regenschauer;14;14;3.1;Stadt Konstanz, Amt fuer Stadtplanung und Umwelt
01.07.2023 02:00;73;32;41;Leichter Nebel;13;14;0.1;Stadt Konstanz, Amt fuer Stadtplanung und Umwelt
01.07.2023 03:00;52;24;28;Bewoelkt;13;13;0;Stadt Konstanz, Amt fuer Stadtplanung und Umwelt
01.07.2023 04:00;26;15;11;Stellenweiser Regenfall;13;13;0.1;Stadt Konstanz, Amt fuer Stadtplanung und Umwelt
01.07.2023 05:00;24;10;14;Leicht bewoelkt;13;13;0;Stadt Konstanz, Amt fuer Stadtplanung und Umwelt
01.07.2023 06:00;43;24;19;Sonnig;14;14;0;Stadt Konstanz, Amt fuer Stadtplanung und Umwelt
01.07.2023 07:00;118;54;64;Stellenweiser Regenfall;15;15;0.1;Stadt Konstanz, Amt fuer Stadtplanung und Umwelt
01.07.2023 08:00;271;154;117;Sonnig;16;16;0;Stadt Konstanz, Amt fuer Stadtplanung und Umwelt
01.07.2023 09:00;622;369;253;Sonnig;19;19;0;Stadt Konstanz, Amt fuer Stadtplanung und Umwelt
01.07.2023 10:00;802;478;324;Sonnig;20;20;0;Stadt Konstanz, Amt fuer Stadtplanung und Umwelt
01.07.2023 11:00;691;370;321;Leicht bewoelkt;22;22;0;Stadt Konstanz, Amt fuer Stadtplanung und Umwelt
01.07.2023 12:00;899;471;428;Leicht bewoelkt;22;24;0;Stadt Konstanz, Amt fuer Stadtplanung und Umwelt
01.07.2023 13:00;785;408;377;Leicht bewoelkt;23;25;0;Stadt Konstanz, Amt fuer Stadtplanung und Umwelt
01.07.2023 14:00;896;453;443;Bedeckt;19;19;0;Stadt Konstanz, Amt fuer Stadtplanung und Umwelt
01.07.2023 15:00;829;407;422;Stellenweiser Regenfall;15;15;0.1;Stadt Konstanz, Amt fuer Stadtplanung und Umwelt
01.07.2023 16:00;831;418;413;Leichter Regenfall;14;13;0.8;Stadt Konstanz, Amt fuer Stadtplanung und Umwelt
01.07.2023 17:00;828;405;423;Nieselregen;14;13;0.2;Stadt Konstanz, Amt fuer Stadtplanung und Umwelt
01.07.2023 18:00;686;307;379;Nieselregen;13;13;0.3;Stadt Konstanz, Amt fuer Stadtplanung und Umwelt
01.07.2023 19:00;573;300;273;Leichter Regenfall;14;13;1.2;Stadt Konstanz, Amt fuer Stadtplanung und Umwelt
01.07.2023 20:00;467;190;277;Nebel;14;13;0;Stadt Konstanz, Amt fuer Stadtplanung und Umwelt
01.07.2023 21:00;354;155;199;Nebel;14;13;0;Stadt Konstanz, Amt fuer Stadtplanung und Umwelt
01.07.2023 22:00;356;143;213;Nebel;14;13;0;Stadt Konstanz, Amt fuer Stadtplanung und Umwelt
01.07.2023 23:00;247;89;158;Nebel;14;14;0;Stadt Konstanz, Amt fuer Stadtplanung und Umwelt
02.07.2023 00:00;198;60;138;Nebel;14;13;0;Stadt Konstanz, Amt fuer Stadtplanung und Umwelt
02.07.2023 01:00;121;46;75;Leichter Nebel;14;13;0;Stadt Konstanz, Amt fuer Stadtplanung und Umwelt
02.07.2023 02:00;58;21;37;Leichter Nebel;14;14;0;Stadt Konstanz, Amt fuer Stadtplanung und Umwelt
02.07.2023 03:00;55;21;34;Nebel;13;13;0;Stadt Konstanz, Amt fuer Stadtplanung und Umwelt
02.07.2023 04:00;26;15;11;Nebel;13;13;0.1;Stadt Konstanz, Amt fuer Stadtplanung und Umwelt
02.07.2023 05:00;27;14;13;Nebel;13;13;0;Stadt Konstanz, Amt fuer Stadtplanung und Umwelt
02.07.2023 06:00;26;18;8;Leichter Nebel;14;14;0;Stadt Konstanz, Amt fuer Stadtplanung und Umwelt
02.07.2023 07:00;56;26;30;Leicht bewoelkt;15;15;0;Stadt Konstanz, Amt fuer Stadtplanung und Umwelt
02.07.2023 08:00;123;56;67;Leicht bewoelkt;17;17;0;Stadt Konstanz, Amt fuer Stadtplanung und Umwelt
02.07.2023 09:00;318;181;137;Leicht bewoelkt;19;19;0;Stadt Konstanz, Amt fuer Stadtplanung und Umwelt
02.07.2023 10:00;386;214;172;Stellenweiser Regenfall;21;21;0.1;Stadt Konstanz, Amt fuer Stadtplanung und Umwelt
02.07.2023 11:00;441;243;198;Leicht bewoelkt;21;21;0;Stadt Konstanz, Amt fuer Stadtplanung und Umwelt
02.07.2023 12:00;522;246;276;Bewoelkt;20;20;0;Stadt Konstanz, Amt fuer Stadtplanung und Umwelt
02.07.2023 13:00;510;228;282;Bewoelkt;21;21;0;Stadt Konstanz, Amt fuer Stadtplanung und Umwelt
02.07.2023 14:00;624;327;297;Bedeckt;23;25;0;Stadt Konstanz, Amt fuer Stadtplanung und Umwelt
02.07.2023 15:00;562;294;268;Leicht bewoelkt;22;25;0;Stadt Konstanz, Amt fuer Stadtplanung und Umwelt
02.07.2023 16:00;650;319;331;Leicht bewoelkt;23;25;0;Stadt Konstanz, Amt fuer Stadtplanung und Umwelt
02.07.2023 17:00;685;305;380;Leicht bewoelkt;23;25;0;Stadt Konstanz, Amt fuer Stadtplanung und Umwelt
02.07.2023 18:00;614;273;341;Leicht bewoelkt;22;22;0;Stadt Konstanz, Amt fuer Stadtplanung und Umwelt
02.07.2023 19:00;513;253;260;Stellenweiser Regenfall;21;21;0.1;Stadt Konstanz, Amt fuer Stadtplanung und Umwelt
02.07.2023 20:00;358;188;170;Leicht bewoelkt;17;17;0;Stadt Konstanz, Amt fuer Stadtplanung und Umwelt
02.07.2023 21:00;307;140;167;Bewoelkt;16;16;0;Stadt Konstanz, Amt fuer Stadtplanung und Umwelt
02.07.2023 22:00;184;86;98;Bewoelkt;15;15;0;Stadt Konstanz, Amt fuer Stadtplanung und Umwelt
02.07.2023 23:00;106;32;74;Leicht bewoelkt;15;16;0;Stadt Konstanz, Amt fuer Stadtplanung und Umwelt
03.07.2023 00:00;40;19;21;Sonnig;15;16;0;Stadt Konstanz, Amt fuer Stadtplanung und Umwelt
03.07.2023 01:00;20;9;11;Leicht bewoelkt;14;14;0;Stadt Konstanz, Amt fuer Stadtplanung und Umwelt
03.07.2023 02:00;7;3;4;Sonnig;14;14;0;Stadt Konstanz, Amt fuer Stadtplanung und Umwelt
03.07.2023 03:00;5;1;4;Sonnig;14;14;0;Stadt Konstanz, Amt fuer Stadtplanung und Umwelt
03.07.2023 04:00;13;9;4;Sonnig;14;14;0;Stadt Konstanz, Amt fuer Stadtplanung und Umwelt
03.07.2023 05:00;56;35;21;Sonnig;14;14;0;Stadt Konstanz, Amt fuer Stadtplanung und Umwelt
03.07.2023 06:00;211;124;87;Leicht bewoelkt;15;15;0;Stadt Konstanz, Amt fuer Stadtplanung und Umwelt
03.07.2023 07:00;985;595;390;Sonnig;17;17;0;Stadt Konstanz, Amt fuer Stadtplanung und Umwelt
03.07.2023 08:00;906;492;414;Sonnig;19;19;0;Stadt Konstanz, Amt fuer Stadtplanung und Umwelt
03.07.2023 09:00;858;493;365;Sonnig;21;21;0;Stadt Konstanz, Amt fuer Stadtplanung und Umwelt
03.07.2023 10:00;630;359;271;Leicht bewoelkt;22;22;0;Stadt Konstanz, Amt fuer Stadtplanung und Umwelt
03.07.2023 11:00;689;363;326;Leicht bewoelkt;23;25;0;Stadt Konstanz, Amt fuer Stadtplanung und Umwelt
03.07.2023 12:00;823;396;427;Sonnig;24;25;0;Stadt Konstanz, Amt fuer Stadtplanung und Umwelt
03.07.2023 13:00;1044;449;595;Sonnig;25;25;0;Stadt Konstanz, Amt fuer Stadtplanung und Umwelt
03.07.2023 14:00;862;411;451;Sonnig;26;26;0;Stadt Konstanz, Amt fuer Stadtplanung und Umwelt
03.07.2023 15:00;1172;578;594;Sonnig;25;25;0;Stadt Konstanz, Amt fuer Stadtplanung und Umwelt
03.07.2023 16:00;1107;514;593;Leicht bewoelkt;24;25;0;Stadt Konstanz, Amt fuer Stadtplanung und Umwelt
03.07.2023 17:00;1209;566;643;Leicht bewoelkt;24;25;0;Stadt Konstanz, Amt fuer Stadtplanung und Umwelt
03.07.2023 18:00;1093;500;593;Sonnig;23;25;0;Stadt Konstanz, Amt fuer Stadtplanung und Umwelt
03.07.2023 19:00;791;382;409;Leicht bewoelkt;21;21;0;Stadt Konstanz, Amt fuer Stadtplanung und Umwelt
03.07.2023 20:00;615;274;341;Leicht bewoelkt;16;16;0;Stadt Konstanz, Amt fuer Stadtplanung und Umwelt
03.07.2023 21:00;493;198;295;Bedeckt;15;15;0;Stadt Konstanz, Amt fuer Stadtplanung und Umwelt
03.07.2023 22:00;339;142;197;Stellenweiser Regenfall;15;15;0.1;Stadt Konstanz, Amt fuer Stadtplanung und Umwelt
03.07.2023 23:00;141;55;86;Bedeckt;15;15;0;Stadt Konstanz, Amt fuer Stadtplanung und Umwelt
04.07.2023 00:00;87;34;53;Bewoelkt;16;16;0;Stadt Konstanz, Amt fuer Stadtplanung und Umwelt
04.07.2023 01:00;48;14;34;Leicht bewoelkt;16;16;0;Stadt Konstanz, Amt fuer Stadtplanung und Umwelt
04.07.2023 02:00;11;5;6;Leicht bewoelkt;13;14;0;Stadt Konstanz, Amt fuer Stadtplanung und Umwelt
04.07.2023 03:00;8;3;5;Leicht bewoelkt;12;12;0;Stadt Konstanz, Amt fuer Stadtplanung und Umwelt
04.07.2023 04:00;14;8;6;Leicht bewoelkt;11;12;0;Stadt Konstanz, Amt fuer Stadtplanung und Umwelt
04.07.2023 05:00;63;43;20;Bewoelkt;12;12;0;Stadt Konstanz, Amt fuer Stadtplanung und Umwelt
04.07.2023 06:00;240;134;106;Leicht bewoelkt;15;16;0;Stadt Konstanz, Amt fuer Stadtplanung und Umwelt
04.07.2023 07:00;906;537;369;Stellenweiser Regenfall;16;16;0.1;Stadt Konstanz, Amt fuer Stadtplanung und Umwelt
04.07.2023 08:00;958;539;419;Stellenweiser Regenfall;16;16;0.1;Stadt Konstanz, Amt fuer Stadtplanung und Umwelt
04.07.2023 09:00;881;497;384;Stellenweiser Regenfall;18;18;0.2;Stadt Konstanz, Amt fuer Stadtplanung und Umwelt
04.07.2023 10:00;712;395;317;Stellenweiser Regenfall;21;21;0.6;Stadt Konstanz, Amt fuer Stadtplanung und Umwelt
04.07.2023 11:00;825;390;435;Leichter Regenschauer;22;25;0.2;Stadt Konstanz, Amt fuer Stadtplanung und Umwelt
04.07.2023 12:00;874;362;512;Stellenweiser Regenfall;23;25;0.3;Stadt Konstanz, Amt fuer Stadtplanung und Umwelt
04.07.2023 13:00;1033;482;551;Stellenweiser Regenfall;23;25;1.3;Stadt Konstanz, Amt fuer Stadtplanung und Umwelt
04.07.2023 14:00;830;421;409;Stellenweiser Regenfall;24;25;0.1;Stadt Konstanz, Amt fuer Stadtplanung und Umwelt
04.07.2023 15:00;1069;563;506;Sonnig;24;25;0;Stadt Konstanz, Amt fuer Stadtplanung und Umwelt
04.07.2023 16:00;1125;513;612;Stellenweiser Regenfall;25;25;0.1;Stadt Konstanz, Amt fuer Stadtplanung und Umwelt
04.07.2023 17:00;1364;677;687;Sonnig;24;25;0;Stadt Konstanz, Amt fuer Stadtplanung und Umwelt
04.07.2023 18:00;1241;608;633;Sonnig;23;25;0;Stadt Konstanz, Amt fuer Stadtplanung und Umwelt
04.07.2023 19:00;854;438;416;Leicht bewoelkt;21;21;0;Stadt Konstanz, Amt fuer Stadtplanung und Umwelt
04.07.2023 20:00;705;323;382;Leicht bewoelkt;17;17;0;Stadt Konstanz, Amt fuer Stadtplanung und Umwelt
04.07.2023 21:00;526;206;320;Stellenweiser Regenfall;15;15;0.1;Stadt Konstanz, Amt fuer Stadtplanung und Umwelt
04.07.2023 22:00;413;161;252;Stellenweiser Regenfall;15;15;0.3;Stadt Konstanz, Amt fuer Stadtplanung und Umwelt
04.07.2023 23:00;241;81;160;Stellenweiser Regenfall;15;15;0.1;Stadt Konstanz, Amt fuer Stadtplanung und Umwelt
05.07.2023 00:00;72;22;50;Stellenweiser Regenfall;12;12;0.1;Stadt Konstanz, Amt fuer Stadtplanung und Umwelt
05.07.2023 01:00;46;25;21;Sonnig;12;12;0;Stadt Konstanz, Amt fuer Stadtplanung und Umwelt
05.07.2023 02:00;19;6;13;Stellenweise Gewitter und Niederschlaege;12;12;0;Stadt Konstanz, Amt fuer Stadtplanung und Umwelt
05.07.2023 03:00;13;4;9;Leichter Nebel;12;11;0.1;Stadt Konstanz, Amt fuer Stadtplanung und Umwelt
05.07.2023 04:00;17;11;6;Nieselregen mit Gewitter;12;11;0.6;Stadt Konstanz, Amt fuer Stadtplanung und Umwelt
05.07.2023 05:00;45;32;13;Nebel;12;11;0;Stadt Konstanz, Amt fuer Stadtplanung und Umwelt
05.07.2023 06:00;184;106;78;Nebel;13;13;0.1;Stadt Konstanz, Amt fuer Stadtplanung und Umwelt
05.07.2023 07:00;858;476;382;Leichter Nebel;15;15;0;Stadt Konstanz, Amt fuer Stadtplanung und Umwelt
05.07.2023 08:00;876;539;337;Stellenweiser Regenfall;16;16;0.1;Stadt Konstanz, Amt fuer Stadtplanung und Umwelt
05.07.2023 09:00;809;464;345;Leicht bewoelkt;17;17;0;Stadt Konstanz, Amt fuer Stadtplanung und Umwelt
05.07.2023 10:00;455;233;222;Leichter Regenschauer;20;20;0.2;Stadt Konstanz, Amt fuer Stadtplanung und Umwelt
05.07.2023 11:00;568;282;286;Leicht bewoelkt;22;22;0;Stadt Konstanz, Amt fuer Stadtplanung und Umwelt
05.07.2023 12:00;703;315;388;Stellenweiser Regenfall;23;25;0.1;Stadt Konstanz, Amt fuer Stadtplanung und Umwelt
05.07.2023 13:00;1003;476;527;Leicht bewoelkt;23;25;0;Stadt Konstanz, Amt fuer Stadtplanung und Umwelt
05.07.2023 14:00;698;333;365;Stellenweiser Regenfall;24;25;0.1;Stadt Konstanz, Amt fuer Stadtplanung und Umwelt
05.07.2023 15:00;916;449;467;Stellenweiser Regenfall;23;25;0.1;Stadt Konstanz, Amt fuer Stadtplanung und Umwelt
05.07.2023 16:00;988;470;518;Stellenweiser Regenfall;22;25;0.3;Stadt Konstanz, Amt fuer Stadtplanung und Umwelt
05.07.2023 17:00;1158;590;568;Stellenweiser Regenfall;23;25;0.1;Stadt Konstanz, Amt fuer Stadtplanung und Umwelt
05.07.2023 18:00;969;498;471;Stellenweiser Regenfall;21;21;0.1;Stadt Konstanz, Amt fuer Stadtplanung und Umwelt
05.07.2023 19:00;696;317;379;Leichter Regenschauer;18;18;0.3;Stadt Konstanz, Amt fuer Stadtplanung und Umwelt
05.07.2023 20:00;587;283;304;Stellenweiser Regenfall;16;16;0.1;Stadt Konstanz, Amt fuer Stadtplanung und Umwelt
05.07.2023 21:00;487;212;275;Stellenweiser Regenfall;15;15;0.1;Stadt Konstanz, Amt fuer Stadtplanung und Umwelt
05.07.2023 22:00;386;162;224;Leichter Regenschauer;14;14;0.4;Stadt Konstanz, Amt fuer Stadtplanung und Umwelt
05.07.2023 23:00;229;87;142;Stellenweiser Regenfall;14;14;0.1;Stadt Konstanz, Amt fuer Stadtplanung und Umwelt
06.07.2023 00:00;127;52;75;Sonnig;11;11;0;Stadt Konstanz, Amt fuer Stadtplanung und Umwelt
06.07.2023 01:00;64;25;39;Stellenweiser Regenfall;10;10;0.1;Stadt Konstanz, Amt fuer Stadtplanung und Umwelt
06.07.2023 02:00;24;12;12;Leicht bewoelkt;10;9;0;Stadt Konstanz, Amt fuer Stadtplanung und Umwelt
06.07.2023 03:00;11;7;4;Leicht bewoelkt;9;9;0;Stadt Konstanz, Amt fuer Stadtplanung und Umwelt
06.07.2023 04:00;11;7;4;Leicht bewoelkt;8;8;0;Stadt Konstanz, Amt fuer Stadtplanung und Umwelt
06.07.2023 05:00;57;45;12;Leicht bewoelkt;8;8;0;Stadt Konstanz, Amt fuer Stadtplanung und Umwelt
06.07.2023 06:00;238;135;103;Leicht bewoelkt;11;11;0;Stadt Konstanz, Amt fuer Stadtplanung und Umwelt
06.07.2023 07:00;1137;700;437;Sonnig;14;15;0;Stadt Konstanz, Amt fuer Stadtplanung und Umwelt
06.07.2023 08:00;988;554;434;Sonnig;17;17;0;Stadt Konstanz, Amt fuer Stadtplanung und Umwelt
06.07.2023 09:00;837;464;373;Sonnig;19;19;0;Stadt Konstanz, Amt fuer Stadtplanung und Umwelt
06.07.2023 10:00;682;354;328;Sonnig;21;21;0;Stadt Konstanz, Amt fuer Stadtplanung und Umwelt
06.07.2023 11:00;778;394;384;Sonnig;24;25;0;Stadt Konstanz, Amt fuer Stadtplanung und Umwelt
06.07.2023 12:00;843;364;479;Sonnig;25;25;0;Stadt Konstanz, Amt fuer Stadtplanung und Umwelt
06.07.2023 13:00;1133;477;656;Sonnig;29;28;0;Stadt Konstanz, Amt fuer Stadtplanung und Umwelt
06.07.2023 14:00;910;473;437;Sonnig;29;28;0;Stadt Konstanz, Amt fuer Stadtplanung und Umwelt
06.07.2023 15:00;1228;626;602;Sonnig;29;28;0;Stadt Konstanz, Amt fuer Stadtplanung und Umwelt
06.07.2023 16:00;1198;585;613;Leicht bewoelkt;26;26;0;Stadt Konstanz, Amt fuer Stadtplanung und Umwelt
06.07.2023 17:00;1403;694;709;Leicht bewoelkt;25;25;0;Stadt Konstanz, Amt fuer Stadtplanung und Umwelt
06.07.2023 18:00;1255;574;681;Stellenweise Gewitter und Niederschlaege;25;26;0;Stadt Konstanz, Amt fuer Stadtplanung und Umwelt
06.07.2023 19:00;961;457;504;Sonnig;21;21;0;Stadt Konstanz, Amt fuer Stadtplanung und Umwelt
06.07.2023 20:00;708;321;387;Stellenweise Gewitter und Niederschlaege;17;17;0;Stadt Konstanz, Amt fuer Stadtplanung und Umwelt
06.07.2023 21:00;597;245;352;Sonnig;15;15;0;Stadt Konstanz, Amt fuer Stadtplanung und Umwelt
06.07.2023 22:00;475;179;296;Sonnig;14;14;0;Stadt Konstanz, Amt fuer Stadtplanung und Umwelt
06.07.2023 23:00;299;111;188;Sonnig;13;13;0;Stadt Konstanz, Amt fuer Stadtplanung und Umwelt
07.07.2023 00:00;139;48;91;Sonnig;13;13;0;Stadt Konstanz, Amt fuer Stadtplanung und Umwelt
07.07.2023 01:00;60;13;47;Sonnig;12;13;0;Stadt Konstanz, Amt fuer Stadtplanung und Umwelt
07.07.2023 02:00;18;7;11;Sonnig;11;12;0;Stadt Konstanz, Amt fuer Stadtplanung und Umwelt
07.07.2023 03:00;7;2;5;Sonnig;11;11;0;Stadt Konstanz, Amt fuer Stadtplanung und Umwelt
07.07.2023 04:00;20;10;10;Sonnig;10;11;0;Stadt Konstanz, Amt fuer Stadtplanung und Umwelt
07.07.2023 05:00;54;40;14;Sonnig;10;11;0;Stadt Konstanz, Amt fuer Stadtplanung und Umwelt
07.07.2023 06:00;202;113;89;Sonnig;12;13;0;Stadt Konstanz, Amt fuer Stadtplanung und Umwelt
07.07.2023 07:00;1026;648;378;Sonnig;16;16;0;Stadt Konstanz, Amt fuer Stadtplanung und Umwelt
07.07.2023 08:00;957;542;415;Sonnig;19;19;0;Stadt Konstanz, Amt fuer Stadtplanung und Umwelt
07.07.2023 09:00;842;515;327;Sonnig;21;21;0;Stadt Konstanz, Amt fuer Stadtplanung und Umwelt
07.07.2023 10:00;748;384;364;Sonnig;23;25;0;Stadt Konstanz, Amt fuer Stadtplanung und Umwelt
07.07.2023 11:00;844;405;439;Sonnig;29;28;0;Stadt Konstanz, Amt fuer Stadtplanung und Umwelt
07.07.2023 12:00;1017;490;527;Sonnig;30;30;0;Stadt Konstanz, Amt fuer Stadtplanung und Umwelt
07.07.2023 13:00;1199;483;716;Sonnig;32;31;0;Stadt Konstanz, Amt fuer Stadtplanung und Umwelt
07.07.2023 14:00;1078;580;498;Sonnig;33;32;0;Stadt Konstanz, Amt fuer Stadtplanung und Umwelt
07.07.2023 15:00;1028;489;539;Sonnig;33;32;0;Stadt Konstanz, Amt fuer Stadtplanung und Umwelt
07.07.2023 16:00;1117;515;602;Sonnig;32;30;0;Stadt Konstanz, Amt fuer Stadtplanung und Umwelt
07.07.2023 17:00;1106;575;531;Sonnig;30;29;0;Stadt Konstanz, Amt fuer Stadtplanung und Umwelt
07.07.2023 18:00;1218;701;517;Sonnig;29;29;0;Stadt Konstanz, Amt fuer Stadtplanung und Umwelt
07.07.2023 19:00;1043;717;326;Sonnig;24;25;0;Stadt Konstanz, Amt fuer Stadtplanung und Umwelt
07.07.2023 20:00;800;498;302;Sonnig;19;19;0;Stadt Konstanz, Amt fuer Stadtplanung und Umwelt
07.07.2023 21:00;578;285;293;Sonnig;17;17;0;Stadt Konstanz, Amt fuer Stadtplanung und Umwelt
07.07.2023 22:00;739;181;558;Sonnig;16;16;0;Stadt Konstanz, Amt fuer Stadtplanung und Umwelt
07.07.2023 23:00;605;112;493;Sonnig;16;16;0;Stadt Konstanz, Amt fuer Stadtplanung und Umwelt
08.07.2023 00:00;452;65;387;Sonnig;15;15;0;Stadt Konstanz, Amt fuer Stadtplanung und Umwelt
08.07.2023 01:00;268;46;222;Sonnig;14;15;0;Stadt Konstanz, Amt fuer Stadtplanung und Umwelt
08.07.2023 02:00;135;19;116;Sonnig;14;15;0;Stadt Konstanz, Amt fuer Stadtplanung und Umwelt
08.07.2023 03:00;92;31;61;Sonnig;13;14;0;Stadt Konstanz, Amt fuer Stadtplanung und Umwelt
08.07.2023 04:00;48;18;30;Leicht bewoelkt;13;14;0;Stadt Konstanz, Amt fuer Stadtplanung und Umwelt
08.07.2023 05:00;36;18;18;Leicht bewoelkt;14;14;0;Stadt Konstanz, Amt fuer Stadtplanung und Umwelt
08.07.2023 06:00;76;46;30;Leicht bewoelkt;15;15;0;Stadt Konstanz, Amt fuer Stadtplanung und Umwelt
08.07.2023 07:00;125;64;61;Leicht bewoelkt;18;18;0;Stadt Konstanz, Amt fuer Stadtplanung und Umwelt
08.07.2023 08:00;330;194;136;Sonnig;21;21;0;Stadt Konstanz, Amt fuer Stadtplanung und Umwelt
08.07.2023 09:00;567;358;209;Sonnig;24;25;0;Stadt Konstanz, Amt fuer Stadtplanung und Umwelt
08.07.2023 10:00;633;356;277;Sonnig;26;27;0;Stadt Konstanz, Amt fuer Stadtplanung und Umwelt
08.07.2023 11:00;775;455;320;Sonnig;31;32;0;Stadt Konstanz, Amt fuer Stadtplanung und Umwelt
08.07.2023 12:00;839;481;358;Sonnig;33;33;0;Stadt Konstanz, Amt fuer Stadtplanung und Umwelt
08.07.2023 13:00;729;356;373;Sonnig;34;34;0;Stadt Konstanz, Amt fuer Stadtplanung und Umwelt
08.07.2023 14:00;821;347;474;Sonnig;35;34;0;Stadt Konstanz, Amt fuer Stadtplanung und Umwelt
08.07.2023 15:00;768;410;358;Sonnig;35;35;0;Stadt Konstanz, Amt fuer Stadtplanung und Umwelt
08.07.2023 16:00;821;399;422;Sonnig;34;33;0;Stadt Konstanz, Amt fuer Stadtplanung und Umwelt
08.07.2023 17:00;832;413;419;Sonnig;33;32;0;Stadt Konstanz, Amt fuer Stadtplanung und Umwelt
08.07.2023 18:00;813;412;401;Sonnig;31;31;0;Stadt Konstanz, Amt fuer Stadtplanung und Umwelt
08.07.2023 19:00;810;416;394;Sonnig;26;26;0;Stadt Konstanz, Amt fuer Stadtplanung und Umwelt
08.07.2023 20:00;641;299;342;Sonnig;21;21;0;Stadt Konstanz, Amt fuer Stadtplanung und Umwelt
08.07.2023 21:00;504;237;267;Leicht bewoelkt;19;19;0;Stadt Konstanz, Amt fuer Stadtplanung und Umwelt
08.07.2023 22:00;509;183;326;Leicht bewoelkt;18;18;0;Stadt Konstanz, Amt fuer Stadtplanung und Umwelt
08.07.2023 23:00;361;117;244;Sonnig;17;17;0;Stadt Konstanz, Amt fuer Stadtplanung und Umwelt
09.07.2023 00:00;286;81;205;Sonnig;17;17;0;Stadt Konstanz, Amt fuer Stadtplanung und Umwelt
09.07.2023 01:00;186;54;132;Sonnig;17;17;0;Stadt Konstanz, Amt fuer Stadtplanung und Umwelt
09.07.2023 02:00;103;37;66;Sonnig;16;16;0;Stadt Konstanz, Amt fuer Stadtplanung und Umwelt
09.07.2023 03:00;54;21;33;Sonnig;15;15;0;Stadt Konstanz, Amt fuer Stadtplanung und Umwelt
09.07.2023 04:00;24;14;10;Sonnig;15;15;0;Stadt Konstanz, Amt fuer Stadtplanung und Umwelt
09.07.2023 05:00;31;18;13;Sonnig;15;15;0;Stadt Konstanz, Amt fuer Stadtplanung und Umwelt
09.07.2023 06:00;64;42;22;Sonnig;17;17;0;Stadt Konstanz, Amt fuer Stadtplanung und Umwelt
09.07.2023 07:00;93;38;55;Sonnig;20;20;0;Stadt Konstanz, Amt fuer Stadtplanung und Umwelt
09.07.2023 08:00;184;110;74;Sonnig;24;25;0;Stadt Konstanz, Amt fuer Stadtplanung und Umwelt
09.07.2023 09:00;439;266;173;Sonnig;26;27;0;Stadt Konstanz, Amt fuer Stadtplanung und Umwelt
09.07.2023 10:00;523;268;255;Sonnig;29;29;0;Stadt Konstanz, Amt fuer Stadtplanung und Umwelt
09.07.2023 11:00;546;272;274;Sonnig;34;36;0;Stadt Konstanz, Amt fuer Stadtplanung und Umwelt
09.07.2023 12:00;547;242;305;Sonnig;36;37;0;Stadt Konstanz, Amt fuer Stadtplanung und Umwelt
09.07.2023 13:00;516;240;276;Sonnig;37;37;0;Stadt Konstanz, Amt fuer Stadtplanung und Umwelt
09.07.2023 14:00;582;274;308;Leicht bewoelkt;35;34;0;Stadt Konstanz, Amt fuer Stadtplanung und Umwelt
09.07.2023 15:00;570;284;286;Leicht bewoelkt;35;34;0;Stadt Konstanz, Amt fuer Stadtplanung und Umwelt
09.07.2023 16:00;604;283;321;Sonnig;35;33;0;Stadt Konstanz, Amt fuer Stadtplanung und Umwelt
09.07.2023 17:00;693;343;350;Sonnig;35;34;0;Stadt Konstanz, Amt fuer Stadtplanung und Umwelt
09.07.2023 18:00;702;389;313;Sonnig;33;34;0;Stadt Konstanz, Amt fuer Stadtplanung und Umwelt
09.07.2023 19:00;593;278;315;Sonnig;28;28;0;Stadt Konstanz, Amt fuer Stadtplanung und Umwelt
09.07.2023 20:00;543;279;264;Sonnig;23;25;0;Stadt Konstanz, Amt fuer Stadtplanung und Umwelt
09.07.2023 21:00;442;174;268;Sonnig;21;21;0;Stadt Konstanz, Amt fuer Stadtplanung und Umwelt
09.07.2023 22:00;300;100;200;Sonnig;20;20;0;Stadt Konstanz, Amt fuer Stadtplanung und Umwelt
09.07.2023 23:00;156;59;97;Sonnig;19;19;0;Stadt Konstanz, Amt fuer Stadtplanung und Umwelt
10.07.2023 00:00;92;40;52;Sonnig;19;19;0;Stadt Konstanz, Amt fuer Stadtplanung und Umwelt
10.07.2023 01:00;34;16;18;Sonnig;18;18;0;Stadt Konstanz, Amt fuer Stadtplanung und Umwelt
10.07.2023 02:00;16;11;5;Sonnig;17;17;0;Stadt Konstanz, Amt fuer Stadtplanung und Umwelt
10.07.2023 03:00;12;4;8;Sonnig;16;16;0;Stadt Konstanz, Amt fuer Stadtplanung und Umwelt
10.07.2023 04:00;15;7;8;Sonnig;16;16;0;Stadt Konstanz, Amt fuer Stadtplanung und Umwelt
10.07.2023 05:00;59;41;18;Sonnig;16;16;0;Stadt Konstanz, Amt fuer Stadtplanung und Umwelt
10.07.2023 06:00;222;133;89;Stellenweiser Regenfall;17;17;0.1;Stadt Konstanz, Amt fuer Stadtplanung und Umwelt
10.07.2023 07:00;1026;600;426;Stellenweiser Regenfall;19;19;0.7;Stadt Konstanz, Amt fuer Stadtplanung und Umwelt
10.07.2023 08:00;741;441;300;Sonnig;21;21;0;Stadt Konstanz, Amt fuer Stadtplanung und Umwelt
10.07.2023 09:00;661;366;295;Sonnig;23;25;0;Stadt Konstanz, Amt fuer Stadtplanung und Umwelt
10.07.2023 10:00;477;260;217;Sonnig;23;25;0;Stadt Konstanz, Amt fuer Stadtplanung und Umwelt
10.07.2023 11:00;606;307;299;Sonnig;30;33;0;Stadt Konstanz, Amt fuer Stadtplanung und Umwelt
10.07.2023 12:00;724;351;373;Sonnig;32;35;0;Stadt Konstanz, Amt fuer Stadtplanung und Umwelt
10.07.2023 13:00;1025;470;555;Sonnig;32;33;0;Stadt Konstanz, Amt fuer Stadtplanung und Umwelt
10.07.2023 14:00;843;390;453;Sonnig;35;37;0;Stadt Konstanz, Amt fuer Stadtplanung und Umwelt
10.07.2023 15:00;1055;501;554;Sonnig;35;36;0;Stadt Konstanz, Amt fuer Stadtplanung und Umwelt
10.07.2023 16:00;1082;517;565;Sonnig;35;35;0;Stadt Konstanz, Amt fuer Stadtplanung und Umwelt
10.07.2023 17:00;1183;570;613;Sonnig;34;34;0;Stadt Konstanz, Amt fuer Stadtplanung und Umwelt
10.07.2023 18:00;1081;516;565;Sonnig;31;32;0;Stadt Konstanz, Amt fuer Stadtplanung und Umwelt
10.07.2023 19:00;805;396;409;Sonnig;27;28;0;Stadt Konstanz, Amt fuer Stadtplanung und Umwelt
10.07.2023 20:00;651;293;358;Sonnig;22;25;0;Stadt Konstanz, Amt fuer Stadtplanung und Umwelt
10.07.2023 21:00;582;258;324;Sonnig;20;20;0;Stadt Konstanz, Amt fuer Stadtplanung und Umwelt
10.07.2023 22:00;358;160;198;Sonnig;19;19;0;Stadt Konstanz, Amt fuer Stadtplanung und Umwelt
10.07.2023 23:00;192;59;133;Sonnig;19;19;0;Stadt Konstanz, Amt fuer Stadtplanung und Umwelt
11.07.2023 00:00;98;38;60;Stellenweiser Regenfall;18;18;0.1;Stadt Konstanz, Amt fuer Stadtplanung und Umwelt
11.07.2023 01:00;28;8;20;Stellenweiser Regenfall;17;17;0.4;Stadt Konstanz, Amt fuer Stadtplanung und Umwelt
11.07.2023 02:00;14;3;11;Sonnig;16;16;0;Stadt Konstanz, Amt fuer Stadtplanung und Umwelt
11.07.2023 03:00;10;5;5;Sonnig;16;16;0;Stadt Konstanz, Amt fuer Stadtplanung und Umwelt
11.07.2023 04:00;17;7;10;Sonnig;16;16;0;Stadt Konstanz, Amt fuer Stadtplanung und Umwelt
11.07.2023 05:00;66;44;22;Sonnig;16;16;0;Stadt Konstanz, Amt fuer Stadtplanung und Umwelt
11.07.2023 06:00;256;143;113;Sonnig;17;17;0;Stadt Konstanz, Amt fuer Stadtplanung und Umwelt
11.07.2023 07:00;1052;634;418;Leicht bewoelkt;21;21;0;Stadt Konstanz, Amt fuer Stadtplanung und Umwelt
11.07.2023 08:00;1100;602;498;Sonnig;23;25;0;Stadt Konstanz, Amt fuer Stadtplanung und Umwelt
11.07.2023 09:00;913;511;402;Sonnig;25;27;0;Stadt Konstanz, Amt fuer Stadtplanung und Umwelt
11.07.2023 10:00;717;377;340;Sonnig;28;29;0;Stadt Konstanz, Amt fuer Stadtplanung und Umwelt
11.07.2023 11:00;808;368;440;Sonnig;33;36;0;Stadt Konstanz, Amt fuer Stadtplanung und Umwelt
11.07.2023 12:00;956;398;558;Sonnig;34;35;0;Stadt Konstanz, Amt fuer Stadtplanung und Umwelt
11.07.2023 13:00;1103;506;597;Sonnig;37;38;0;Stadt Konstanz, Amt fuer Stadtplanung und Umwelt
11.07.2023 14:00;932;456;476;Sonnig;38;39;0;Stadt Konstanz, Amt fuer Stadtplanung und Umwelt
11.07.2023 15:00;1166;514;652;Sonnig;38;39;0;Stadt Konstanz, Amt fuer Stadtplanung und Umwelt
11.07.2023 16:00;1188;528;660;Sonnig;38;38;0;Stadt Konstanz, Amt fuer Stadtplanung und Umwelt
11.07.2023 17:00;1293;655;638;Sonnig;36;36;0;Stadt Konstanz, Amt fuer Stadtplanung und Umwelt
11.07.2023 18:00;1282;665;617;Sonnig;33;35;0;Stadt Konstanz, Amt fuer Stadtplanung und Umwelt
11.07.2023 19:00;946;471;475;Stellenweise Gewitter und Niederschlaege;26;27;0;Stadt Konstanz, Amt fuer Stadtplanung und Umwelt
11.07.2023 20:00;782;340;442;Teilweise maeßiger Regenfall;18;18;4;Stadt Konstanz, Amt fuer Stadtplanung und Umwelt
11.07.2023 21:00;815;300;515;Leichter Regenfall;18;18;1.1;Stadt Konstanz, Amt fuer Stadtplanung und Umwelt
11.07.2023 22:00;187;84;103;Teilweise maeßiger Regenfall;16;16;4.3;Stadt Konstanz, Amt fuer Stadtplanung und Umwelt
11.07.2023 23:00;136;59;77;Nebel;16;16;0.1;Stadt Konstanz, Amt fuer Stadtplanung und Umwelt
12.07.2023 00:00;89;36;53;Leichter Regenschauer;16;16;0.9;Stadt Konstanz, Amt fuer Stadtplanung und Umwelt
12.07.2023 01:00;48;27;21;Leichter Regenschauer;16;16;0.4;Stadt Konstanz, Amt fuer Stadtplanung und Umwelt
12.07.2023 02:00;20;7;13;Nebel;15;15;0.1;Stadt Konstanz, Amt fuer Stadtplanung und Umwelt
12.07.2023 03:00;6;1;5;Nebel;15;15;0.1;Stadt Konstanz, Amt fuer Stadtplanung und Umwelt
12.07.2023 04:00;21;9;12;Leichter Regenschauer;15;15;1;Stadt Konstanz, Amt fuer Stadtplanung und Umwelt
12.07.2023 05:00;60;41;19;Leichter Regenschauer;16;16;0.4;Stadt Konstanz, Amt fuer Stadtplanung und Umwelt
12.07.2023 06:00;168;97;71;Leichter Regenschauer;17;17;0.5;Stadt Konstanz, Amt fuer Stadtplanung und Umwelt
12.07.2023 07:00;607;335;272;Maeßiger bis starker Regenschauer;18;18;3.8;Stadt Konstanz, Amt fuer Stadtplanung und Umwelt
12.07.2023 08:00;774;419;355;Leichter Regenschauer;20;20;1.9;Stadt Konstanz, Amt fuer Stadtplanung und Umwelt
12.07.2023 09:00;775;447;328;Leichter Regenschauer;22;22;1;Stadt Konstanz, Amt fuer Stadtplanung und Umwelt
12.07.2023 10:00;615;340;275;Leichter Regenschauer;24;26;2.1;Stadt Konstanz, Amt fuer Stadtplanung und Umwelt
12.07.2023 11:00;735;380;355;Leichter Regenschauer;25;27;0.4;Stadt Konstanz, Amt fuer Stadtplanung und Umwelt
12.07.2023 12:00;825;382;443;Nieselregen mit Gewitter;27;28;0.4;Stadt Konstanz, Amt fuer Stadtplanung und Umwelt
12.07.2023 13:00;980;470;510;Leichter Regenschauer;27;28;1.9;Stadt Konstanz, Amt fuer Stadtplanung und Umwelt
12.07.2023 14:00;608;301;307;Stellenweise Gewitter und Niederschlaege;26;27;0.1;Stadt Konstanz, Amt fuer Stadtplanung und Umwelt
12.07.2023 15:00;729;341;388;Stellenweise Gewitter und Niederschlaege;26;27;0.1;Stadt Konstanz, Amt fuer Stadtplanung und Umwelt
12.07.2023 16:00;734;362;372;Nieselregen mit Gewitter;26;27;0.3;Stadt Konstanz, Amt fuer Stadtplanung und Umwelt
12.07.2023 17:00;886;428;458;Stellenweise Gewitter und Niederschlaege;26;27;0.1;Stadt Konstanz, Amt fuer Stadtplanung und Umwelt
12.07.2023 18:00;774;370;404;Stellenweiser Regenfall;26;27;0.1;Stadt Konstanz, Amt fuer Stadtplanung und Umwelt
12.07.2023 19:00;554;265;289;Stellenweiser Regenfall;24;26;0.5;Stadt Konstanz, Amt fuer Stadtplanung und Umwelt
12.07.2023 20:00;359;161;198;Sonnig;19;19;0;Stadt Konstanz, Amt fuer Stadtplanung und Umwelt
12.07.2023 21:00;257;97;160;Stellenweiser Regenfall;17;17;0.1;Stadt Konstanz, Amt fuer Stadtplanung und Umwelt
12.07.2023 22:00;219;89;130;Stellenweiser Regenfall;17;17;0.2;Stadt Konstanz, Amt fuer Stadtplanung und Umwelt
12.07.2023 23:00;155;63;92;Stellenweiser Regenfall;16;16;0.1;Stadt Konstanz, Amt fuer Stadtplanung und Umwelt
13.07.2023 00:00;68;28;40;Leichter Regenschauer;15;16;0.3;Stadt Konstanz, Amt fuer Stadtplanung und Umwelt
13.07.2023 01:00;49;22;27;Leichter Regenschauer;15;15;2;Stadt Konstanz, Amt fuer Stadtplanung und Umwelt
13.07.2023 02:00;13;6;7;Leichter Regenschauer;14;15;0.5;Stadt Konstanz, Amt fuer Stadtplanung und Umwelt
13.07.2023 03:00;9;4;5;Leichter Regenschauer;13;14;0.5;Stadt Konstanz, Amt fuer Stadtplanung und Umwelt
13.07.2023 04:00;13;5;8;Leichter Regenschauer;13;14;1;Stadt Konstanz, Amt fuer Stadtplanung und Umwelt
13.07.2023 05:00;54;40;14;Stellenweiser Regenfall;13;13;0.3;Stadt Konstanz, Amt fuer Stadtplanung und Umwelt
13.07.2023 06:00;203;129;74;Leichter Regenschauer;15;15;0.2;Stadt Konstanz, Amt fuer Stadtplanung und Umwelt
13.07.2023 07:00;911;552;359;Leichter Regenschauer;16;16;1.2;Stadt Konstanz, Amt fuer Stadtplanung und Umwelt
13.07.2023 08:00;750;420;330;Leichter Nebel;16;16;0;Stadt Konstanz, Amt fuer Stadtplanung und Umwelt
13.07.2023 09:00;511;305;206;Stellenweiser Regenfall;19;19;0.1;Stadt Konstanz, Amt fuer Stadtplanung und Umwelt
13.07.2023 10:00;523;292;231;Stellenweiser Regenfall;20;20;0.5;Stadt Konstanz, Amt fuer Stadtplanung und Umwelt
13.07.2023 11:00;704;335;369;Leichter Regenschauer;21;21;0.2;Stadt Konstanz, Amt fuer Stadtplanung und Umwelt
13.07.2023 12:00;816;363;453;Stellenweiser Regenfall;21;21;0.2;Stadt Konstanz, Amt fuer Stadtplanung und Umwelt
13.07.2023 13:00;925;414;511;Stellenweiser Regenfall;22;25;1.2;Stadt Konstanz, Amt fuer Stadtplanung und Umwelt
13.07.2023 14:00;856;447;409;Sonnig;25;25;0;Stadt Konstanz, Amt fuer Stadtplanung und Umwelt
13.07.2023 15:00;1170;615;555;Sonnig;26;26;0;Stadt Konstanz, Amt fuer Stadtplanung und Umwelt
13.07.2023 16:00;1125;561;564;Sonnig;26;26;0;Stadt Konstanz, Amt fuer Stadtplanung und Umwelt
13.07.2023 17:00;1286;644;642;Sonnig;26;26;0;Stadt Konstanz, Amt fuer Stadtplanung und Umwelt
13.07.2023 18:00;1198;573;625;Sonnig;25;26;0;Stadt Konstanz, Amt fuer Stadtplanung und Umwelt
13.07.2023 19:00;891;445;446;Sonnig;21;21;0;Stadt Konstanz, Amt fuer Stadtplanung und Umwelt
13.07.2023 20:00;743;353;390;Sonnig;17;17;0;Stadt Konstanz, Amt fuer Stadtplanung und Umwelt
13.07.2023 21:00;578;238;340;Sonnig;15;16;0;Stadt Konstanz, Amt fuer Stadtplanung und Umwelt
13.07.2023 22:00;524;204;320;Sonnig;14;14;0;Stadt Konstanz, Amt fuer Stadtplanung und Umwelt
13.07.2023 23:00;286;116;170;Sonnig;13;13;0;Stadt Konstanz, Amt fuer Stadtplanung und Umwelt
14.07.2023 00:00;170;58;112;Sonnig;12;12;0;Stadt Konstanz, Amt fuer Stadtplanung und Umwelt
14.07.2023 01:00;80;26;54;Sonnig;12;12;0;Stadt Konstanz, Amt fuer Stadtplanung und Umwelt
14.07.2023 02:00;36;10;26;Sonnig;11;11;0;Stadt Konstanz, Amt fuer Stadtplanung und Umwelt
14.07.2023 03:00;13;4;9;Sonnig;11;11;0;Stadt Konstanz, Amt fuer Stadtplanung und Umwelt
14.07.2023 04:00;24;8;16;Sonnig;11;11;0;Stadt Konstanz, Amt fuer Stadtplanung und Umwelt
14.07.2023 05:00;64;43;21;Sonnig;10;11;0;Stadt Konstanz, Amt fuer Stadtplanung und Umwelt
14.07.2023 06:00;200;120;80;Sonnig;12;12;0;Stadt Konstanz, Amt fuer Stadtplanung und Umwelt
14.07.2023 07:00;898;516;382;Sonnig;16;16;0;Stadt Konstanz, Amt fuer Stadtplanung und Umwelt
14.07.2023 08:00;910;513;397;Sonnig;19;19;0;Stadt Konstanz, Amt fuer Stadtplanung und Umwelt
14.07.2023 09:00;913;540;373;Leicht bewoelkt;21;21;0;Stadt Konstanz, Amt fuer Stadtplanung und Umwelt
14.07.2023 10:00;834;448;386;Sonnig;23;25;0;Stadt Konstanz, Amt fuer Stadtplanung und Umwelt
14.07.2023 11:00;923;489;434;Leicht bewoelkt;26;26;0;Stadt Konstanz, Amt fuer Stadtplanung und Umwelt
14.07.2023 12:00;1129;488;641;Sonnig;30;30;0;Stadt Konstanz, Amt fuer Stadtplanung und Umwelt
14.07.2023 13:00;1279;543;736;Sonnig;32;31;0;Stadt Konstanz, Amt fuer Stadtplanung und Umwelt
14.07.2023 14:00;1009;516;493;Sonnig;32;32;0;Stadt Konstanz, Amt fuer Stadtplanung und Umwelt
14.07.2023 15:00;1052;526;526;Sonnig;32;32;0;Stadt Konstanz, Amt fuer Stadtplanung und Umwelt
14.07.2023 16:00;1066;519;547;Sonnig;32;31;0;Stadt Konstanz, Amt fuer Stadtplanung und Umwelt
14.07.2023 17:00;1166;570;596;Sonnig;30;29;0;Stadt Konstanz, Amt fuer Stadtplanung und Umwelt
14.07.2023 18:00;1105;538;567;Sonnig;29;29;0;Stadt Konstanz, Amt fuer Stadtplanung und Umwelt
14.07.2023 19:00;831;406;425;Sonnig;26;27;0;Stadt Konstanz, Amt fuer Stadtplanung und Umwelt
14.07.2023 20:00;689;374;315;Sonnig;19;19;0;Stadt Konstanz, Amt fuer Stadtplanung und Umwelt
14.07.2023 21:00;699;299;400;Sonnig;18;18;0;Stadt Konstanz, Amt fuer Stadtplanung und Umwelt
14.07.2023 22:00;510;201;309;Sonnig;17;17;0;Stadt Konstanz, Amt fuer Stadtplanung und Umwelt
14.07.2023 23:00;410;128;282;Sonnig;16;16;0;Stadt Konstanz, Amt fuer Stadtplanung und Umwelt
15.07.2023 00:00;258;74;184;Sonnig;15;15;0;Stadt Konstanz, Amt fuer Stadtplanung und Umwelt
15.07.2023 01:00;185;50;135;Sonnig;15;15;0;Stadt Konstanz, Amt fuer Stadtplanung und Umwelt
15.07.2023 02:00;99;34;65;Sonnig;14;14;0;Stadt Konstanz, Amt fuer Stadtplanung und Umwelt
15.07.2023 03:00;65;19;46;Sonnig;14;14;0;Stadt Konstanz, Amt fuer Stadtplanung und Umwelt
15.07.2023 04:00;39;18;21;Sonnig;14;14;0;Stadt Konstanz, Amt fuer Stadtplanung und Umwelt
15.07.2023 05:00;49;34;15;Sonnig;14;14;0;Stadt Konstanz, Amt fuer Stadtplanung und Umwelt
15.07.2023 06:00;65;38;27;Sonnig;16;16;0;Stadt Konstanz, Amt fuer Stadtplanung und Umwelt
15.07.2023 07:00;139;82;57;Sonnig;19;19;0;Stadt Konstanz, Amt fuer Stadtplanung und Umwelt
15.07.2023 08:00;373;176;197;Sonnig;23;25;0;Stadt Konstanz, Amt fuer Stadtplanung und Umwelt
15.07.2023 09:00;638;379;259;Sonnig;26;26;0;Stadt Konstanz, Amt fuer Stadtplanung und Umwelt
15.07.2023 10:00;708;415;293;Sonnig;28;28;0;Stadt Konstanz, Amt fuer Stadtplanung und Umwelt
15.07.2023 11:00;784;420;364;Sonnig;34;35;0;Stadt Konstanz, Amt fuer Stadtplanung und Umwelt
15.07.2023 12:00;774;397;377;Sonnig;36;37;0;Stadt Konstanz, Amt fuer Stadtplanung und Umwelt
15.07.2023 13:00;807;398;409;Sonnig;38;38;0;Stadt Konstanz, Amt fuer Stadtplanung und Umwelt
15.07.2023 14:00;876;418;458;Sonnig;39;39;0;Stadt Konstanz, Amt fuer Stadtplanung und Umwelt
15.07.2023 15:00;734;352;382;Sonnig;39;38;0;Stadt Konstanz, Amt fuer Stadtplanung und Umwelt
15.07.2023 16:00;804;387;417;Sonnig;37;37;0;Stadt Konstanz, Amt fuer Stadtplanung und Umwelt
15.07.2023 17:00;868;420;448;Sonnig;32;32;0;Stadt Konstanz, Amt fuer Stadtplanung und Umwelt
15.07.2023 18:00;790;405;385;Sonnig;29;30;0;Stadt Konstanz, Amt fuer Stadtplanung und Umwelt
15.07.2023 19:00;693;375;318;Leicht bewoelkt;26;27;0;Stadt Konstanz, Amt fuer Stadtplanung und Umwelt
15.07.2023 20:00;639;309;330;Stellenweiser Regenfall;23;25;0.2;Stadt Konstanz, Amt fuer Stadtplanung und Umwelt
15.07.2023 21:00;491;234;257;Stellenweiser Regenfall;20;20;0.1;Stadt Konstanz, Amt fuer Stadtplanung und Umwelt
15.07.2023 22:00;428;160;268;Stellenweiser Regenfall;19;19;0.6;Stadt Konstanz, Amt fuer Stadtplanung und Umwelt
15.07.2023 23:00;391;88;303;Leichter Nebel;18;18;0;Stadt Konstanz, Amt fuer Stadtplanung und Umwelt
16.07.2023 00:00;234;73;161;Stellenweiser Regenfall;17;17;0.2;Stadt Konstanz, Amt fuer Stadtplanung und Umwelt
16.07.2023 01:00;170;59;111;Nebel;17;17;0;Stadt Konstanz, Amt fuer Stadtplanung und Umwelt
16.07.2023 02:00;98;40;58;Leichter Regenschauer;17;17;0.3;Stadt Konstanz, Amt fuer Stadtplanung und Umwelt
16.07.2023 03:00;61;23;38;Nebel;17;17;0;Stadt Konstanz, Amt fuer Stadtplanung und Umwelt
16.07.2023 04:00;39;11;28;Leichter Regenschauer;17;17;0.9;Stadt Konstanz, Amt fuer Stadtplanung und Umwelt
16.07.2023 05:00;24;15;9;Nebel;17;17;0;Stadt Konstanz, Amt fuer Stadtplanung und Umwelt
16.07.2023 06:00;18;13;5;Leichter Regenschauer;17;17;0.3;Stadt Konstanz, Amt fuer Stadtplanung und Umwelt
16.07.2023 07:00;48;16;32;Nebel;17;17;0;Stadt Konstanz, Amt fuer Stadtplanung und Umwelt
16.07.2023 08:00;147;55;92;Leichter Regenschauer;18;18;0.3;Stadt Konstanz, Amt fuer Stadtplanung und Umwelt
16.07.2023 09:00;280;146;134;Stellenweiser Regenfall;18;18;0.1;Stadt Konstanz, Amt fuer Stadtplanung und Umwelt
16.07.2023 10:00;445;251;194;Leichter Regenschauer;19;19;0.8;Stadt Konstanz, Amt fuer Stadtplanung und Umwelt
16.07.2023 11:00;533;266;267;Stellenweiser Regenfall;21;21;0.1;Stadt Konstanz, Amt fuer Stadtplanung und Umwelt
16.07.2023 12:00;477;248;229;Leichter Regenschauer;23;25;0.3;Stadt Konstanz, Amt fuer Stadtplanung und Umwelt
16.07.2023 13:00;586;293;293;Bewoelkt;24;25;0;Stadt Konstanz, Amt fuer Stadtplanung und Umwelt
16.07.2023 14:00;588;330;258;Bewoelkt;25;26;0;Stadt Konstanz, Amt fuer Stadtplanung und Umwelt
16.07.2023 15:00;677;363;314;Leicht bewoelkt;27;28;0;Stadt Konstanz, Amt fuer Stadtplanung und Umwelt
16.07.2023 16:00;640;284;356;Bewoelkt;27;28;0;Stadt Konstanz, Amt fuer Stadtplanung und Umwelt
16.07.2023 17:00;653;346;307;Stellenweise Gewitter und Niederschlaege;27;27;0;Stadt Konstanz, Amt fuer Stadtplanung und Umwelt
16.07.2023 18:00;775;358;417;Leicht bewoelkt;26;27;0;Stadt Konstanz, Amt fuer Stadtplanung und Umwelt
16.07.2023 19:00;548;269;279;Leicht bewoelkt;24;26;0;Stadt Konstanz, Amt fuer Stadtplanung und Umwelt
16.07.2023 20:00;466;209;257;Leicht bewoelkt;19;19;0;Stadt Konstanz, Amt fuer Stadtplanung und Umwelt
16.07.2023 21:00;307;135;172;Leicht bewoelkt;18;18;0;Stadt Konstanz, Amt fuer Stadtplanung und Umwelt
16.07.2023 22:00;199;78;121;Stellenweiser Regenfall;17;17;0.7;Stadt Konstanz, Amt fuer Stadtplanung und Umwelt
16.07.2023 23:00;91;36;55;Leichter Nebel;16;16;0;Stadt Konstanz, Amt fuer Stadtplanung und Umwelt
17.07.2023 00:00;59;28;31;Stellenweiser Regenfall;15;15;0.1;Stadt Konstanz, Amt fuer Stadtplanung und Umwelt
17.07.2023 01:00;23;8;15;Stellenweiser Regenfall;15;16;0.1;Stadt Konstanz, Amt fuer Stadtplanung und Umwelt
17.07.2023 02:00;15;8;7;Leichter Nebel;15;15;0.1;Stadt Konstanz, Amt fuer Stadtplanung und Umwelt
17.07.2023 03:00;4;2;2;Leichter Nebel;14;15;0;Stadt Konstanz, Amt fuer Stadtplanung und Umwelt
17.07.2023 04:00;18;10;8;Stellenweiser Regenfall;14;15;0.4;Stadt Konstanz, Amt fuer Stadtplanung und Umwelt
17.07.2023 05:00;52;38;14;Nebel;14;14;0.1;Stadt Konstanz, Amt fuer Stadtplanung und Umwelt
17.07.2023 06:00;224;127;97;Leichter Nebel;15;15;0.1;Stadt Konstanz, Amt fuer Stadtplanung und Umwelt
17.07.2023 07:00;925;559;366;Leichter Regenschauer;18;18;0.6;Stadt Konstanz, Amt fuer Stadtplanung und Umwelt
17.07.2023 08:00;893;534;359;Leicht bewoelkt;20;20;0;Stadt Konstanz, Amt fuer Stadtplanung und Umwelt
17.07.2023 09:00;784;445;339;Leicht bewoelkt;22;25;0;Stadt Konstanz, Amt fuer Stadtplanung und Umwelt
17.07.2023 10:00;651;362;289;Sonnig;24;26;0;Stadt Konstanz, Amt fuer Stadtplanung und Umwelt
17.07.2023 11:00;765;387;378;Leicht bewoelkt;27;28;0;Stadt Konstanz, Amt fuer Stadtplanung und Umwelt
17.07.2023 12:00;946;445;501;Leicht bewoelkt;28;28;0;Stadt Konstanz, Amt fuer Stadtplanung und Umwelt
17.07.2023 13:00;1108;475;633;Leicht bewoelkt;29;29;0;Stadt Konstanz, Amt fuer Stadtplanung und Umwelt
17.07.2023 14:00;930;454;476;Leicht bewoelkt;29;30;0;Stadt Konstanz, Amt fuer Stadtplanung und Umwelt
17.07.2023 15:00;1218;602;616;Sonnig;30;29;0;Stadt Konstanz, Amt fuer Stadtplanung und Umwelt
17.07.2023 16:00;1258;612;646;Sonnig;29;29;0;Stadt Konstanz, Amt fuer Stadtplanung und Umwelt
17.07.2023 17:00;1419;683;736;Sonnig;28;28;0;Stadt Konstanz, Amt fuer Stadtplanung und Umwelt
17.07.2023 18:00;1195;618;577;Sonnig;26;27;0;Stadt Konstanz, Amt fuer Stadtplanung und Umwelt
17.07.2023 19:00;932;384;548;Stellenweiser Regenfall;21;21;0.4;Stadt Konstanz, Amt fuer Stadtplanung und Umwelt
17.07.2023 20:00;653;292;361;Stellenweiser Regenfall;18;18;0.1;Stadt Konstanz, Amt fuer Stadtplanung und Umwelt
17.07.2023 21:00;546;212;334;Stellenweiser Regenfall;18;18;0.1;Stadt Konstanz, Amt fuer Stadtplanung und Umwelt
17.07.2023 22:00;344;110;234;Stellenweiser Regenfall;18;18;0.2;Stadt Konstanz, Amt fuer Stadtplanung und Umwelt
17.07.2023 23:00;197;91;106;Sonnig;17;17;0;Stadt Konstanz, Amt fuer Stadtplanung und Umwelt
18.07.2023 00:00;54;17;37;Sonnig;15;15;0;Stadt Konstanz, Amt fuer Stadtplanung und Umwelt
18.07.2023 01:00;33;12;21;Stellenweiser Regenfall;14;15;0.1;Stadt Konstanz, Amt fuer Stadtplanung und Umwelt
18.07.2023 02:00;15;5;10;Sonnig;14;14;0;Stadt Konstanz, Amt fuer Stadtplanung und Umwelt
18.07.2023 03:00;9;4;5;Sonnig;13;13;0;Stadt Konstanz, Amt fuer Stadtplanung und Umwelt
18.07.2023 04:00;13;11;2;Sonnig;13;13;0;Stadt Konstanz, Amt fuer Stadtplanung und Umwelt
18.07.2023 05:00;72;52;20;Sonnig;12;12;0;Stadt Konstanz, Amt fuer Stadtplanung und Umwelt
18.07.2023 06:00;240;141;99;Sonnig;14;14;0;Stadt Konstanz, Amt fuer Stadtplanung und Umwelt
18.07.2023 07:00;1036;638;398;Sonnig;17;17;0;Stadt Konstanz, Amt fuer Stadtplanung und Umwelt
18.07.2023 08:00;1046;618;428;Sonnig;20;20;0;Stadt Konstanz, Amt fuer Stadtplanung und Umwelt
18.07.2023 09:00;887;498;389;Sonnig;22;25;0;Stadt Konstanz, Amt fuer Stadtplanung und Umwelt
18.07.2023 10:00;758;416;342;Sonnig;25;26;0;Stadt Konstanz, Amt fuer Stadtplanung und Umwelt
18.07.2023 11:00;850;401;449;Sonnig;30;31;0;Stadt Konstanz, Amt fuer Stadtplanung und Umwelt
18.07.2023 12:00;988;406;582;Sonnig;32;34;0;Stadt Konstanz, Amt fuer Stadtplanung und Umwelt
18.07.2023 13:00;978;409;569;Sonnig;32;32;0;Stadt Konstanz, Amt fuer Stadtplanung und Umwelt
18.07.2023 14:00;697;335;362;Sonnig;35;36;0;Stadt Konstanz, Amt fuer Stadtplanung und Umwelt
18.07.2023 15:00;1041;529;512;Stellenweiser Regenfall;34;35;0.1;Stadt Konstanz, Amt fuer Stadtplanung und Umwelt
18.07.2023 16:00;1108;543;565;Nieselregen mit Gewitter;31;32;0.4;Stadt Konstanz, Amt fuer Stadtplanung und Umwelt
18.07.2023 17:00;1201;584;617;Stellenweise Gewitter und Niederschlaege;30;31;0.1;Stadt Konstanz, Amt fuer Stadtplanung und Umwelt
18.07.2023 18:00;1105;529;576;Stellenweise Gewitter und Niederschlaege;28;30;0.1;Stadt Konstanz, Amt fuer Stadtplanung und Umwelt
18.07.2023 19:00;867;422;445;Nieselregen mit Gewitter;24;26;1;Stadt Konstanz, Amt fuer Stadtplanung und Umwelt
18.07.2023 20:00;690;351;339;Nieselregen mit Gewitter;19;19;1.5;Stadt Konstanz, Amt fuer Stadtplanung und Umwelt
18.07.2023 21:00;546;214;332;Nieselregen mit Gewitter;18;18;1.3;Stadt Konstanz, Amt fuer Stadtplanung und Umwelt
18.07.2023 22:00;403;153;250;Maeßiger bis starker Regenschauer;18;18;6.5;Stadt Konstanz, Amt fuer Stadtplanung und Umwelt
18.07.2023 23:00;194;45;149;Leichter Regenschauer;18;18;1.3;Stadt Konstanz, Amt fuer Stadtplanung und Umwelt
19.07.2023 00:00;97;36;61;Nieselregen mit Gewitter;16;16;0.7;Stadt Konstanz, Amt fuer Stadtplanung und Umwelt
19.07.2023 01:00;54;19;35;Maeßiger bis starker Regenschauer;15;15;2.5;Stadt Konstanz, Amt fuer Stadtplanung und Umwelt
19.07.2023 02:00;24;7;17;Leichter Regenschauer;15;15;0.2;Stadt Konstanz, Amt fuer Stadtplanung und Umwelt
19.07.2023 03:00;17;9;8;Nebel;15;15;0.1;Stadt Konstanz, Amt fuer Stadtplanung und Umwelt
19.07.2023 04:00;27;10;17;Leichter Regenschauer;15;15;0.3;Stadt Konstanz, Amt fuer Stadtplanung und Umwelt
19.07.2023 05:00;56;44;12;Nebel;15;16;0.1;Stadt Konstanz, Amt fuer Stadtplanung und Umwelt
19.07.2023 06:00;209;121;88;Nebel;16;16;0.1;Stadt Konstanz, Amt fuer Stadtplanung und Umwelt
19.07.2023 07:00;1025;613;412;Leichter Nebel;18;18;0.1;Stadt Konstanz, Amt fuer Stadtplanung und Umwelt
19.07.2023 08:00;969;530;439;Stellenweiser Regenfall;21;21;0.1;Stadt Konstanz, Amt fuer Stadtplanung und Umwelt
19.07.2023 09:00;901;471;430;Stellenweiser Regenfall;23;25;0.1;Stadt Konstanz, Amt fuer Stadtplanung und Umwelt
19.07.2023 10:00;666;352;314;Stellenweiser Regenfall;25;26;0.4;Stadt Konstanz, Amt fuer Stadtplanung und Umwelt
19.07.2023 11:00;820;413;407;Stellenweiser Regenfall;28;28;0.1;Stadt Konstanz, Amt fuer Stadtplanung und Umwelt
19.07.2023 12:00;1097;471;626;Stellenweiser Regenfall;31;31;0.1;Stadt Konstanz, Amt fuer Stadtplanung und Umwelt
19.07.2023 13:00;1143;557;586;Teilweise maeßiger Regenfall;31;31;0.5;Stadt Konstanz, Amt fuer Stadtplanung und Umwelt
19.07.2023 14:00;945;456;489;Sonnig;31;30;0;Stadt Konstanz, Amt fuer Stadtplanung und Umwelt
19.07.2023 15:00;1058;539;519;Sonnig;31;30;0;Stadt Konstanz, Amt fuer Stadtplanung und Umwelt
19.07.2023 16:00;1244;596;648;Sonnig;30;29;0;Stadt Konstanz, Amt fuer Stadtplanung und Umwelt
19.07.2023 17:00;1332;645;687;Sonnig;29;28;0;Stadt Konstanz, Amt fuer Stadtplanung und Umwelt
19.07.2023 18:00;1260;600;660;Sonnig;27;27;0;Stadt Konstanz, Amt fuer Stadtplanung und Umwelt
19.07.2023 19:00;932;499;433;Sonnig;23;25;0;Stadt Konstanz, Amt fuer Stadtplanung und Umwelt
19.07.2023 20:00;746;392;354;Sonnig;18;18;0;Stadt Konstanz, Amt fuer Stadtplanung und Umwelt
19.07.2023 21:00;562;254;308;Sonnig;17;17;0;Stadt Konstanz, Amt fuer Stadtplanung und Umwelt
19.07.2023 22:00;476;167;309;Sonnig;15;15;0;Stadt Konstanz, Amt fuer Stadtplanung und Umwelt
19.07.2023 23:00;321;89;232;Sonnig;15;15;0;Stadt Konstanz, Amt fuer Stadtplanung und Umwelt
20.07.2023 00:00;144;46;98;Leicht bewoelkt;14;15;0;Stadt Konstanz, Amt fuer Stadtplanung und Umwelt
20.07.2023 01:00;58;19;39;Sonnig;14;14;0;Stadt Konstanz, Amt fuer Stadtplanung und Umwelt
20.07.2023 02:00;26;10;16;Leicht bewoelkt;13;14;0;Stadt Konstanz, Amt fuer Stadtplanung und Umwelt
20.07.2023 03:00;9;4;5;Leicht bewoelkt;13;13;0;Stadt Konstanz, Amt fuer Stadtplanung und Umwelt
20.07.2023 04:00;21;6;15;Leicht bewoelkt;12;12;0;Stadt Konstanz, Amt fuer Stadtplanung und Umwelt
20.07.2023 05:00;60;41;19;Bedeckt;12;12;0;Stadt Konstanz, Amt fuer Stadtplanung und Umwelt
20.07.2023 06:00;221;123;98;Bewoelkt;15;15;0;Stadt Konstanz, Amt fuer Stadtplanung und Umwelt
20.07.2023 07:00;1001;588;413;Bewoelkt;17;17;0;Stadt Konstanz, Amt fuer Stadtplanung und Umwelt
20.07.2023 08:00;967;527;440;Bewoelkt;17;17;0;Stadt Konstanz, Amt fuer Stadtplanung und Umwelt
20.07.2023 09:00;840;462;378;Leicht bewoelkt;20;20;0;Stadt Konstanz, Amt fuer Stadtplanung und Umwelt
20.07.2023 10:00;715;366;349;Sonnig;23;25;0;Stadt Konstanz, Amt fuer Stadtplanung und Umwelt
20.07.2023 11:00;816;386;430;Sonnig;26;26;0;Stadt Konstanz, Amt fuer Stadtplanung und Umwelt
20.07.2023 12:00;972;419;553;Sonnig;27;27;0;Stadt Konstanz, Amt fuer Stadtplanung und Umwelt
20.07.2023 13:00;1150;487;663;Sonnig;28;27;0;Stadt Konstanz, Amt fuer Stadtplanung und Umwelt
20.07.2023 14:00;980;499;481;Sonnig;30;30;0;Stadt Konstanz, Amt fuer Stadtplanung und Umwelt
20.07.2023 15:00;1218;644;574;Sonnig;31;30;0;Stadt Konstanz, Amt fuer Stadtplanung und Umwelt
20.07.2023 16:00;1174;564;610;Sonnig;28;27;0;Stadt Konstanz, Amt fuer Stadtplanung und Umwelt
20.07.2023 17:00;1334;674;660;Sonnig;27;27;0;Stadt Konstanz, Amt fuer Stadtplanung und Umwelt
20.07.2023 18:00;1249;569;680;Sonnig;26;26;0;Stadt Konstanz, Amt fuer Stadtplanung und Umwelt
20.07.2023 19:00;936;466;470;Leicht bewoelkt;22;25;0;Stadt Konstanz, Amt fuer Stadtplanung und Umwelt
20.07.2023 20:00;703;345;358;Leicht bewoelkt;18;18;0;Stadt Konstanz, Amt fuer Stadtplanung und Umwelt
20.07.2023 21:00;571;217;354;Stellenweiser Regenfall;17;17;0.1;Stadt Konstanz, Amt fuer Stadtplanung und Umwelt
20.07.2023 22:00;498;168;330;Stellenweiser Regenfall;15;15;0.2;Stadt Konstanz, Amt fuer Stadtplanung und Umwelt
20.07.2023 23:00;360;109;251;Stellenweiser Regenfall;14;15;0.1;Stadt Konstanz, Amt fuer Stadtplanung und Umwelt
21.07.2023 00:00;183;48;135;Sonnig;15;15;0;Stadt Konstanz, Amt fuer Stadtplanung und Umwelt
21.07.2023 01:00;72;12;60;Stellenweiser Regenfall;14;15;0.1;Stadt Konstanz, Amt fuer Stadtplanung und Umwelt
21.07.2023 02:00;40;16;24;Stellenweiser Regenfall;13;13;0.1;Stadt Konstanz, Amt fuer Stadtplanung und Umwelt
21.07.2023 03:00;14;5;9;Stellenweiser Regenfall;12;12;0.1;Stadt Konstanz, Amt fuer Stadtplanung und Umwelt
21.07.2023 04:00;15;8;7;Leichter Regenschauer;11;11;0.4;Stadt Konstanz, Amt fuer Stadtplanung und Umwelt
21.07.2023 05:00;51;38;13;Stellenweiser Regenfall;12;12;0.1;Stadt Konstanz, Amt fuer Stadtplanung und Umwelt
21.07.2023 06:00;182;100;82;Stellenweiser Regenfall;13;13;0.1;Stadt Konstanz, Amt fuer Stadtplanung und Umwelt
21.07.2023 07:00;857;568;289;Stellenweiser Regenfall;15;15;0.5;Stadt Konstanz, Amt fuer Stadtplanung und Umwelt
21.07.2023 08:00;872;495;377;Sonnig;17;17;0;Stadt Konstanz, Amt fuer Stadtplanung und Umwelt
21.07.2023 09:00;786;486;300;Sonnig;20;20;0;Stadt Konstanz, Amt fuer Stadtplanung und Umwelt
21.07.2023 10:00;745;397;348;Leicht bewoelkt;22;24;0;Stadt Konstanz, Amt fuer Stadtplanung und Umwelt
21.07.2023 11:00;897;454;443;Bewoelkt;22;22;0;Stadt Konstanz, Amt fuer Stadtplanung und Umwelt
21.07.2023 12:00;1034;449;585;Stellenweise Gewitter und Niederschlaege;23;25;0;Stadt Konstanz, Amt fuer Stadtplanung und Umwelt
21.07.2023 13:00;1058;468;590;Leichter Regenschauer;25;26;0.2;Stadt Konstanz, Amt fuer Stadtplanung und Umwelt
21.07.2023 14:00;964;472;492;Leichter Regenschauer;17;17;1.8;Stadt Konstanz, Amt fuer Stadtplanung und Umwelt
21.07.2023 15:00;988;491;497;Leichter Regenschauer;21;21;1.1;Stadt Konstanz, Amt fuer Stadtplanung und Umwelt
21.07.2023 16:00;804;357;447;Maeßiger bis starker Regenschauer;23;25;2.9;Stadt Konstanz, Amt fuer Stadtplanung und Umwelt
21.07.2023 17:00;802;368;434;Stellenweiser Regenfall;22;25;0.8;Stadt Konstanz, Amt fuer Stadtplanung und Umwelt
21.07.2023 18:00;866;434;432;Stellenweiser Regenfall;21;21;0.7;Stadt Konstanz, Amt fuer Stadtplanung und Umwelt
21.07.2023 19:00;640;343;297;Maeßiger bis starker Regenschauer;18;18;3.7;Stadt Konstanz, Amt fuer Stadtplanung und Umwelt
21.07.2023 20:00;523;274;249;Stellenweiser Regenfall;16;16;0.6;Stadt Konstanz, Amt fuer Stadtplanung und Umwelt
21.07.2023 21:00;452;233;219;Stellenweiser Regenfall;13;13;0.4;Stadt Konstanz, Amt fuer Stadtplanung und Umwelt
21.07.2023 22:00;377;126;251;Leichter Regenschauer;13;14;1.1;Stadt Konstanz, Amt fuer Stadtplanung und Umwelt
21.07.2023 23:00;335;102;233;Leichter Regenschauer;13;13;0.3;Stadt Konstanz, Amt fuer Stadtplanung und Umwelt
22.07.2023 00:00;210;51;159;Leichter Regenschauer;13;13;0.3;Stadt Konstanz, Amt fuer Stadtplanung und Umwelt
22.07.2023 01:00;168;59;109;Leichter Regenschauer;13;13;1.3;Stadt Konstanz, Amt fuer Stadtplanung und Umwelt
22.07.2023 02:00;100;35;65;Leicht bewoelkt;13;13;0;Stadt Konstanz, Amt fuer Stadtplanung und Umwelt
22.07.2023 03:00;65;23;42;Bewoelkt;13;13;0;Stadt Konstanz, Amt fuer Stadtplanung und Umwelt
22.07.2023 04:00;50;34;16;Leicht bewoelkt;13;13;0;Stadt Konstanz, Amt fuer Stadtplanung und Umwelt
22.07.2023 05:00;52;29;23;Bewoelkt;12;12;0;Stadt Konstanz, Amt fuer Stadtplanung und Umwelt
22.07.2023 06:00;48;23;25;Bewoelkt;13;13;0;Stadt Konstanz, Amt fuer Stadtplanung und Umwelt
22.07.2023 07:00;123;67;56;Bewoelkt;15;15;0;Stadt Konstanz, Amt fuer Stadtplanung und Umwelt
22.07.2023 08:00;259;139;120;Leicht bewoelkt;16;16;0;Stadt Konstanz, Amt fuer Stadtplanung und Umwelt
22.07.2023 09:00;536;297;239;Stellenweiser Regenfall;19;19;0.1;Stadt Konstanz, Amt fuer Stadtplanung und Umwelt
22.07.2023 10:00;787;477;310;Stellenweiser Regenfall;21;21;0.5;Stadt Konstanz, Amt fuer Stadtplanung und Umwelt
22.07.2023 11:00;816;442;374;Stellenweiser Regenfall;23;25;0.1;Stadt Konstanz, Amt fuer Stadtplanung und Umwelt
22.07.2023 12:00;857;461;396;Stellenweiser Regenfall;24;25;0.1;Stadt Konstanz, Amt fuer Stadtplanung und Umwelt
22.07.2023 13:00;958;463;495;Stellenweiser Regenfall;25;25;0.5;Stadt Konstanz, Amt fuer Stadtplanung und Umwelt
22.07.2023 14:00;1046;496;550;Bewoelkt;25;25;0;Stadt Konstanz, Amt fuer Stadtplanung und Umwelt
22.07.2023 15:00;957;462;495;Leicht bewoelkt;25;25;0;Stadt Konstanz, Amt fuer Stadtplanung und Umwelt
22.07.2023 16:00;1033;489;544;Leicht bewoelkt;25;25;0;Stadt Konstanz, Amt fuer Stadtplanung und Umwelt
22.07.2023 17:00;997;426;571;Sonnig;25;25;0;Stadt Konstanz, Amt fuer Stadtplanung und Umwelt
22.07.2023 18:00;874;377;497;Sonnig;23;25;0;Stadt Konstanz, Amt fuer Stadtplanung und Umwelt
22.07.2023 19:00;657;334;323;Sonnig;20;20;0;Stadt Konstanz, Amt fuer Stadtplanung und Umwelt
22.07.2023 20:00;584;315;269;Leicht bewoelkt;16;16;0;Stadt Konstanz, Amt fuer Stadtplanung und Umwelt
22.07.2023 21:00;492;247;245;Leicht bewoelkt;14;14;0;Stadt Konstanz, Amt fuer Stadtplanung und Umwelt
22.07.2023 22:00;390;185;205;Leicht bewoelkt;13;13;0;Stadt Konstanz, Amt fuer Stadtplanung und Umwelt
22.07.2023 23:00;325;112;213;Leicht bewoelkt;13;13;0;Stadt Konstanz, Amt fuer Stadtplanung und Umwelt
23.07.2023 00:00;179;63;116;Sonnig;13;13;0;Stadt Konstanz, Amt fuer Stadtplanung und Umwelt
23.07.2023 01:00;175;57;118;Sonnig;13;13;0;Stadt Konstanz, Amt fuer Stadtplanung und Umwelt
23.07.2023 02:00;102;26;76;Sonnig;12;12;0;Stadt Konstanz, Amt fuer Stadtplanung und Umwelt
23.07.2023 03:00;74;29;45;Sonnig;12;12;0;Stadt Konstanz, Amt fuer Stadtplanung und Umwelt
23.07.2023 04:00;47;29;18;Sonnig;11;11;0;Stadt Konstanz, Amt fuer Stadtplanung und Umwelt
23.07.2023 05:00;36;20;16;Sonnig;11;11;0;Stadt Konstanz, Amt fuer Stadtplanung und Umwelt
23.07.2023 06:00;48;30;18;Sonnig;13;13;0;Stadt Konstanz, Amt fuer Stadtplanung und Umwelt
23.07.2023 07:00;71;34;37;Sonnig;16;16;0;Stadt Konstanz, Amt fuer Stadtplanung und Umwelt
23.07.2023 08:00;156;93;63;Sonnig;18;18;0;Stadt Konstanz, Amt fuer Stadtplanung und Umwelt
23.07.2023 09:00;319;152;167;Leicht bewoelkt;21;21;0;Stadt Konstanz, Amt fuer Stadtplanung und Umwelt
23.07.2023 10:00;454;199;255;Leicht bewoelkt;22;22;0;Stadt Konstanz, Amt fuer Stadtplanung und Umwelt
23.07.2023 11:00;515;248;267;Bewoelkt;23;24;0;Stadt Konstanz, Amt fuer Stadtplanung und Umwelt
23.07.2023 12:00;527;264;263;Leicht bewoelkt;25;25;0;Stadt Konstanz, Amt fuer Stadtplanung und Umwelt
23.07.2023 13:00;610;308;302;Bedeckt;26;26;0;Stadt Konstanz, Amt fuer Stadtplanung und Umwelt
23.07.2023 14:00;623;329;294;Leicht bewoelkt;29;28;0;Stadt Konstanz, Amt fuer Stadtplanung und Umwelt
23.07.2023 15:00;674;350;324;Sonnig;31;30;0;Stadt Konstanz, Amt fuer Stadtplanung und Umwelt
23.07.2023 16:00;634;327;307;Sonnig;31;30;0;Stadt Konstanz, Amt fuer Stadtplanung und Umwelt
23.07.2023 17:00;721;375;346;Sonnig;30;29;0;Stadt Konstanz, Amt fuer Stadtplanung und Umwelt
23.07.2023 18:00;634;325;309;Sonnig;27;27;0;Stadt Konstanz, Amt fuer Stadtplanung und Umwelt
23.07.2023 19:00;505;245;260;Sonnig;23;25;0;Stadt Konstanz, Amt fuer Stadtplanung und Umwelt
23.07.2023 20:00;460;194;266;Sonnig;18;18;0;Stadt Konstanz, Amt fuer Stadtplanung und Umwelt
23.07.2023 21:00;305;136;169;Sonnig;16;16;0;Stadt Konstanz, Amt fuer Stadtplanung und Umwelt
23.07.2023 22:00;246;96;150;Sonnig;15;15;0;Stadt Konstanz, Amt fuer Stadtplanung und Umwelt
23.07.2023 23:00;148;69;79;Leicht bewoelkt;14;14;0;Stadt Konstanz, Amt fuer Stadtplanung und Umwelt
24.07.2023 00:00;73;31;42;Stellenweiser Regenfall;14;14;0.1;Stadt Konstanz, Amt fuer Stadtplanung und Umwelt
24.07.2023 01:00;28;8;20;Leichter Regenschauer;14;14;0.8;Stadt Konstanz, Amt fuer Stadtplanung und Umwelt
24.07.2023 02:00;16;4;12;Sonnig;14;14;0;Stadt Konstanz, Amt fuer Stadtplanung und Umwelt
24.07.2023 03:00;12;4;8;Bewoelkt;13;14;0;Stadt Konstanz, Amt fuer Stadtplanung und Umwelt
24.07.2023 04:00;17;7;10;Stellenweiser Nieselregen;13;13;0.5;Stadt Konstanz, Amt fuer Stadtplanung und Umwelt
24.07.2023 05:00;51;37;14;Stellenweiser Nieselregen;14;13;0.5;Stadt Konstanz, Amt fuer Stadtplanung und Umwelt
24.07.2023 06:00;208;117;91;Leichter Regenfall;14;14;1;Stadt Konstanz, Amt fuer Stadtplanung und Umwelt
24.07.2023 07:00;444;264;180;Maeßiger Regenfall;15;14;7.2;Stadt Konstanz, Amt fuer Stadtplanung und Umwelt
24.07.2023 08:00;589;309;280;Teilweise maeßiger Regenfall;16;16;3.7;Stadt Konstanz, Amt fuer Stadtplanung und Umwelt
24.07.2023 09:00;533;311;222;Maeßiger Regenfall;16;16;4;Stadt Konstanz, Amt fuer Stadtplanung und Umwelt
24.07.2023 10:00;430;205;225;Starker Regenfall;16;16;9;Stadt Konstanz, Amt fuer Stadtplanung und Umwelt
24.07.2023 11:00;529;239;290;Stellenweiser leichter Regenfall;19;19;2.2;Stadt Konstanz, Amt fuer Stadtplanung und Umwelt
24.07.2023 12:00;645;293;352;Stellenweiser Regenfall;23;25;1.8;Stadt Konstanz, Amt fuer Stadtplanung und Umwelt
24.07.2023 13:00;475;237;238;Maeßiger bis starker Regen mit Gewitter;25;26;8.6;Stadt Konstanz, Amt fuer Stadtplanung und Umwelt
24.07.2023 14:00;550;274;276;Stellenweise Gewitter und Niederschlaege;26;27;0;Stadt Konstanz, Amt fuer Stadtplanung und Umwelt
24.07.2023 15:00;689;371;318;Stellenweise Gewitter und Niederschlaege;23;25;0;Stadt Konstanz, Amt fuer Stadtplanung und Umwelt
24.07.2023 16:00;859;424;435;Leichter Regenschauer;22;22;0.9;Stadt Konstanz, Amt fuer Stadtplanung und Umwelt
24.07.2023 17:00;754;392;362;Stellenweise Gewitter und Niederschlaege;23;25;0;Stadt Konstanz, Amt fuer Stadtplanung und Umwelt
24.07.2023 18:00;734;353;381;Leichter Regenschauer;23;25;0.2;Stadt Konstanz, Amt fuer Stadtplanung und Umwelt
24.07.2023 19:00;571;240;331;Stellenweise Gewitter und Niederschlaege;21;21;0;Stadt Konstanz, Amt fuer Stadtplanung und Umwelt
24.07.2023 20:00;360;139;221;Leichter Regenschauer;17;17;0.2;Stadt Konstanz, Amt fuer Stadtplanung und Umwelt
24.07.2023 21:00;256;111;145;Stellenweiser Regenfall;15;15;0.3;Stadt Konstanz, Amt fuer Stadtplanung und Umwelt
24.07.2023 22:00;246;104;142;Stellenweiser Regenfall;14;15;0.7;Stadt Konstanz, Amt fuer Stadtplanung und Umwelt
24.07.2023 23:00;125;50;75;Leichter Regenschauer;14;14;0.2;Stadt Konstanz, Amt fuer Stadtplanung und Umwelt
25.07.2023 00:00;80;31;49;Leichter Nebel;14;15;0.1;Stadt Konstanz, Amt fuer Stadtplanung und Umwelt
25.07.2023 01:00;44;19;25;Leichter Regenschauer;13;13;0.3;Stadt Konstanz, Amt fuer Stadtplanung und Umwelt
25.07.2023 02:00;22;7;15;Leichter Nebel;13;13;0;Stadt Konstanz, Amt fuer Stadtplanung und Umwelt
25.07.2023 03:00;9;4;5;Leichter Nebel;13;14;0;Stadt Konstanz, Amt fuer Stadtplanung und Umwelt
25.07.2023 04:00;13;5;8;Leichter Regenschauer;13;14;0.3;Stadt Konstanz, Amt fuer Stadtplanung und Umwelt
25.07.2023 05:00;52;37;15;Leichter Regenschauer;13;13;0.3;Stadt Konstanz, Amt fuer Stadtplanung und Umwelt
25.07.2023 06:00;181;103;78;Leichter Regenschauer;14;14;0.4;Stadt Konstanz, Amt fuer Stadtplanung und Umwelt
25.07.2023 07:00;484;268;216;Leichter Regenschauer;15;14;1.3;Stadt Konstanz, Amt fuer Stadtplanung und Umwelt
25.07.2023 08:00;886;494;392;Leichter Regenschauer;16;16;0.2;Stadt Konstanz, Amt fuer Stadtplanung und Umwelt
25.07.2023 09:00;661;376;285;Sonnig;18;18;0;Stadt Konstanz, Amt fuer Stadtplanung und Umwelt
25.07.2023 10:00;635;321;314;Stellenweiser Regenfall;20;20;0.3;Stadt Konstanz, Amt fuer Stadtplanung und Umwelt
25.07.2023 11:00;655;349;306;Leicht bewoelkt;22;22;0;Stadt Konstanz, Amt fuer Stadtplanung und Umwelt
25.07.2023 12:00;873;400;473;Stellenweiser Regenfall;23;25;0.1;Stadt Konstanz, Amt fuer Stadtplanung und Umwelt
25.07.2023 13:00;628;307;321;Sonnig;24;25;0;Stadt Konstanz, Amt fuer Stadtplanung und Umwelt
25.07.2023 14:00;738;386;352;Sonnig;23;25;0;Stadt Konstanz, Amt fuer Stadtplanung und Umwelt
25.07.2023 15:00;800;416;384;Sonnig;22;24;0;Stadt Konstanz, Amt fuer Stadtplanung und Umwelt
25.07.2023 16:00;828;367;461;Stellenweiser Regenfall;21;21;0.1;Stadt Konstanz, Amt fuer Stadtplanung und Umwelt
25.07.2023 17:00;930;432;498;Leicht bewoelkt;20;20;0;Stadt Konstanz, Amt fuer Stadtplanung und Umwelt
25.07.2023 18:00;906;454;452;Stellenweiser Regenfall;18;18;0.1;Stadt Konstanz, Amt fuer Stadtplanung und Umwelt
25.07.2023 19:00;658;298;360;Bewoelkt;15;15;0;Stadt Konstanz, Amt fuer Stadtplanung und Umwelt
25.07.2023 20:00;391;166;225;Leichter Regenschauer;13;13;0.9;Stadt Konstanz, Amt fuer Stadtplanung und Umwelt
25.07.2023 21:00;310;144;166;Leichter Regenschauer;13;12;1.1;Stadt Konstanz, Amt fuer Stadtplanung und Umwelt
25.07.2023 22:00;231;76;155;Maeßiger bis starker Regenschauer;12;12;3.5;Stadt Konstanz, Amt fuer Stadtplanung und Umwelt
25.07.2023 23:00;141;46;95;Leichter Regenschauer;12;12;1.1;Stadt Konstanz, Amt fuer Stadtplanung und Umwelt
26.07.2023 00:00;70;22;48;Stellenweiser Regenfall;12;12;0.1;Stadt Konstanz, Amt fuer Stadtplanung und Umwelt
26.07.2023 01:00;49;11;38;Leicht bewoelkt;12;12;0;Stadt Konstanz, Amt fuer Stadtplanung und Umwelt
26.07.2023 02:00;20;7;13;Stellenweiser Regenfall;11;12;0.1;Stadt Konstanz, Amt fuer Stadtplanung und Umwelt
26.07.2023 03:00;13;5;8;Bedeckt;10;10;0;Stadt Konstanz, Amt fuer Stadtplanung und Umwelt
26.07.2023 04:00;17;8;9;Nebel;9;8;0.1;Stadt Konstanz, Amt fuer Stadtplanung und Umwelt
26.07.2023 05:00;48;33;15;Leichter Nebel;9;9;0;Stadt Konstanz, Amt fuer Stadtplanung und Umwelt
26.07.2023 06:00;162;88;74;Leichter Nebel;10;10;0;Stadt Konstanz, Amt fuer Stadtplanung und Umwelt
26.07.2023 07:00;629;281;348;Leicht bewoelkt;12;12;0;Stadt Konstanz, Amt fuer Stadtplanung und Umwelt
26.07.2023 08:00;860;475;385;Sonnig;14;14;0;Stadt Konstanz, Amt fuer Stadtplanung und Umwelt
26.07.2023 09:00;877;584;293;Sonnig;16;16;0;Stadt Konstanz, Amt fuer Stadtplanung und Umwelt
26.07.2023 10:00;778;318;460;Stellenweiser Regenfall;18;18;0.1;Stadt Konstanz, Amt fuer Stadtplanung und Umwelt
26.07.2023 11:00;763;408;355;Sonnig;20;20;0;Stadt Konstanz, Amt fuer Stadtplanung und Umwelt
26.07.2023 12:00;768;346;422;Leicht bewoelkt;20;20;0;Stadt Konstanz, Amt fuer Stadtplanung und Umwelt
26.07.2023 13:00;755;348;407;Leicht bewoelkt;19;19;0;Stadt Konstanz, Amt fuer Stadtplanung und Umwelt
26.07.2023 14:00;505;200;305;Leicht bewoelkt;20;20;0;Stadt Konstanz, Amt fuer Stadtplanung und Umwelt
26.07.2023 15:00;710;361;349;Stellenweise Gewitter und Niederschlaege;21;21;0;Stadt Konstanz, Amt fuer Stadtplanung und Umwelt
26.07.2023 16:00;840;439;401;Leichter Regenschauer;18;18;0.3;Stadt Konstanz, Amt fuer Stadtplanung und Umwelt
26.07.2023 17:00;948;496;452;Leicht bewoelkt;14;15;0;Stadt Konstanz, Amt fuer Stadtplanung und Umwelt
26.07.2023 18:00;1027;580;447;Leichter Regenschauer;16;16;0.3;Stadt Konstanz, Amt fuer Stadtplanung und Umwelt
26.07.2023 19:00;795;494;301;Leicht bewoelkt;14;14;0;Stadt Konstanz, Amt fuer Stadtplanung und Umwelt
26.07.2023 20:00;540;300;240;Stellenweiser Regenfall;12;12;0.1;Stadt Konstanz, Amt fuer Stadtplanung und Umwelt
26.07.2023 21:00;445;220;225;Leicht bewoelkt;10;10;0;Stadt Konstanz, Amt fuer Stadtplanung und Umwelt
26.07.2023 22:00;440;145;295;Stellenweiser Regenfall;10;10;0.1;Stadt Konstanz, Amt fuer Stadtplanung und Umwelt
26.07.2023 23:00;370;57;313;Sonnig;10;10;0;Stadt Konstanz, Amt fuer Stadtplanung und Umwelt
27.07.2023 00:00;325;27;298;Sonnig;10;10;0;Stadt Konstanz, Amt fuer Stadtplanung und Umwelt
27.07.2023 01:00;202;27;175;Sonnig;9;9;0;Stadt Konstanz, Amt fuer Stadtplanung und Umwelt
27.07.2023 02:00;63;15;48;Sonnig;9;9;0;Stadt Konstanz, Amt fuer Stadtplanung und Umwelt
27.07.2023 03:00;22;6;16;Leicht bewoelkt;8;8;0;Stadt Konstanz, Amt fuer Stadtplanung und Umwelt
27.07.2023 04:00;20;10;10;Leicht bewoelkt;8;8;0;Stadt Konstanz, Amt fuer Stadtplanung und Umwelt
27.07.2023 05:00;50;30;20;Leichter Nebel;8;8;0;Stadt Konstanz, Amt fuer Stadtplanung und Umwelt
27.07.2023 06:00;199;115;84;Leicht bewoelkt;10;10;0;Stadt Konstanz, Amt fuer Stadtplanung und Umwelt
27.07.2023 07:00;458;258;200;Bewoelkt;12;12;0;Stadt Konstanz, Amt fuer Stadtplanung und Umwelt
27.07.2023 08:00;722;403;319;Leicht bewoelkt;15;16;0;Stadt Konstanz, Amt fuer Stadtplanung und Umwelt
27.07.2023 09:00;649;359;290;Leicht bewoelkt;17;17;0;Stadt Konstanz, Amt fuer Stadtplanung und Umwelt
27.07.2023 10:00;565;305;260;Bewoelkt;18;18;0;Stadt Konstanz, Amt fuer Stadtplanung und Umwelt
27.07.2023 11:00;689;333;356;Leicht bewoelkt;17;17;0;Stadt Konstanz, Amt fuer Stadtplanung und Umwelt
27.07.2023 12:00;724;344;380;Leicht bewoelkt;21;21;0;Stadt Konstanz, Amt fuer Stadtplanung und Umwelt
27.07.2023 13:00;781;388;393;Leicht bewoelkt;22;22;0;Stadt Konstanz, Amt fuer Stadtplanung und Umwelt
27.07.2023 14:00;790;349;441;Leicht bewoelkt;24;25;0;Stadt Konstanz, Amt fuer Stadtplanung und Umwelt
27.07.2023 15:00;937;505;432;Leicht bewoelkt;25;25;0;Stadt Konstanz, Amt fuer Stadtplanung und Umwelt
27.07.2023 16:00;1083;522;561;Leicht bewoelkt;26;26;0;Stadt Konstanz, Amt fuer Stadtplanung und Umwelt
27.07.2023 17:00;1141;573;568;Sonnig;26;26;0;Stadt Konstanz, Amt fuer Stadtplanung und Umwelt
27.07.2023 18:00;999;527;472;Leicht bewoelkt;23;25;0;Stadt Konstanz, Amt fuer Stadtplanung und Umwelt
27.07.2023 19:00;817;466;351;Sonnig;21;21;0;Stadt Konstanz, Amt fuer Stadtplanung und Umwelt
27.07.2023 20:00;552;328;224;Sonnig;18;18;0;Stadt Konstanz, Amt fuer Stadtplanung und Umwelt
27.07.2023 21:00;429;207;222;Sonnig;16;16;0;Stadt Konstanz, Amt fuer Stadtplanung und Umwelt
27.07.2023 22:00;469;161;308;Sonnig;15;16;0;Stadt Konstanz, Amt fuer Stadtplanung und Umwelt
27.07.2023 23:00;339;66;273;Sonnig;14;14;0;Stadt Konstanz, Amt fuer Stadtplanung und Umwelt
28.07.2023 00:00;247;30;217;Sonnig;13;13;0;Stadt Konstanz, Amt fuer Stadtplanung und Umwelt
28.07.2023 01:00;142;18;124;Sonnig;13;13;0;Stadt Konstanz, Amt fuer Stadtplanung und Umwelt
28.07.2023 02:00;32;7;25;Leicht bewoelkt;12;12;0;Stadt Konstanz, Amt fuer Stadtplanung und Umwelt
28.07.2023 03:00;18;1;17;Leicht bewoelkt;12;12;0;Stadt Konstanz, Amt fuer Stadtplanung und Umwelt
28.07.2023 04:00;13;5;8;Leicht bewoelkt;12;12;0;Stadt Konstanz, Amt fuer Stadtplanung und Umwelt
28.07.2023 05:00;56;40;16;Leicht bewoelkt;13;13;0;Stadt Konstanz, Amt fuer Stadtplanung und Umwelt
28.07.2023 06:00;170;100;70;Sonnig;14;14;0;Stadt Konstanz, Amt fuer Stadtplanung und Umwelt
28.07.2023 07:00;406;206;200;Sonnig;16;16;0;Stadt Konstanz, Amt fuer Stadtplanung und Umwelt
28.07.2023 08:00;630;355;275;Sonnig;20;20;0;Stadt Konstanz, Amt fuer Stadtplanung und Umwelt
28.07.2023 09:00;714;404;310;Sonnig;22;22;0;Stadt Konstanz, Amt fuer Stadtplanung und Umwelt
28.07.2023 10:00;648;375;273;Sonnig;24;25;0;Stadt Konstanz, Amt fuer Stadtplanung und Umwelt
28.07.2023 11:00;690;367;323;Leicht bewoelkt;26;27;0;Stadt Konstanz, Amt fuer Stadtplanung und Umwelt
28.07.2023 12:00;795;358;437;Leicht bewoelkt;26;26;0;Stadt Konstanz, Amt fuer Stadtplanung und Umwelt
28.07.2023 13:00;844;392;452;Leicht bewoelkt;24;25;0;Stadt Konstanz, Amt fuer Stadtplanung und Umwelt
28.07.2023 14:00;913;470;443;Stellenweiser Regenfall;24;25;0.1;Stadt Konstanz, Amt fuer Stadtplanung und Umwelt
28.07.2023 15:00;878;453;425;Leicht bewoelkt;25;26;0;Stadt Konstanz, Amt fuer Stadtplanung und Umwelt
28.07.2023 16:00;904;432;472;Stellenweiser Regenfall;23;25;0.3;Stadt Konstanz, Amt fuer Stadtplanung und Umwelt
28.07.2023 17:00;726;392;334;Leicht bewoelkt;23;25;0;Stadt Konstanz, Amt fuer Stadtplanung und Umwelt
28.07.2023 18:00;741;350;391;Stellenweiser Regenfall;23;25;0.1;Stadt Konstanz, Amt fuer Stadtplanung und Umwelt
28.07.2023 19:00;553;342;211;Sonnig;22;22;0;Stadt Konstanz, Amt fuer Stadtplanung und Umwelt
28.07.2023 20:00;447;273;174;Sonnig;16;16;0;Stadt Konstanz, Amt fuer Stadtplanung und Umwelt
28.07.2023 21:00;348;220;128;Leichter Nebel;15;15;0;Stadt Konstanz, Amt fuer Stadtplanung und Umwelt
28.07.2023 22:00;267;110;157;Leichter Nebel;14;14;0;Stadt Konstanz, Amt fuer Stadtplanung und Umwelt
28.07.2023 23:00;274;76;198;Leichter Nebel;14;14;0;Stadt Konstanz, Amt fuer Stadtplanung und Umwelt
29.07.2023 00:00;262;30;232;Leichter Nebel;13;14;0;Stadt Konstanz, Amt fuer Stadtplanung und Umwelt
29.07.2023 01:00;286;25;261;Leichter Nebel;13;13;0;Stadt Konstanz, Amt fuer Stadtplanung und Umwelt
29.07.2023 02:00;92;21;71;Stellenweiser Regenfall;13;14;0.4;Stadt Konstanz, Amt fuer Stadtplanung und Umwelt
29.07.2023 03:00;35;7;28;Leichter Regenschauer;13;13;0.3;Stadt Konstanz, Amt fuer Stadtplanung und Umwelt
29.07.2023 04:00;36;12;24;Leichter Regenschauer;13;13;1.3;Stadt Konstanz, Amt fuer Stadtplanung und Umwelt
29.07.2023 05:00;39;24;15;Nebel;13;13;0;Stadt Konstanz, Amt fuer Stadtplanung und Umwelt
29.07.2023 06:00;41;23;18;Leichter Regenschauer;14;14;0.3;Stadt Konstanz, Amt fuer Stadtplanung und Umwelt
29.07.2023 07:00;93;44;49;Leichter Nebel;16;16;0;Stadt Konstanz, Amt fuer Stadtplanung und Umwelt
29.07.2023 08:00;215;115;100;Leichter Regenschauer;17;17;0.4;Stadt Konstanz, Amt fuer Stadtplanung und Umwelt
29.07.2023 09:00;444;224;220;Leichter Regenschauer;19;19;0.2;Stadt Konstanz, Amt fuer Stadtplanung und Umwelt
29.07.2023 10:00;559;324;235;Leichter Regenschauer;20;20;0.6;Stadt Konstanz, Amt fuer Stadtplanung und Umwelt
29.07.2023 11:00;661;361;300;Bedeckt;22;25;0;Stadt Konstanz, Amt fuer Stadtplanung und Umwelt
29.07.2023 12:00;664;349;315;Leichter Regenschauer;20;20;0.3;Stadt Konstanz, Amt fuer Stadtplanung und Umwelt
29.07.2023 13:00;690;359;331;Leicht bewoelkt;19;19;0;Stadt Konstanz, Amt fuer Stadtplanung und Umwelt
29.07.2023 14:00;654;321;333;Bewoelkt;20;20;0;Stadt Konstanz, Amt fuer Stadtplanung und Umwelt
29.07.2023 15:00;482;226;256;Leicht bewoelkt;20;20;0;Stadt Konstanz, Amt fuer Stadtplanung und Umwelt
29.07.2023 16:00;357;160;197;Stellenweiser Regenfall;22;25;0.1;Stadt Konstanz, Amt fuer Stadtplanung und Umwelt
29.07.2023 17:00;348;173;175;Leicht bewoelkt;22;25;0;Stadt Konstanz, Amt fuer Stadtplanung und Umwelt
29.07.2023 18:00;415;230;185;Leicht bewoelkt;22;25;0;Stadt Konstanz, Amt fuer Stadtplanung und Umwelt
29.07.2023 19:00;391;234;157;Stellenweise Gewitter und Niederschlaege;19;19;0;Stadt Konstanz, Amt fuer Stadtplanung und Umwelt
29.07.2023 20:00;371;214;157;Stellenweiser Regenfall;16;16;0.9;Stadt Konstanz, Amt fuer Stadtplanung und Umwelt
29.07.2023 21:00;306;168;138;Leichter Regenschauer;15;15;0.8;Stadt Konstanz, Amt fuer Stadtplanung und Umwelt
29.07.2023 22:00;239;117;122;Maeßiger bis starker Regenschauer;15;15;4.1;Stadt Konstanz, Amt fuer Stadtplanung und Umwelt
29.07.2023 23:00;177;51;126;Leichter Regenschauer;15;15;1.6;Stadt Konstanz, Amt fuer Stadtplanung und Umwelt
30.07.2023 00:00;203;30;173;Leichter Regenschauer;15;15;0.8;Stadt Konstanz, Amt fuer Stadtplanung und Umwelt
30.07.2023 01:00;151;25;126;Leichter Regenschauer;15;15;2.3;Stadt Konstanz, Amt fuer Stadtplanung und Umwelt
30.07.2023 02:00;105;17;88;Leichter Regenschauer;14;15;1.4;Stadt Konstanz, Amt fuer Stadtplanung und Umwelt
30.07.2023 03:00;92;23;69;Leichter Regenschauer;14;14;1;Stadt Konstanz, Amt fuer Stadtplanung und Umwelt
30.07.2023 04:00;28;12;16;Maeßiger bis starker Regenschauer;14;14;4.4;Stadt Konstanz, Amt fuer Stadtplanung und Umwelt
30.07.2023 05:00;30;21;9;Leichter Regenschauer;14;14;1;Stadt Konstanz, Amt fuer Stadtplanung und Umwelt
30.07.2023 06:00;23;12;11;Leichter Regenschauer;15;15;1.1;Stadt Konstanz, Amt fuer Stadtplanung und Umwelt
30.07.2023 07:00;47;23;24;Maeßiger bis starker Regenschauer;16;16;4.4;Stadt Konstanz, Amt fuer Stadtplanung und Umwelt
30.07.2023 08:00;138;58;80;Bedeckt;17;17;0;Stadt Konstanz, Amt fuer Stadtplanung und Umwelt
30.07.2023 09:00;280;158;122;Bewoelkt;18;18;0;Stadt Konstanz, Amt fuer Stadtplanung und Umwelt
30.07.2023 10:00;337;164;173;Stellenweiser Regenfall;19;19;0.2;Stadt Konstanz, Amt fuer Stadtplanung und Umwelt
30.07.2023 11:00;443;236;207;Bewoelkt;23;25;0;Stadt Konstanz, Amt fuer Stadtplanung und Umwelt
30.07.2023 12:00;434;180;254;Stellenweiser Regenfall;23;25;0.1;Stadt Konstanz, Amt fuer Stadtplanung und Umwelt
30.07.2023 13:00;463;227;236;Leicht bewoelkt;23;25;0;Stadt Konstanz, Amt fuer Stadtplanung und Umwelt
30.07.2023 14:00;552;257;295;Sonnig;23;25;0;Stadt Konstanz, Amt fuer Stadtplanung und Umwelt
30.07.2023 15:00;569;308;261;Sonnig;24;25;0;Stadt Konstanz, Amt fuer Stadtplanung und Umwelt
30.07.2023 16:00;550;276;274;Sonnig;25;25;0;Stadt Konstanz, Amt fuer Stadtplanung und Umwelt
30.07.2023 17:00;669;337;332;Sonnig;25;25;0;Stadt Konstanz, Amt fuer Stadtplanung und Umwelt
30.07.2023 18:00;589;292;297;Sonnig;23;25;0;Stadt Konstanz, Amt fuer Stadtplanung und Umwelt
30.07.2023 19:00;502;249;253;Sonnig;19;19;0;Stadt Konstanz, Amt fuer Stadtplanung und Umwelt
30.07.2023 20:00;413;196;217;Sonnig;15;15;0;Stadt Konstanz, Amt fuer Stadtplanung und Umwelt
30.07.2023 21:00;299;112;187;Sonnig;14;14;0;Stadt Konstanz, Amt fuer Stadtplanung und Umwelt
30.07.2023 22:00;204;92;112;Sonnig;14;15;0;Stadt Konstanz, Amt fuer Stadtplanung und Umwelt
30.07.2023 23:00;127;48;79;Sonnig;13;14;0;Stadt Konstanz, Amt fuer Stadtplanung und Umwelt
31.07.2023 00:00;58;32;26;Sonnig;11;11;0;Stadt Konstanz, Amt fuer Stadtplanung und Umwelt
31.07.2023 01:00;24;10;14;Sonnig;10;10;0;Stadt Konstanz, Amt fuer Stadtplanung und Umwelt
31.07.2023 02:00;8;2;6;Sonnig;10;10;0;Stadt Konstanz, Amt fuer Stadtplanung und Umwelt
31.07.2023 03:00;9;6;3;Sonnig;9;9;0;Stadt Konstanz, Amt fuer Stadtplanung und Umwelt
31.07.2023 04:00;12;5;7;Sonnig;9;9;0;Stadt Konstanz, Amt fuer Stadtplanung und Umwelt
31.07.2023 05:00;31;19;12;Sonnig;9;9;0;Stadt Konstanz, Amt fuer Stadtplanung und Umwelt
31.07.2023 06:00;185;101;84;Sonnig;11;11;0;Stadt Konstanz, Amt fuer Stadtplanung und Umwelt
31.07.2023 07:00;457;245;212;Sonnig;14;15;0;Stadt Konstanz, Amt fuer Stadtplanung und Umwelt
31.07.2023 08:00;666;359;307;Leicht bewoelkt;16;16;0;Stadt Konstanz, Amt fuer Stadtplanung und Umwelt
31.07.2023 09:00;645;357;288;Leicht bewoelkt;18;18;0;Stadt Konstanz, Amt fuer Stadtplanung und Umwelt
31.07.2023 10:00;630;321;309;Sonnig;20;20;0;Stadt Konstanz, Amt fuer Stadtplanung und Umwelt
31.07.2023 11:00;736;355;381;Sonnig;22;24;0;Stadt Konstanz, Amt fuer Stadtplanung und Umwelt
31.07.2023 12:00;785;371;414;Leicht bewoelkt;24;25;0;Stadt Konstanz, Amt fuer Stadtplanung und Umwelt
31.07.2023 13:00;784;402;382;Sonnig;25;25;0;Stadt Konstanz, Amt fuer Stadtplanung und Umwelt
31.07.2023 14:00;801;439;362;Leicht bewoelkt;25;25;0;Stadt Konstanz, Amt fuer Stadtplanung und Umwelt
31.07.2023 15:00;937;463;474;Sonnig;25;26;0;Stadt Konstanz, Amt fuer Stadtplanung und Umwelt
31.07.2023 16:00;944;457;487;Sonnig;25;26;0;Stadt Konstanz, Amt fuer Stadtplanung und Umwelt
31.07.2023 17:00;1015;501;514;Sonnig;25;26;0;Stadt Konstanz, Amt fuer Stadtplanung und Umwelt
31.07.2023 18:00;917;438;479;Sonnig;24;25;0;Stadt Konstanz, Amt fuer Stadtplanung und Umwelt
31.07.2023 19:00;689;325;364;Sonnig;20;20;0;Stadt Konstanz, Amt fuer Stadtplanung und Umwelt
31.07.2023 20:00;487;233;254;Sonnig;17;17;0;Stadt Konstanz, Amt fuer Stadtplanung und Umwelt
31.07.2023 21:00;317;121;196;Sonnig;17;17;0;Stadt Konstanz, Amt fuer Stadtplanung und Umwelt
31.07.2023 22:00;288;108;180;Sonnig;16;16;0;Stadt Konstanz, Amt fuer Stadtplanung und Umwelt
31.07.2023 23:00;140;40;100;Leicht bewoelkt;15;15;0;Stadt Konstanz, Amt fuer Stadtplanung und Umwelt
01.08.2023 00:00;105;28;77;Leicht bewoelkt;13;14;0;Stadt Konstanz, Amt fuer Stadtplanung und Umwelt
01.08.2023 01:00;54;15;39;Leicht bewoelkt;14;14;0;Stadt Konstanz, Amt fuer Stadtplanung und Umwelt
01.08.2023 02:00;18;6;12;Bewoelkt;14;15;0;Stadt Konstanz, Amt fuer Stadtplanung und Umwelt
01.08.2023 03:00;10;2;8;Leicht bewoelkt;14;15;0;Stadt Konstanz, Amt fuer Stadtplanung und Umwelt
01.08.2023 04:00;15;7;8;Leicht bewoelkt;14;14;0;Stadt Konstanz, Amt fuer Stadtplanung und Umwelt
01.08.2023 05:00;30;19;11;Leicht bewoelkt;14;14;0;Stadt Konstanz, Amt fuer Stadtplanung und Umwelt
01.08.2023 06:00;147;72;75;Leicht bewoelkt;15;15;0;Stadt Konstanz, Amt fuer Stadtplanung und Umwelt
01.08.2023 07:00;331;167;164;Leicht bewoelkt;17;17;0;Stadt Konstanz, Amt fuer Stadtplanung und Umwelt
01.08.2023 08:00;492;273;219;Stellenweiser Regenfall;18;18;0.1;Stadt Konstanz, Amt fuer Stadtplanung und Umwelt
01.08.2023 09:00;431;258;173;Bewoelkt;15;15;0;Stadt Konstanz, Amt fuer Stadtplanung und Umwelt
01.08.2023 10:00;361;187;174;Maeßiger Regenfall;15;13;3.6;Stadt Konstanz, Amt fuer Stadtplanung und Umwelt
01.08.2023 11:00;278;137;141;Bedeckt;15;13;0;Stadt Konstanz, Amt fuer Stadtplanung und Umwelt
01.08.2023 12:00;458;217;241;Leichter Regenfall;15;14;1.9;Stadt Konstanz, Amt fuer Stadtplanung und Umwelt
01.08.2023 13:00;500;259;241;Bedeckt;15;15;0;Stadt Konstanz, Amt fuer Stadtplanung und Umwelt
01.08.2023 14:00;457;257;200;Leichter Regenschauer;18;18;0.2;Stadt Konstanz, Amt fuer Stadtplanung und Umwelt
01.08.2023 15:00;529;246;283;Stellenweise Gewitter und Niederschlaege;17;17;0;Stadt Konstanz, Amt fuer Stadtplanung und Umwelt
01.08.2023 16:00;677;354;323;Teilweise maeßiger Regenfall;17;17;3.1;Stadt Konstanz, Amt fuer Stadtplanung und Umwelt
01.08.2023 17:00;627;316;311;Leichter Regenschauer;17;17;0.3;Stadt Konstanz, Amt fuer Stadtplanung und Umwelt
01.08.2023 18:00;648;320;328;Leichter Regenschauer;17;17;1.1;Stadt Konstanz, Amt fuer Stadtplanung und Umwelt
01.08.2023 19:00;491;222;269;Leichter Regenschauer;16;16;1.9;Stadt Konstanz, Amt fuer Stadtplanung und Umwelt
01.08.2023 20:00;375;163;212;Leicht bewoelkt;14;14;0;Stadt Konstanz, Amt fuer Stadtplanung und Umwelt
01.08.2023 21:00;288;131;157;Leichter Nebel;14;13;0;Stadt Konstanz, Amt fuer Stadtplanung und Umwelt
01.08.2023 22:00;241;89;152;Leichter Nebel;13;13;0;Stadt Konstanz, Amt fuer Stadtplanung und Umwelt
01.08.2023 23:00;154;57;97;Nebel;12;12;0;Stadt Konstanz, Amt fuer Stadtplanung und Umwelt
02.08.2023 00:00;84;39;45;Nebel;11;12;0;Stadt Konstanz, Amt fuer Stadtplanung und Umwelt
02.08.2023 01:00;46;20;26;Nebel;11;11;0.1;Stadt Konstanz, Amt fuer Stadtplanung und Umwelt
02.08.2023 02:00;15;5;10;Nebel;11;11;0;Stadt Konstanz, Amt fuer Stadtplanung und Umwelt
02.08.2023 03:00;10;5;5;Bewoelkt;10;10;0;Stadt Konstanz, Amt fuer Stadtplanung und Umwelt
02.08.2023 04:00;15;11;4;Nebel;10;10;0;Stadt Konstanz, Amt fuer Stadtplanung und Umwelt
02.08.2023 05:00;48;33;15;Nebel;11;11;0;Stadt Konstanz, Amt fuer Stadtplanung und Umwelt
02.08.2023 06:00;172;106;66;Leichter Nebel;12;12;0;Stadt Konstanz, Amt fuer Stadtplanung und Umwelt
02.08.2023 07:00;399;214;185;Leichter Nebel;13;12;0;Stadt Konstanz, Amt fuer Stadtplanung und Umwelt
02.08.2023 08:00;522;287;235;Leichter Nebel;14;14;0;Stadt Konstanz, Amt fuer Stadtplanung und Umwelt
02.08.2023 09:00;347;184;163;Leicht bewoelkt;15;15;0;Stadt Konstanz, Amt fuer Stadtplanung und Umwelt
02.08.2023 10:00;397;209;188;Leicht bewoelkt;17;17;0;Stadt Konstanz, Amt fuer Stadtplanung und Umwelt
02.08.2023 11:00;520;267;253;Leicht bewoelkt;21;21;0;Stadt Konstanz, Amt fuer Stadtplanung und Umwelt
02.08.2023 12:00;571;247;324;Leicht bewoelkt;22;25;0;Stadt Konstanz, Amt fuer Stadtplanung und Umwelt
02.08.2023 13:00;690;349;341;Leicht bewoelkt;25;26;0;Stadt Konstanz, Amt fuer Stadtplanung und Umwelt
02.08.2023 14:00;768;423;345;Leicht bewoelkt;28;28;0;Stadt Konstanz, Amt fuer Stadtplanung und Umwelt
02.08.2023 15:00;809;426;383;Leicht bewoelkt;28;28;0;Stadt Konstanz, Amt fuer Stadtplanung und Umwelt
02.08.2023 16:00;962;449;513;Leicht bewoelkt;29;29;0;Stadt Konstanz, Amt fuer Stadtplanung und Umwelt
02.08.2023 17:00;1108;499;609;Leicht bewoelkt;28;28;0;Stadt Konstanz, Amt fuer Stadtplanung und Umwelt
02.08.2023 18:00;864;371;493;Leicht bewoelkt;24;25;0;Stadt Konstanz, Amt fuer Stadtplanung und Umwelt
02.08.2023 19:00;550;254;296;Leicht bewoelkt;20;20;0;Stadt Konstanz, Amt fuer Stadtplanung und Umwelt
02.08.2023 20:00;450;196;254;Stellenweiser Nieselregen;18;18;0.4;Stadt Konstanz, Amt fuer Stadtplanung und Umwelt
02.08.2023 21:00;267;105;162;Stellenweiser Regenfall;16;16;0.4;Stadt Konstanz, Amt fuer Stadtplanung und Umwelt
02.08.2023 22:00;238;79;159;Stellenweiser leichter Regenfall;16;16;2.4;Stadt Konstanz, Amt fuer Stadtplanung und Umwelt
02.08.2023 23:00;134;58;76;Stellenweiser Regenfall;16;16;0.5;Stadt Konstanz, Amt fuer Stadtplanung und Umwelt
03.08.2023 00:00;49;19;30;Stellenweiser Regenfall;17;17;0.3;Stadt Konstanz, Amt fuer Stadtplanung und Umwelt
03.08.2023 01:00;44;14;30;Sonnig;16;16;0;Stadt Konstanz, Amt fuer Stadtplanung und Umwelt
03.08.2023 02:00;15;5;10;Sonnig;15;15;0;Stadt Konstanz, Amt fuer Stadtplanung und Umwelt
03.08.2023 03:00;16;7;9;Sonnig;15;15;0;Stadt Konstanz, Amt fuer Stadtplanung und Umwelt
03.08.2023 04:00;10;6;4;Sonnig;16;16;0;Stadt Konstanz, Amt fuer Stadtplanung und Umwelt
03.08.2023 05:00;45;30;15;Sonnig;16;16;0;Stadt Konstanz, Amt fuer Stadtplanung und Umwelt
03.08.2023 06:00;181;107;74;Sonnig;16;16;0;Stadt Konstanz, Amt fuer Stadtplanung und Umwelt
03.08.2023 07:00;472;281;191;Sonnig;16;16;0;Stadt Konstanz, Amt fuer Stadtplanung und Umwelt
03.08.2023 08:00;711;392;319;Sonnig;18;18;0;Stadt Konstanz, Amt fuer Stadtplanung und Umwelt
03.08.2023 09:00;617;325;292;Sonnig;19;19;0;Stadt Konstanz, Amt fuer Stadtplanung und Umwelt
03.08.2023 10:00;638;346;292;Leicht bewoelkt;20;20;0;Stadt Konstanz, Amt fuer Stadtplanung und Umwelt
03.08.2023 11:00;782;395;387;Leicht bewoelkt;22;22;0;Stadt Konstanz, Amt fuer Stadtplanung und Umwelt
03.08.2023 12:00;725;337;388;Sonnig;23;24;0;Stadt Konstanz, Amt fuer Stadtplanung und Umwelt
03.08.2023 13:00;716;319;397;Sonnig;24;25;0;Stadt Konstanz, Amt fuer Stadtplanung und Umwelt
03.08.2023 14:00;819;428;391;Leicht bewoelkt;24;25;0;Stadt Konstanz, Amt fuer Stadtplanung und Umwelt
03.08.2023 15:00;936;459;477;Sonnig;24;25;0;Stadt Konstanz, Amt fuer Stadtplanung und Umwelt
03.08.2023 16:00;1051;502;549;Sonnig;24;25;0;Stadt Konstanz, Amt fuer Stadtplanung und Umwelt
03.08.2023 17:00;1035;496;539;Sonnig;24;25;0;Stadt Konstanz, Amt fuer Stadtplanung und Umwelt
03.08.2023 18:00;1013;479;534;Sonnig;22;25;0;Stadt Konstanz, Amt fuer Stadtplanung und Umwelt
03.08.2023 19:00;663;325;338;Sonnig;19;19;0;Stadt Konstanz, Amt fuer Stadtplanung und Umwelt
03.08.2023 20:00;496;226;270;Sonnig;14;14;0;Stadt Konstanz, Amt fuer Stadtplanung und Umwelt
03.08.2023 21:00;438;198;240;Leicht bewoelkt;13;13;0;Stadt Konstanz, Amt fuer Stadtplanung und Umwelt
03.08.2023 22:00;365;137;228;Leicht bewoelkt;12;12;0;Stadt Konstanz, Amt fuer Stadtplanung und Umwelt
03.08.2023 23:00;239;88;151;Sonnig;12;12;0;Stadt Konstanz, Amt fuer Stadtplanung und Umwelt
04.08.2023 00:00;128;43;85;Leicht bewoelkt;12;12;0;Stadt Konstanz, Amt fuer Stadtplanung und Umwelt
04.08.2023 01:00;57;22;35;Leicht bewoelkt;11;11;0;Stadt Konstanz, Amt fuer Stadtplanung und Umwelt
04.08.2023 02:00;31;9;22;Leicht bewoelkt;12;12;0;Stadt Konstanz, Amt fuer Stadtplanung und Umwelt
04.08.2023 03:00;13;6;7;Bewoelkt;11;11;0;Stadt Konstanz, Amt fuer Stadtplanung und Umwelt
04.08.2023 04:00;20;11;9;Leichter Nebel;10;11;0;Stadt Konstanz, Amt fuer Stadtplanung und Umwelt
04.08.2023 05:00;46;26;20;Leichter Nebel;10;10;0;Stadt Konstanz, Amt fuer Stadtplanung und Umwelt
04.08.2023 06:00;162;98;64;Leicht bewoelkt;12;12;0;Stadt Konstanz, Amt fuer Stadtplanung und Umwelt
04.08.2023 07:00;389;229;160;Bewoelkt;14;15;0;Stadt Konstanz, Amt fuer Stadtplanung und Umwelt
04.08.2023 08:00;607;350;257;Bewoelkt;16;16;0;Stadt Konstanz, Amt fuer Stadtplanung und Umwelt
04.08.2023 09:00;559;301;258;Leicht bewoelkt;16;16;0;Stadt Konstanz, Amt fuer Stadtplanung und Umwelt
04.08.2023 10:00;628;337;291;Stellenweiser Regenfall;19;19;0.1;Stadt Konstanz, Amt fuer Stadtplanung und Umwelt
04.08.2023 11:00;672;360;312;Leicht bewoelkt;19;19;0;Stadt Konstanz, Amt fuer Stadtplanung und Umwelt
04.08.2023 12:00;680;318;362;Leichter Regenschauer;19;19;0.3;Stadt Konstanz, Amt fuer Stadtplanung und Umwelt
04.08.2023 13:00;768;363;405;Leichter Regenschauer;18;18;1.3;Stadt Konstanz, Amt fuer Stadtplanung und Umwelt
04.08.2023 14:00;795;394;401;Leichter Regenschauer;18;18;0.9;Stadt Konstanz, Amt fuer Stadtplanung und Umwelt
04.08.2023 15:00;794;359;435;Leichter Regenschauer;18;18;0.9;Stadt Konstanz, Amt fuer Stadtplanung und Umwelt
04.08.2023 16:00;679;312;367;Maeßiger bis starker Regenschauer;18;18;3.3;Stadt Konstanz, Amt fuer Stadtplanung und Umwelt
04.08.2023 17:00;597;284;313;Leichter Regenschauer;16;16;0.9;Stadt Konstanz, Amt fuer Stadtplanung und Umwelt
04.08.2023 18:00;510;233;277;Leichter Regenschauer;15;15;1;Stadt Konstanz, Amt fuer Stadtplanung und Umwelt
04.08.2023 19:00;553;330;223;Maeßiger bis starker Regenschauer;14;14;4.3;Stadt Konstanz, Amt fuer Stadtplanung und Umwelt
04.08.2023 20:00;378;228;150;Stellenweiser Regenfall;13;13;0.1;Stadt Konstanz, Amt fuer Stadtplanung und Umwelt
04.08.2023 21:00;257;142;115;Stellenweiser Regenfall;12;13;0.1;Stadt Konstanz, Amt fuer Stadtplanung und Umwelt
04.08.2023 22:00;303;85;218;Leichter Regenschauer;12;12;0.3;Stadt Konstanz, Amt fuer Stadtplanung und Umwelt
04.08.2023 23:00;273;62;211;Leichter Nebel;12;13;0.1;Stadt Konstanz, Amt fuer Stadtplanung und Umwelt
05.08.2023 00:00;159;39;120;Leichter Nebel;10;11;0;Stadt Konstanz, Amt fuer Stadtplanung und Umwelt
05.08.2023 01:00;114;34;80;Leichter Nebel;10;11;0;Stadt Konstanz, Amt fuer Stadtplanung und Umwelt
05.08.2023 02:00;92;14;78;Leichter Nebel;11;11;0;Stadt Konstanz, Amt fuer Stadtplanung und Umwelt
05.08.2023 03:00;39;17;22;Leicht bewoelkt;11;12;0;Stadt Konstanz, Amt fuer Stadtplanung und Umwelt
05.08.2023 04:00;30;13;17;Leichter Nebel;10;11;0;Stadt Konstanz, Amt fuer Stadtplanung und Umwelt
05.08.2023 05:00;30;13;17;Leichter Nebel;10;10;0;Stadt Konstanz, Amt fuer Stadtplanung und Umwelt
05.08.2023 06:00;41;25;16;Leichter Nebel;10;11;0;Stadt Konstanz, Amt fuer Stadtplanung und Umwelt
05.08.2023 07:00;84;47;37;Stellenweiser Regenfall;12;13;0.1;Stadt Konstanz, Amt fuer Stadtplanung und Umwelt
05.08.2023 08:00;189;104;85;Leicht bewoelkt;14;14;0;Stadt Konstanz, Amt fuer Stadtplanung und Umwelt
05.08.2023 09:00;375;195;180;Sonnig;16;16;0;Stadt Konstanz, Amt fuer Stadtplanung und Umwelt
05.08.2023 10:00;473;258;215;Sonnig;18;18;0;Stadt Konstanz, Amt fuer Stadtplanung und Umwelt
05.08.2023 11:00;640;348;292;Sonnig;20;20;0;Stadt Konstanz, Amt fuer Stadtplanung und Umwelt
05.08.2023 12:00;711;367;344;Leicht bewoelkt;21;21;0;Stadt Konstanz, Amt fuer Stadtplanung und Umwelt
05.08.2023 13:00;611;264;347;Leicht bewoelkt;22;22;0;Stadt Konstanz, Amt fuer Stadtplanung und Umwelt
05.08.2023 14:00;595;291;304;Sonnig;23;24;0;Stadt Konstanz, Amt fuer Stadtplanung und Umwelt
05.08.2023 15:00;673;328;345;Sonnig;23;24;0;Stadt Konstanz, Amt fuer Stadtplanung und Umwelt
05.08.2023 16:00;607;295;312;Leicht bewoelkt;22;24;0;Stadt Konstanz, Amt fuer Stadtplanung und Umwelt
05.08.2023 17:00;650;303;347;Leicht bewoelkt;20;20;0;Stadt Konstanz, Amt fuer Stadtplanung und Umwelt
05.08.2023 18:00;581;275;306;Bewoelkt;18;18;0;Stadt Konstanz, Amt fuer Stadtplanung und Umwelt
05.08.2023 19:00;489;250;239;Leicht bewoelkt;17;17;0;Stadt Konstanz, Amt fuer Stadtplanung und Umwelt
05.08.2023 20:00;350;170;180;Leicht bewoelkt;15;14;0;Stadt Konstanz, Amt fuer Stadtplanung und Umwelt
05.08.2023 21:00;318;146;172;Bewoelkt;14;13;0;Stadt Konstanz, Amt fuer Stadtplanung und Umwelt
05.08.2023 22:00;246;91;155;Stellenweiser Nieselregen;13;13;0.2;Stadt Konstanz, Amt fuer Stadtplanung und Umwelt
05.08.2023 23:00;187;72;115;Leicht bewoelkt;13;13;0;Stadt Konstanz, Amt fuer Stadtplanung und Umwelt
06.08.2023 00:00;167;79;88;Bedeckt;14;13;0;Stadt Konstanz, Amt fuer Stadtplanung und Umwelt
06.08.2023 01:00;104;59;45;Bewoelkt;14;13;0;Stadt Konstanz, Amt fuer Stadtplanung und Umwelt
06.08.2023 02:00;78;45;33;Leicht bewoelkt;12;11;0;Stadt Konstanz, Amt fuer Stadtplanung und Umwelt
06.08.2023 03:00;68;36;32;Leicht bewoelkt;12;11;0;Stadt Konstanz, Amt fuer Stadtplanung und Umwelt
06.08.2023 04:00;34;28;6;Leicht bewoelkt;9;9;0;Stadt Konstanz, Amt fuer Stadtplanung und Umwelt
06.08.2023 05:00;39;26;13;Bewoelkt;10;9;0;Stadt Konstanz, Amt fuer Stadtplanung und Umwelt
06.08.2023 06:00;40;26;14;Stellenweiser Regenfall;12;9;0.1;Stadt Konstanz, Amt fuer Stadtplanung und Umwelt
06.08.2023 07:00;27;10;17;Leicht bewoelkt;11;8;0;Stadt Konstanz, Amt fuer Stadtplanung und Umwelt
06.08.2023 08:00;56;35;21;Bedeckt;12;10;0;Stadt Konstanz, Amt fuer Stadtplanung und Umwelt
06.08.2023 09:00;148;65;83;Bedeckt;13;10;0;Stadt Konstanz, Amt fuer Stadtplanung und Umwelt
06.08.2023 10:00;129;57;72;Nieselregen;11;8;0.5;Stadt Konstanz, Amt fuer Stadtplanung und Umwelt
06.08.2023 11:00;188;105;83;Nieselregen;10;7;0.2;Stadt Konstanz, Amt fuer Stadtplanung und Umwelt
06.08.2023 12:00;153;77;76;Nieselregen;10;7;0.5;Stadt Konstanz, Amt fuer Stadtplanung und Umwelt
06.08.2023 13:00;177;96;81;Bedeckt;11;8;0;Stadt Konstanz, Amt fuer Stadtplanung und Umwelt
06.08.2023 14:00;238;105;133;Nieselregen;10;8;0.4;Stadt Konstanz, Amt fuer Stadtplanung und Umwelt
06.08.2023 15:00;230;120;110;Bedeckt;11;8;0;Stadt Konstanz, Amt fuer Stadtplanung und Umwelt
06.08.2023 16:00;235;100;135;Leichter Regenfall;11;8;1.3;Stadt Konstanz, Amt fuer Stadtplanung und Umwelt
06.08.2023 17:00;263;108;155;Bedeckt;11;8;0;Stadt Konstanz, Amt fuer Stadtplanung und Umwelt
06.08.2023 18:00;244;132;112;Nieselregen;12;9;0.3;Stadt Konstanz, Amt fuer Stadtplanung und Umwelt
06.08.2023 19:00;260;139;121;Bewoelkt;11;9;0;Stadt Konstanz, Amt fuer Stadtplanung und Umwelt
06.08.2023 20:00;196;100;96;Bewoelkt;11;9;0;Stadt Konstanz, Amt fuer Stadtplanung und Umwelt
06.08.2023 21:00;119;59;60;Bedeckt;11;9;0;Stadt Konstanz, Amt fuer Stadtplanung und Umwelt
06.08.2023 22:00;138;58;80;Stellenweiser Regenfall;11;9;0.4;Stadt Konstanz, Amt fuer Stadtplanung und Umwelt
06.08.2023 23:00;73;36;37;Leichter Nebel;9;8;0;Stadt Konstanz, Amt fuer Stadtplanung und Umwelt
07.08.2023 00:00;38;16;22;Leicht bewoelkt;11;9;0;Stadt Konstanz, Amt fuer Stadtplanung und Umwelt
07.08.2023 01:00;17;8;9;Leicht bewoelkt;9;8;0;Stadt Konstanz, Amt fuer Stadtplanung und Umwelt
07.08.2023 02:00;9;3;6;Leichter Nebel;8;6;0;Stadt Konstanz, Amt fuer Stadtplanung und Umwelt
07.08.2023 03:00;8;6;2;Leichter Nebel;7;6;0;Stadt Konstanz, Amt fuer Stadtplanung und Umwelt
07.08.2023 04:00;9;6;3;Nebel;7;5;0.1;Stadt Konstanz, Amt fuer Stadtplanung und Umwelt
07.08.2023 05:00;36;24;12;Nebel;7;5;0;Stadt Konstanz, Amt fuer Stadtplanung und Umwelt
07.08.2023 06:00;176;99;77;Leichter Nebel;7;6;0;Stadt Konstanz, Amt fuer Stadtplanung und Umwelt
07.08.2023 07:00;365;211;154;Bewoelkt;10;8;0;Stadt Konstanz, Amt fuer Stadtplanung und Umwelt
07.08.2023 08:00;465;255;210;Stellenweiser Regenfall;12;10;0.1;Stadt Konstanz, Amt fuer Stadtplanung und Umwelt
07.08.2023 09:00;471;252;219;Bewoelkt;14;12;0;Stadt Konstanz, Amt fuer Stadtplanung und Umwelt
07.08.2023 10:00;484;232;252;Leichter Regenschauer;14;13;0.2;Stadt Konstanz, Amt fuer Stadtplanung und Umwelt
07.08.2023 11:00;511;288;223;Bedeckt;15;15;0;Stadt Konstanz, Amt fuer Stadtplanung und Umwelt
07.08.2023 12:00;331;154;177;Stellenweiser Regenfall;16;16;0.1;Stadt Konstanz, Amt fuer Stadtplanung und Umwelt
07.08.2023 13:00;488;257;231;Leicht bewoelkt;17;17;0;Stadt Konstanz, Amt fuer Stadtplanung und Umwelt
07.08.2023 14:00;508;253;255;Stellenweiser Regenfall;18;18;0.3;Stadt Konstanz, Amt fuer Stadtplanung und Umwelt
07.08.2023 15:00;602;309;293;Stellenweiser Regenfall;18;18;0.2;Stadt Konstanz, Amt fuer Stadtplanung und Umwelt
07.08.2023 16:00;621;293;328;Stellenweiser Regenfall;19;19;0.5;Stadt Konstanz, Amt fuer Stadtplanung und Umwelt
07.08.2023 17:00;803;356;447;Stellenweiser Regenfall;18;18;0.1;Stadt Konstanz, Amt fuer Stadtplanung und Umwelt
07.08.2023 18:00;550;220;330;Stellenweiser Regenfall;17;17;0.1;Stadt Konstanz, Amt fuer Stadtplanung und Umwelt
07.08.2023 19:00;492;222;270;Stellenweiser Regenfall;14;14;0.7;Stadt Konstanz, Amt fuer Stadtplanung und Umwelt
07.08.2023 20:00;333;144;189;Stellenweiser Regenfall;11;11;0.1;Stadt Konstanz, Amt fuer Stadtplanung und Umwelt
07.08.2023 21:00;224;104;120;Leicht bewoelkt;10;10;0;Stadt Konstanz, Amt fuer Stadtplanung und Umwelt
07.08.2023 22:00;180;69;111;Stellenweiser Regenfall;9;9;0.1;Stadt Konstanz, Amt fuer Stadtplanung und Umwelt
07.08.2023 23:00;91;27;64;Sonnig;8;8;0;Stadt Konstanz, Amt fuer Stadtplanung und Umwelt
08.08.2023 00:00;50;21;29;Sonnig;7;7;0;Stadt Konstanz, Amt fuer Stadtplanung und Umwelt
08.08.2023 01:00;30;14;16;Leichter Nebel;7;7;0;Stadt Konstanz, Amt fuer Stadtplanung und Umwelt
08.08.2023 02:00;17;8;9;Leichter Nebel;7;7;0;Stadt Konstanz, Amt fuer Stadtplanung und Umwelt
08.08.2023 03:00;6;2;4;Leichter Nebel;6;6;0;Stadt Konstanz, Amt fuer Stadtplanung und Umwelt
08.08.2023 04:00;14;6;8;Leichter Nebel;6;6;0;Stadt Konstanz, Amt fuer Stadtplanung und Umwelt
08.08.2023 05:00;39;32;7;Leichter Nebel;6;6;0;Stadt Konstanz, Amt fuer Stadtplanung und Umwelt
08.08.2023 06:00;178;107;71;Leichter Nebel;6;6;0;Stadt Konstanz, Amt fuer Stadtplanung und Umwelt
08.08.2023 07:00;389;232;157;Leicht bewoelkt;10;10;0;Stadt Konstanz, Amt fuer Stadtplanung und Umwelt
08.08.2023 08:00;555;321;234;Sonnig;12;12;0;Stadt Konstanz, Amt fuer Stadtplanung und Umwelt
08.08.2023 09:00;566;347;219;Sonnig;14;15;0;Stadt Konstanz, Amt fuer Stadtplanung und Umwelt
08.08.2023 10:00;670;373;297;Sonnig;17;17;0;Stadt Konstanz, Amt fuer Stadtplanung und Umwelt
08.08.2023 11:00;684;342;342;Sonnig;19;19;0;Stadt Konstanz, Amt fuer Stadtplanung und Umwelt
08.08.2023 12:00;751;373;378;Sonnig;20;20;0;Stadt Konstanz, Amt fuer Stadtplanung und Umwelt
08.08.2023 13:00;694;346;348;Sonnig;21;21;0;Stadt Konstanz, Amt fuer Stadtplanung und Umwelt
08.08.2023 14:00;786;389;397;Sonnig;22;24;0;Stadt Konstanz, Amt fuer Stadtplanung und Umwelt
08.08.2023 15:00;904;468;436;Sonnig;23;24;0;Stadt Konstanz, Amt fuer Stadtplanung und Umwelt
08.08.2023 16:00;921;428;493;Sonnig;22;22;0;Stadt Konstanz, Amt fuer Stadtplanung und Umwelt
08.08.2023 17:00;946;418;528;Sonnig;21;21;0;Stadt Konstanz, Amt fuer Stadtplanung und Umwelt
08.08.2023 18:00;924;413;511;Sonnig;20;20;0;Stadt Konstanz, Amt fuer Stadtplanung und Umwelt
08.08.2023 19:00;654;297;357;Sonnig;17;17;0;Stadt Konstanz, Amt fuer Stadtplanung und Umwelt
08.08.2023 20:00;463;223;240;Leicht bewoelkt;15;15;0;Stadt Konstanz, Amt fuer Stadtplanung und Umwelt
08.08.2023 21:00;339;142;197;Leicht bewoelkt;13;14;0;Stadt Konstanz, Amt fuer Stadtplanung und Umwelt
08.08.2023 22:00;281;101;180;Leicht bewoelkt;13;14;0;Stadt Konstanz, Amt fuer Stadtplanung und Umwelt
08.08.2023 23:00;147;37;110;Leicht bewoelkt;13;13;0;Stadt Konstanz, Amt fuer Stadtplanung und Umwelt
09.08.2023 00:00;58;23;35;Bedeckt;12;12;0;Stadt Konstanz, Amt fuer Stadtplanung und Umwelt
09.08.2023 01:00;40;9;31;Bedeckt;12;13;0;Stadt Konstanz, Amt fuer Stadtplanung und Umwelt
09.08.2023 02:00;8;3;5;Leicht bewoelkt;13;13;0;Stadt Konstanz, Amt fuer Stadtplanung und Umwelt
09.08.2023 03:00;11;5;6;Bedeckt;12;12;0;Stadt Konstanz, Amt fuer Stadtplanung und Umwelt
09.08.2023 04:00;17;6;11;Bewoelkt;13;13;0;Stadt Konstanz, Amt fuer Stadtplanung und Umwelt
09.08.2023 05:00;48;31;17;Leicht bewoelkt;13;13;0;Stadt Konstanz, Amt fuer Stadtplanung und Umwelt
09.08.2023 06:00;179;92;87;Bedeckt;12;13;0;Stadt Konstanz, Amt fuer Stadtplanung und Umwelt
09.08.2023 07:00;375;214;161;Leicht bewoelkt;14;14;0;Stadt Konstanz, Amt fuer Stadtplanung und Umwelt
09.08.2023 08:00;537;324;213;Leicht bewoelkt;16;16;0;Stadt Konstanz, Amt fuer Stadtplanung und Umwelt
09.08.2023 09:00;410;212;198;Leicht bewoelkt;18;18;0;Stadt Konstanz, Amt fuer Stadtplanung und Umwelt
09.08.2023 10:00;433;252;181;Leicht bewoelkt;20;20;0;Stadt Konstanz, Amt fuer Stadtplanung und Umwelt
09.08.2023 11:00;495;249;246;Leicht bewoelkt;21;21;0;Stadt Konstanz, Amt fuer Stadtplanung und Umwelt
09.08.2023 12:00;597;304;293;Leicht bewoelkt;22;22;0;Stadt Konstanz, Amt fuer Stadtplanung und Umwelt
09.08.2023 13:00;611;310;301;Leicht bewoelkt;23;25;0;Stadt Konstanz, Amt fuer Stadtplanung und Umwelt
09.08.2023 14:00;682;367;315;Leicht bewoelkt;24;25;0;Stadt Konstanz, Amt fuer Stadtplanung und Umwelt
09.08.2023 15:00;760;368;392;Leicht bewoelkt;24;25;0;Stadt Konstanz, Amt fuer Stadtplanung und Umwelt
09.08.2023 16:00;893;450;443;Leicht bewoelkt;23;25;0;Stadt Konstanz, Amt fuer Stadtplanung und Umwelt
09.08.2023 17:00;957;460;497;Leicht bewoelkt;22;25;0;Stadt Konstanz, Amt fuer Stadtplanung und Umwelt
09.08.2023 18:00;851;395;456;Sonnig;21;21;0;Stadt Konstanz, Amt fuer Stadtplanung und Umwelt
09.08.2023 19:00;585;283;302;Sonnig;18;18;0;Stadt Konstanz, Amt fuer Stadtplanung und Umwelt
09.08.2023 20:00;420;192;228;Leicht bewoelkt;15;15;0;Stadt Konstanz, Amt fuer Stadtplanung und Umwelt
09.08.2023 21:00;310;134;176;Leicht bewoelkt;14;13;0;Stadt Konstanz, Amt fuer Stadtplanung und Umwelt
09.08.2023 22:00;322;83;239;Leicht bewoelkt;13;12;0;Stadt Konstanz, Amt fuer Stadtplanung und Umwelt
09.08.2023 23:00;226;52;174;Leicht bewoelkt;12;12;0;Stadt Konstanz, Amt fuer Stadtplanung und Umwelt
10.08.2023 00:00;130;24;106;Leicht bewoelkt;12;13;0;Stadt Konstanz, Amt fuer Stadtplanung und Umwelt
10.08.2023 01:00;58;13;45;Leicht bewoelkt;12;12;0;Stadt Konstanz, Amt fuer Stadtplanung und Umwelt
10.08.2023 02:00;15;4;11;Leicht bewoelkt;11;12;0;Stadt Konstanz, Amt fuer Stadtplanung und Umwelt
10.08.2023 03:00;14;6;8;Leicht bewoelkt;11;11;0;Stadt Konstanz, Amt fuer Stadtplanung und Umwelt
10.08.2023 04:00;9;8;1;Leichter Nebel;11;11;0;Stadt Konstanz, Amt fuer Stadtplanung und Umwelt
10.08.2023 05:00;51;36;15;Leichter Nebel;11;11;0;Stadt Konstanz, Amt fuer Stadtplanung und Umwelt
10.08.2023 06:00;188;105;83;Sonnig;11;11;0;Stadt Konstanz, Amt fuer Stadtplanung und Umwelt
10.08.2023 07:00;393;224;169;Sonnig;15;15;0;Stadt Konstanz, Amt fuer Stadtplanung und Umwelt
10.08.2023 08:00;557;317;240;Sonnig;17;17;0;Stadt Konstanz, Amt fuer Stadtplanung und Umwelt
10.08.2023 09:00;588;345;243;Sonnig;20;20;0;Stadt Konstanz, Amt fuer Stadtplanung und Umwelt
10.08.2023 10:00;635;346;289;Sonnig;22;22;0;Stadt Konstanz, Amt fuer Stadtplanung und Umwelt
10.08.2023 11:00;775;417;358;Sonnig;24;25;0;Stadt Konstanz, Amt fuer Stadtplanung und Umwelt
10.08.2023 12:00;785;366;419;Sonnig;25;26;0;Stadt Konstanz, Amt fuer Stadtplanung und Umwelt
10.08.2023 13:00;769;374;395;Sonnig;27;27;0;Stadt Konstanz, Amt fuer Stadtplanung und Umwelt
10.08.2023 14:00;770;419;351;Sonnig;27;27;0;Stadt Konstanz, Amt fuer Stadtplanung und Umwelt
10.08.2023 15:00;853;425;428;Sonnig;27;27;0;Stadt Konstanz, Amt fuer Stadtplanung und Umwelt
10.08.2023 16:00;1008;493;515;Sonnig;27;27;0;Stadt Konstanz, Amt fuer Stadtplanung und Umwelt
10.08.2023 17:00;1076;502;574;Sonnig;26;27;0;Stadt Konstanz, Amt fuer Stadtplanung und Umwelt
10.08.2023 18:00;980;416;564;Sonnig;25;26;0;Stadt Konstanz, Amt fuer Stadtplanung und Umwelt
10.08.2023 19:00;776;378;398;Sonnig;21;21;0;Stadt Konstanz, Amt fuer Stadtplanung und Umwelt
10.08.2023 20:00;578;284;294;Sonnig;18;18;0;Stadt Konstanz, Amt fuer Stadtplanung und Umwelt
10.08.2023 21:00;453;197;256;Sonnig;16;16;0;Stadt Konstanz, Amt fuer Stadtplanung und Umwelt
10.08.2023 22:00;402;135;267;Sonnig;16;16;0;Stadt Konstanz, Amt fuer Stadtplanung und Umwelt
10.08.2023 23:00;240;50;190;Sonnig;15;15;0;Stadt Konstanz, Amt fuer Stadtplanung und Umwelt
11.08.2023 00:00;165;31;134;Sonnig;14;14;0;Stadt Konstanz, Amt fuer Stadtplanung und Umwelt
11.08.2023 01:00;80;12;68;Sonnig;13;14;0;Stadt Konstanz, Amt fuer Stadtplanung und Umwelt
11.08.2023 02:00;26;6;20;Sonnig;13;13;0;Stadt Konstanz, Amt fuer Stadtplanung und Umwelt
11.08.2023 03:00;14;4;10;Sonnig;12;13;0;Stadt Konstanz, Amt fuer Stadtplanung und Umwelt
11.08.2023 04:00;14;8;6;Leicht bewoelkt;12;12;0;Stadt Konstanz, Amt fuer Stadtplanung und Umwelt
11.08.2023 05:00;43;33;10;Sonnig;12;12;0;Stadt Konstanz, Amt fuer Stadtplanung und Umwelt
11.08.2023 06:00;175;99;76;Sonnig;12;13;0;Stadt Konstanz, Amt fuer Stadtplanung und Umwelt
11.08.2023 07:00;343;186;157;Sonnig;16;16;0;Stadt Konstanz, Amt fuer Stadtplanung und Umwelt
11.08.2023 08:00;586;357;229;Sonnig;19;19;0;Stadt Konstanz, Amt fuer Stadtplanung und Umwelt
11.08.2023 09:00;667;395;272;Sonnig;21;21;0;Stadt Konstanz, Amt fuer Stadtplanung und Umwelt
11.08.2023 10:00;740;389;351;Sonnig;24;25;0;Stadt Konstanz, Amt fuer Stadtplanung und Umwelt
11.08.2023 11:00;809;395;414;Sonnig;26;27;0;Stadt Konstanz, Amt fuer Stadtplanung und Umwelt
11.08.2023 12:00;880;416;464;Sonnig;28;28;0;Stadt Konstanz, Amt fuer Stadtplanung und Umwelt
11.08.2023 13:00;849;351;498;Sonnig;29;29;0;Stadt Konstanz, Amt fuer Stadtplanung und Umwelt
11.08.2023 14:00;857;427;430;Sonnig;29;29;0;Stadt Konstanz, Amt fuer Stadtplanung und Umwelt
11.08.2023 15:00;792;418;374;Sonnig;29;29;0;Stadt Konstanz, Amt fuer Stadtplanung und Umwelt
11.08.2023 16:00;816;411;405;Sonnig;29;29;0;Stadt Konstanz, Amt fuer Stadtplanung und Umwelt
11.08.2023 17:00;888;434;454;Sonnig;29;29;0;Stadt Konstanz, Amt fuer Stadtplanung und Umwelt
11.08.2023 18:00;796;423;373;Sonnig;27;28;0;Stadt Konstanz, Amt fuer Stadtplanung und Umwelt
11.08.2023 19:00;736;406;330;Sonnig;23;25;0;Stadt Konstanz, Amt fuer Stadtplanung und Umwelt
11.08.2023 20:00;599;298;301;Sonnig;20;20;0;Stadt Konstanz, Amt fuer Stadtplanung und Umwelt
11.08.2023 21:00;485;215;270;Sonnig;19;19;0;Stadt Konstanz, Amt fuer Stadtplanung und Umwelt
11.08.2023 22:00;373;137;236;Sonnig;18;18;0;Stadt Konstanz, Amt fuer Stadtplanung und Umwelt
11.08.2023 23:00;376;90;286;Sonnig;17;17;0;Stadt Konstanz, Amt fuer Stadtplanung und Umwelt
12.08.2023 00:00;313;73;240;Sonnig;17;17;0;Stadt Konstanz, Amt fuer Stadtplanung und Umwelt
12.08.2023 01:00;148;32;116;Sonnig;16;16;0;Stadt Konstanz, Amt fuer Stadtplanung und Umwelt
12.08.2023 02:00;85;10;75;Sonnig;15;15;0;Stadt Konstanz, Amt fuer Stadtplanung und Umwelt
12.08.2023 03:00;40;8;32;Sonnig;15;15;0;Stadt Konstanz, Amt fuer Stadtplanung und Umwelt
12.08.2023 04:00;32;12;20;Leicht bewoelkt;15;15;0;Stadt Konstanz, Amt fuer Stadtplanung und Umwelt
12.08.2023 05:00;34;20;14;Leicht bewoelkt;14;14;0;Stadt Konstanz, Amt fuer Stadtplanung und Umwelt
12.08.2023 06:00;66;39;27;Sonnig;15;15;0;Stadt Konstanz, Amt fuer Stadtplanung und Umwelt
12.08.2023 07:00;117;59;58;Sonnig;18;18;0;Stadt Konstanz, Amt fuer Stadtplanung und Umwelt
12.08.2023 08:00;268;151;117;Sonnig;20;20;0;Stadt Konstanz, Amt fuer Stadtplanung und Umwelt
12.08.2023 09:00;450;260;190;Sonnig;22;22;0;Stadt Konstanz, Amt fuer Stadtplanung und Umwelt
12.08.2023 10:00;632;372;260;Sonnig;26;27;0;Stadt Konstanz, Amt fuer Stadtplanung und Umwelt
12.08.2023 11:00;744;384;360;Sonnig;27;28;0;Stadt Konstanz, Amt fuer Stadtplanung und Umwelt
12.08.2023 12:00;759;412;347;Sonnig;29;30;0;Stadt Konstanz, Amt fuer Stadtplanung und Umwelt
12.08.2023 13:00;794;393;401;Sonnig;31;31;0;Stadt Konstanz, Amt fuer Stadtplanung und Umwelt
12.08.2023 14:00;807;401;406;Sonnig;31;31;0;Stadt Konstanz, Amt fuer Stadtplanung und Umwelt
12.08.2023 15:00;896;395;501;Sonnig;31;32;0;Stadt Konstanz, Amt fuer Stadtplanung und Umwelt
12.08.2023 16:00;1018;427;591;Sonnig;31;31;0;Stadt Konstanz, Amt fuer Stadtplanung und Umwelt
12.08.2023 17:00;1044;497;547;Sonnig;30;31;0;Stadt Konstanz, Amt fuer Stadtplanung und Umwelt
12.08.2023 18:00;991;494;497;Sonnig;27;28;0;Stadt Konstanz, Amt fuer Stadtplanung und Umwelt
12.08.2023 19:00;745;345;400;Sonnig;23;25;0;Stadt Konstanz, Amt fuer Stadtplanung und Umwelt
12.08.2023 20:00;761;328;433;Stellenweiser Regenfall;20;20;1.1;Stadt Konstanz, Amt fuer Stadtplanung und Umwelt
12.08.2023 21:00;652;265;387;Stellenweiser Regenfall;18;18;1.2;Stadt Konstanz, Amt fuer Stadtplanung und Umwelt
12.08.2023 22:00;334;137;197;Maeßiger bis starker Regenschauer;18;18;2.7;Stadt Konstanz, Amt fuer Stadtplanung und Umwelt
12.08.2023 23:00;951;504;447;Stellenweiser Regenfall;17;17;0.6;Stadt Konstanz, Amt fuer Stadtplanung und Umwelt
13.08.2023 00:00;525;242;283;Sonnig;16;16;0;Stadt Konstanz, Amt fuer Stadtplanung und Umwelt
13.08.2023 01:00;312;96;216;Sonnig;16;16;0;Stadt Konstanz, Amt fuer Stadtplanung und Umwelt
13.08.2023 02:00;191;47;144;Sonnig;16;16;0;Stadt Konstanz, Amt fuer Stadtplanung und Umwelt
13.08.2023 03:00;129;33;96;Sonnig;15;15;0;Stadt Konstanz, Amt fuer Stadtplanung und Umwelt
13.08.2023 04:00;49;19;30;Sonnig;15;15;0;Stadt Konstanz, Amt fuer Stadtplanung und Umwelt
13.08.2023 05:00;49;31;18;Sonnig;15;15;0;Stadt Konstanz, Amt fuer Stadtplanung und Umwelt
13.08.2023 06:00;47;29;18;Sonnig;16;16;0;Stadt Konstanz, Amt fuer Stadtplanung und Umwelt
13.08.2023 07:00;61;35;26;Sonnig;18;18;0;Stadt Konstanz, Amt fuer Stadtplanung und Umwelt
13.08.2023 08:00;97;50;47;Sonnig;20;20;0;Stadt Konstanz, Amt fuer Stadtplanung und Umwelt
13.08.2023 09:00;294;158;136;Leicht bewoelkt;22;22;0;Stadt Konstanz, Amt fuer Stadtplanung und Umwelt
13.08.2023 10:00;383;207;176;Sonnig;24;25;0;Stadt Konstanz, Amt fuer Stadtplanung und Umwelt
13.08.2023 11:00;528;257;271;Sonnig;26;27;0;Stadt Konstanz, Amt fuer Stadtplanung und Umwelt
13.08.2023 12:00;562;261;301;Sonnig;28;28;0;Stadt Konstanz, Amt fuer Stadtplanung und Umwelt
13.08.2023 13:00;525;224;301;Sonnig;29;29;0;Stadt Konstanz, Amt fuer Stadtplanung und Umwelt
13.08.2023 14:00;595;299;296;Stellenweiser Regenfall;29;30;0.1;Stadt Konstanz, Amt fuer Stadtplanung und Umwelt
13.08.2023 15:00;565;270;295;Leicht bewoelkt;29;30;0;Stadt Konstanz, Amt fuer Stadtplanung und Umwelt
13.08.2023 16:00;641;330;311;Stellenweiser Regenfall;29;30;0.1;Stadt Konstanz, Amt fuer Stadtplanung und Umwelt
13.08.2023 17:00;580;298;282;Leicht bewoelkt;29;30;0;Stadt Konstanz, Amt fuer Stadtplanung und Umwelt
13.08.2023 18:00;513;243;270;Sonnig;27;29;0;Stadt Konstanz, Amt fuer Stadtplanung und Umwelt
13.08.2023 19:00;278;131;147;Sonnig;24;26;0;Stadt Konstanz, Amt fuer Stadtplanung und Umwelt
13.08.2023 20:00;294;123;171;Stellenweiser Regenfall;21;21;0.1;Stadt Konstanz, Amt fuer Stadtplanung und Umwelt
13.08.2023 21:00;220;100;120;Sonnig;19;19;0;Stadt Konstanz, Amt fuer Stadtplanung und Umwelt
13.08.2023 22:00;139;51;88;Stellenweiser Regenfall;18;18;1.7;Stadt Konstanz, Amt fuer Stadtplanung und Umwelt
13.08.2023 23:00;87;38;49;Leichter Nebel;18;18;0;Stadt Konstanz, Amt fuer Stadtplanung und Umwelt
14.08.2023 00:00;52;26;26;Stellenweiser Regenfall;19;19;0.6;Stadt Konstanz, Amt fuer Stadtplanung und Umwelt
14.08.2023 01:00;18;4;14;Leichter Nebel;19;19;0;Stadt Konstanz, Amt fuer Stadtplanung und Umwelt
14.08.2023 02:00;14;7;7;Nebel;18;18;0;Stadt Konstanz, Amt fuer Stadtplanung und Umwelt
14.08.2023 03:00;6;2;4;Nebel;18;18;0;Stadt Konstanz, Amt fuer Stadtplanung und Umwelt
14.08.2023 04:00;9;6;3;Leichter Nebel;18;18;0;Stadt Konstanz, Amt fuer Stadtplanung und Umwelt
14.08.2023 05:00;43;30;13;Nebel;17;17;0;Stadt Konstanz, Amt fuer Stadtplanung und Umwelt
14.08.2023 06:00;182;107;75;Leichter Nebel;17;17;0;Stadt Konstanz, Amt fuer Stadtplanung und Umwelt
14.08.2023 07:00;330;190;140;Leicht bewoelkt;20;20;0;Stadt Konstanz, Amt fuer Stadtplanung und Umwelt
14.08.2023 08:00;517;292;225;Leicht bewoelkt;21;21;0;Stadt Konstanz, Amt fuer Stadtplanung und Umwelt
14.08.2023 09:00;577;284;293;Sonnig;23;25;0;Stadt Konstanz, Amt fuer Stadtplanung und Umwelt
14.08.2023 10:00;643;352;291;Sonnig;26;28;0;Stadt Konstanz, Amt fuer Stadtplanung und Umwelt
14.08.2023 11:00;645;321;324;Sonnig;28;29;0;Stadt Konstanz, Amt fuer Stadtplanung und Umwelt
14.08.2023 12:00;711;312;399;Sonnig;29;30;0;Stadt Konstanz, Amt fuer Stadtplanung und Umwelt
14.08.2023 13:00;660;337;323;Sonnig;30;31;0;Stadt Konstanz, Amt fuer Stadtplanung und Umwelt
14.08.2023 14:00;715;368;347;Sonnig;31;32;0;Stadt Konstanz, Amt fuer Stadtplanung und Umwelt
14.08.2023 15:00;720;364;356;Sonnig;32;33;0;Stadt Konstanz, Amt fuer Stadtplanung und Umwelt
14.08.2023 16:00;787;398;389;Sonnig;31;32;0;Stadt Konstanz, Amt fuer Stadtplanung und Umwelt
14.08.2023 17:00;969;466;503;Sonnig;31;32;0;Stadt Konstanz, Amt fuer Stadtplanung und Umwelt
14.08.2023 18:00;833;406;427;Sonnig;28;29;0;Stadt Konstanz, Amt fuer Stadtplanung und Umwelt
14.08.2023 19:00;678;314;364;Stellenweiser Regenfall;21;21;0.2;Stadt Konstanz, Amt fuer Stadtplanung und Umwelt
14.08.2023 20:00;524;228;296;Stellenweiser Regenfall;18;18;0.1;Stadt Konstanz, Amt fuer Stadtplanung und Umwelt
14.08.2023 21:00;367;146;221;Sonnig;17;17;0;Stadt Konstanz, Amt fuer Stadtplanung und Umwelt
14.08.2023 22:00;273;103;170;Stellenweiser Regenfall;16;16;0.2;Stadt Konstanz, Amt fuer Stadtplanung und Umwelt
14.08.2023 23:00;126;39;87;Sonnig;16;16;0;Stadt Konstanz, Amt fuer Stadtplanung und Umwelt
15.08.2023 00:00;83;31;52;Stellenweiser Regenfall;17;17;0.3;Stadt Konstanz, Amt fuer Stadtplanung und Umwelt
15.08.2023 01:00;42;13;29;Stellenweiser Regenfall;17;17;1.5;Stadt Konstanz, Amt fuer Stadtplanung und Umwelt
15.08.2023 02:00;18;8;10;Sonnig;17;17;0;Stadt Konstanz, Amt fuer Stadtplanung und Umwelt
15.08.2023 03:00;9;4;5;Sonnig;16;16;0;Stadt Konstanz, Amt fuer Stadtplanung und Umwelt
15.08.2023 04:00;13;8;5;Leichter Nebel;16;16;0;Stadt Konstanz, Amt fuer Stadtplanung und Umwelt
15.08.2023 05:00;47;30;17;Leichter Nebel;16;16;0.1;Stadt Konstanz, Amt fuer Stadtplanung und Umwelt
15.08.2023 06:00;200;115;85;Leichter Nebel;16;16;0.1;Stadt Konstanz, Amt fuer Stadtplanung und Umwelt
15.08.2023 07:00;393;229;164;Stellenweiser Regenfall;18;18;0.6;Stadt Konstanz, Amt fuer Stadtplanung und Umwelt
15.08.2023 08:00;502;283;219;Stellenweiser Regenfall;19;19;0.1;Stadt Konstanz, Amt fuer Stadtplanung und Umwelt
15.08.2023 09:00;543;310;233;Leicht bewoelkt;21;21;0;Stadt Konstanz, Amt fuer Stadtplanung und Umwelt
15.08.2023 10:00;652;362;290;Stellenweiser Regenfall;22;25;0.1;Stadt Konstanz, Amt fuer Stadtplanung und Umwelt
15.08.2023 11:00;699;358;341;Sonnig;22;25;0;Stadt Konstanz, Amt fuer Stadtplanung und Umwelt
15.08.2023 12:00;689;337;352;Sonnig;25;26;0;Stadt Konstanz, Amt fuer Stadtplanung und Umwelt
15.08.2023 13:00;709;370;339;Stellenweiser Regenfall;27;28;0.1;Stadt Konstanz, Amt fuer Stadtplanung und Umwelt
15.08.2023 14:00;719;341;378;Sonnig;28;29;0;Stadt Konstanz, Amt fuer Stadtplanung und Umwelt
15.08.2023 15:00;775;397;378;Sonnig;29;30;0;Stadt Konstanz, Amt fuer Stadtplanung und Umwelt
15.08.2023 16:00;882;417;465;Stellenweise Gewitter und Niederschlaege;29;30;0;Stadt Konstanz, Amt fuer Stadtplanung und Umwelt
15.08.2023 17:00;921;469;452;Sonnig;29;30;0;Stadt Konstanz, Amt fuer Stadtplanung und Umwelt
15.08.2023 18:00;962;430;532;Sonnig;27;29;0;Stadt Konstanz, Amt fuer Stadtplanung und Umwelt
15.08.2023 19:00;630;287;343;Stellenweise Gewitter und Niederschlaege;23;25;0;Stadt Konstanz, Amt fuer Stadtplanung und Umwelt
15.08.2023 20:00;523;263;260;Stellenweiser Regenfall;20;20;0.6;Stadt Konstanz, Amt fuer Stadtplanung und Umwelt
15.08.2023 21:00;425;178;247;Sonnig;18;18;0;Stadt Konstanz, Amt fuer Stadtplanung und Umwelt
15.08.2023 22:00;315;119;196;Stellenweiser Regenfall;18;18;0.8;Stadt Konstanz, Amt fuer Stadtplanung und Umwelt
15.08.2023 23:00;179;43;136;Sonnig;17;17;0;Stadt Konstanz, Amt fuer Stadtplanung und Umwelt
16.08.2023 00:00;77;23;54;Stellenweiser Regenfall;17;17;0.2;Stadt Konstanz, Amt fuer Stadtplanung und Umwelt
16.08.2023 01:00;43;13;30;Stellenweiser Regenfall;17;17;0.3;Stadt Konstanz, Amt fuer Stadtplanung und Umwelt
16.08.2023 02:00;13;7;6;Leichter Nebel;17;17;0;Stadt Konstanz, Amt fuer Stadtplanung und Umwelt
16.08.2023 03:00;8;4;4;Leichter Nebel;16;16;0;Stadt Konstanz, Amt fuer Stadtplanung und Umwelt
16.08.2023 04:00;10;5;5;Leichter Nebel;16;16;0;Stadt Konstanz, Amt fuer Stadtplanung und Umwelt
16.08.2023 05:00;54;36;18;Leichter Nebel;16;16;0;Stadt Konstanz, Amt fuer Stadtplanung und Umwelt
16.08.2023 06:00;188;96;92;Leichter Nebel;16;16;0;Stadt Konstanz, Amt fuer Stadtplanung und Umwelt
16.08.2023 07:00;386;215;171;Leicht bewoelkt;18;18;0;Stadt Konstanz, Amt fuer Stadtplanung und Umwelt
16.08.2023 08:00;525;275;250;Sonnig;21;21;0;Stadt Konstanz, Amt fuer Stadtplanung und Umwelt
16.08.2023 09:00;655;361;294;Sonnig;23;25;0;Stadt Konstanz, Amt fuer Stadtplanung und Umwelt
16.08.2023 10:00;604;321;283;Sonnig;26;27;0;Stadt Konstanz, Amt fuer Stadtplanung und Umwelt
16.08.2023 11:00;678;375;303;Sonnig;28;29;0;Stadt Konstanz, Amt fuer Stadtplanung und Umwelt
16.08.2023 12:00;636;284;352;Sonnig;30;31;0;Stadt Konstanz, Amt fuer Stadtplanung und Umwelt
16.08.2023 13:00;680;345;335;Sonnig;31;32;0;Stadt Konstanz, Amt fuer Stadtplanung und Umwelt
16.08.2023 14:00;684;343;341;Sonnig;32;33;0;Stadt Konstanz, Amt fuer Stadtplanung und Umwelt
16.08.2023 15:00;710;287;423;Sonnig;32;33;0;Stadt Konstanz, Amt fuer Stadtplanung und Umwelt
16.08.2023 16:00;858;426;432;Sonnig;31;32;0;Stadt Konstanz, Amt fuer Stadtplanung und Umwelt
16.08.2023 17:00;947;468;479;Sonnig;31;31;0;Stadt Konstanz, Amt fuer Stadtplanung und Umwelt
16.08.2023 18:00;900;450;450;Nieselregen mit Gewitter;25;26;0.2;Stadt Konstanz, Amt fuer Stadtplanung und Umwelt
16.08.2023 19:00;739;336;403;Nieselregen mit Gewitter;17;17;1.2;Stadt Konstanz, Amt fuer Stadtplanung und Umwelt
16.08.2023 20:00;557;254;303;Nieselregen mit Gewitter;16;16;0.5;Stadt Konstanz, Amt fuer Stadtplanung und Umwelt
16.08.2023 21:00;482;202;280;Stellenweiser Regenfall;16;16;0.1;Stadt Konstanz, Amt fuer Stadtplanung und Umwelt
16.08.2023 22:00;273;97;176;Nieselregen mit Gewitter;16;16;0.6;Stadt Konstanz, Amt fuer Stadtplanung und Umwelt
16.08.2023 23:00;182;62;120;Sonnig;16;16;0;Stadt Konstanz, Amt fuer Stadtplanung und Umwelt
17.08.2023 00:00;73;22;51;Stellenweiser Regenfall;18;18;0.1;Stadt Konstanz, Amt fuer Stadtplanung und Umwelt
17.08.2023 01:00;40;11;29;Sonnig;18;18;0;Stadt Konstanz, Amt fuer Stadtplanung und Umwelt
17.08.2023 02:00;37;14;23;Nieselregen mit Gewitter;17;17;0.4;Stadt Konstanz, Amt fuer Stadtplanung und Umwelt
17.08.2023 03:00;9;3;6;Nieselregen mit Gewitter;17;17;0.2;Stadt Konstanz, Amt fuer Stadtplanung und Umwelt
17.08.2023 04:00;22;12;10;Nieselregen mit Gewitter;16;16;1.8;Stadt Konstanz, Amt fuer Stadtplanung und Umwelt
17.08.2023 05:00;53;36;17;Nieselregen mit Gewitter;16;16;0.5;Stadt Konstanz, Amt fuer Stadtplanung und Umwelt
17.08.2023 06:00;187;99;88;Nieselregen mit Gewitter;17;17;0.5;Stadt Konstanz, Amt fuer Stadtplanung und Umwelt
17.08.2023 07:00;374;205;169;Leichter Regenschauer;18;18;1.6;Stadt Konstanz, Amt fuer Stadtplanung und Umwelt
17.08.2023 08:00;534;318;216;Stellenweise Gewitter und Niederschlaege;20;20;0;Stadt Konstanz, Amt fuer Stadtplanung und Umwelt
17.08.2023 09:00;624;347;277;Bewoelkt;21;21;0;Stadt Konstanz, Amt fuer Stadtplanung und Umwelt
17.08.2023 10:00;642;339;303;Leicht bewoelkt;23;25;0;Stadt Konstanz, Amt fuer Stadtplanung und Umwelt
17.08.2023 11:00;662;337;325;Sonnig;25;27;0;Stadt Konstanz, Amt fuer Stadtplanung und Umwelt
17.08.2023 12:00;708;318;390;Sonnig;26;28;0;Stadt Konstanz, Amt fuer Stadtplanung und Umwelt
17.08.2023 13:00;579;252;327;Sonnig;29;30;0;Stadt Konstanz, Amt fuer Stadtplanung und Umwelt
17.08.2023 14:00;700;338;362;Sonnig;30;31;0;Stadt Konstanz, Amt fuer Stadtplanung und Umwelt
17.08.2023 15:00;660;330;330;Sonnig;31;31;0;Stadt Konstanz, Amt fuer Stadtplanung und Umwelt
17.08.2023 16:00;769;392;377;Sonnig;30;31;0;Stadt Konstanz, Amt fuer Stadtplanung und Umwelt
17.08.2023 17:00;915;428;487;Stellenweise Gewitter und Niederschlaege;30;30;0;Stadt Konstanz, Amt fuer Stadtplanung und Umwelt
17.08.2023 18:00;762;326;436;Stellenweiser Regenfall;26;27;0.1;Stadt Konstanz, Amt fuer Stadtplanung und Umwelt
17.08.2023 19:00;564;266;298;Maeßiger bis starker Regenschauer;16;16;4.4;Stadt Konstanz, Amt fuer Stadtplanung und Umwelt
17.08.2023 20:00;496;187;309;Maeßiger bis starker Regenschauer;16;16;3.6;Stadt Konstanz, Amt fuer Stadtplanung und Umwelt
17.08.2023 21:00;342;142;200;Maeßiger bis starker Regenschauer;16;16;2.6;Stadt Konstanz, Amt fuer Stadtplanung und Umwelt
17.08.2023 22:00;308;120;188;Maeßiger bis starker Regenschauer;16;16;6;Stadt Konstanz, Amt fuer Stadtplanung und Umwelt
17.08.2023 23:00;178;74;104;Stellenweiser Regenfall;16;16;1.1;Stadt Konstanz, Amt fuer Stadtplanung und Umwelt
18.08.2023 00:00;91;39;52;Leichter Nebel;15;15;0;Stadt Konstanz, Amt fuer Stadtplanung und Umwelt
18.08.2023 01:00;56;18;38;Leichter Nebel;14;15;0;Stadt Konstanz, Amt fuer Stadtplanung und Umwelt
18.08.2023 02:00;34;14;20;Bewoelkt;14;14;0;Stadt Konstanz, Amt fuer Stadtplanung und Umwelt
18.08.2023 03:00;3;1;2;Leicht bewoelkt;14;14;0;Stadt Konstanz, Amt fuer Stadtplanung und Umwelt
18.08.2023 04:00;10;7;3;Sonnig;14;14;0;Stadt Konstanz, Amt fuer Stadtplanung und Umwelt
18.08.2023 05:00;51;32;19;Sonnig;14;15;0;Stadt Konstanz, Amt fuer Stadtplanung und Umwelt
18.08.2023 06:00;166;89;77;Sonnig;14;14;0;Stadt Konstanz, Amt fuer Stadtplanung und Umwelt
18.08.2023 07:00;332;197;135;Sonnig;16;16;0;Stadt Konstanz, Amt fuer Stadtplanung und Umwelt
18.08.2023 08:00;493;295;198;Sonnig;19;19;0;Stadt Konstanz, Amt fuer Stadtplanung und Umwelt
18.08.2023 09:00;565;330;235;Sonnig;22;22;0;Stadt Konstanz, Amt fuer Stadtplanung und Umwelt
18.08.2023 10:00;0;0;0;Sonnig;24;26;0;Stadt Konstanz, Amt fuer Stadtplanung und Umwelt
18.08.2023 11:00;0;0;0;Sonnig;27;27;0;Stadt Konstanz, Amt fuer Stadtplanung und Umwelt
18.08.2023 12:00;0;0;0;Sonnig;29;29;0;Stadt Konstanz, Amt fuer Stadtplanung und Umwelt
18.08.2023 13:00;0;0;0;Sonnig;31;30;0;Stadt Konstanz, Amt fuer Stadtplanung und Umwelt
18.08.2023 14:00;0;0;0;Sonnig;31;31;0;Stadt Konstanz, Amt fuer Stadtplanung und Umwelt
18.08.2023 15:00;0;0;0;Sonnig;31;31;0;Stadt Konstanz, Amt fuer Stadtplanung und Umwelt
18.08.2023 16:00;0;0;0;Sonnig;31;31;0;Stadt Konstanz, Amt fuer Stadtplanung und Umwelt
18.08.2023 17:00;0;0;0;Sonnig;31;30;0;Stadt Konstanz, Amt fuer Stadtplanung und Umwelt
18.08.2023 18:00;0;0;0;Sonnig;27;28;0;Stadt Konstanz, Amt fuer Stadtplanung und Umwelt
18.08.2023 19:00;0;0;0;Sonnig;22;25;0;Stadt Konstanz, Amt fuer Stadtplanung und Umwelt
18.08.2023 20:00;0;0;0;Sonnig;20;20;0;Stadt Konstanz, Amt fuer Stadtplanung und Umwelt
18.08.2023 21:00;0;0;0;Sonnig;19;19;0;Stadt Konstanz, Amt fuer Stadtplanung und Umwelt
18.08.2023 22:00;0;0;0;Sonnig;18;18;0;Stadt Konstanz, Amt fuer Stadtplanung und Umwelt
18.08.2023 23:00;0;0;0;Sonnig;18;18;0;Stadt Konstanz, Amt fuer Stadtplanung und Umwelt
19.08.2023 00:00;0;0;0;Sonnig;17;17;0;Stadt Konstanz, Amt fuer Stadtplanung und Umwelt
19.08.2023 01:00;0;0;0;Sonnig;17;17;0;Stadt Konstanz, Amt fuer Stadtplanung und Umwelt
19.08.2023 02:00;0;0;0;Sonnig;16;16;0;Stadt Konstanz, Amt fuer Stadtplanung und Umwelt
19.08.2023 03:00;0;0;0;Sonnig;16;16;0;Stadt Konstanz, Amt fuer Stadtplanung und Umwelt
19.08.2023 04:00;0;0;0;Sonnig;16;16;0;Stadt Konstanz, Amt fuer Stadtplanung und Umwelt
19.08.2023 05:00;0;0;0;Sonnig;15;15;0;Stadt Konstanz, Amt fuer Stadtplanung und Umwelt
19.08.2023 06:00;0;0;0;Sonnig;16;16;0;Stadt Konstanz, Amt fuer Stadtplanung und Umwelt
19.08.2023 07:00;0;0;0;Sonnig;18;18;0;Stadt Konstanz, Amt fuer Stadtplanung und Umwelt
19.08.2023 08:00;0;0;0;Sonnig;22;22;0;Stadt Konstanz, Amt fuer Stadtplanung und Umwelt
19.08.2023 09:00;0;0;0;Sonnig;24;26;0;Stadt Konstanz, Amt fuer Stadtplanung und Umwelt
19.08.2023 10:00;0;0;0;Sonnig;27;28;0;Stadt Konstanz, Amt fuer Stadtplanung und Umwelt
19.08.2023 11:00;0;0;0;Sonnig;29;30;0;Stadt Konstanz, Amt fuer Stadtplanung und Umwelt
19.08.2023 12:00;0;0;0;Sonnig;31;32;0;Stadt Konstanz, Amt fuer Stadtplanung und Umwelt
19.08.2023 13:00;0;0;0;Sonnig;33;33;0;Stadt Konstanz, Amt fuer Stadtplanung und Umwelt
19.08.2023 14:00;0;0;0;Sonnig;34;34;0;Stadt Konstanz, Amt fuer Stadtplanung und Umwelt
19.08.2023 15:00;0;0;0;Sonnig;34;34;0;Stadt Konstanz, Amt fuer Stadtplanung und Umwelt
19.08.2023 16:00;0;0;0;Sonnig;33;33;0;Stadt Konstanz, Amt fuer Stadtplanung und Umwelt
19.08.2023 17:00;0;0;0;Sonnig;33;33;0;Stadt Konstanz, Amt fuer Stadtplanung und Umwelt
19.08.2023 18:00;0;0;0;Sonnig;29;30;0;Stadt Konstanz, Amt fuer Stadtplanung und Umwelt
19.08.2023 19:00;0;0;0;Sonnig;25;26;0;Stadt Konstanz, Amt fuer Stadtplanung und Umwelt
19.08.2023 20:00;0;0;0;Sonnig;22;25;0;Stadt Konstanz, Amt fuer Stadtplanung und Umwelt
19.08.2023 21:00;0;0;0;Sonnig;21;21;0;Stadt Konstanz, Amt fuer Stadtplanung und Umwelt
19.08.2023 22:00;0;0;0;Sonnig;20;20;0;Stadt Konstanz, Amt fuer Stadtplanung und Umwelt
19.08.2023 23:00;0;0;0;Sonnig;20;20;0;Stadt Konstanz, Amt fuer Stadtplanung und Umwelt
20.08.2023 00:00;0;0;0;Sonnig;19;19;0;Stadt Konstanz, Amt fuer Stadtplanung und Umwelt
20.08.2023 01:00;0;0;0;Sonnig;18;18;0;Stadt Konstanz, Amt fuer Stadtplanung und Umwelt
20.08.2023 02:00;0;0;0;Sonnig;18;18;0;Stadt Konstanz, Amt fuer Stadtplanung und Umwelt
20.08.2023 03:00;0;0;0;Sonnig;17;17;0;Stadt Konstanz, Amt fuer Stadtplanung und Umwelt
20.08.2023 04:00;0;0;0;Sonnig;17;17;0;Stadt Konstanz, Amt fuer Stadtplanung und Umwelt
20.08.2023 05:00;0;0;0;Sonnig;17;16;0;Stadt Konstanz, Amt fuer Stadtplanung und Umwelt
20.08.2023 06:00;0;0;0;Sonnig;17;17;0;Stadt Konstanz, Amt fuer Stadtplanung und Umwelt
20.08.2023 07:00;0;0;0;Sonnig;19;19;0;Stadt Konstanz, Amt fuer Stadtplanung und Umwelt
20.08.2023 08:00;0;0;0;Sonnig;22;25;0;Stadt Konstanz, Amt fuer Stadtplanung und Umwelt
20.08.2023 09:00;0;0;0;Sonnig;25;26;0;Stadt Konstanz, Amt fuer Stadtplanung und Umwelt
20.08.2023 10:00;0;0;0;Sonnig;28;28;0;Stadt Konstanz, Amt fuer Stadtplanung und Umwelt
20.08.2023 11:00;0;0;0;Sonnig;30;31;0;Stadt Konstanz, Amt fuer Stadtplanung und Umwelt
20.08.2023 12:00;0;0;0;Sonnig;32;32;0;Stadt Konstanz, Amt fuer Stadtplanung und Umwelt
20.08.2023 13:00;0;0;0;Sonnig;33;33;0;Stadt Konstanz, Amt fuer Stadtplanung und Umwelt
20.08.2023 14:00;0;0;0;Sonnig;34;33;0;Stadt Konstanz, Amt fuer Stadtplanung und Umwelt
20.08.2023 15:00;0;0;0;Sonnig;34;33;0;Stadt Konstanz, Amt fuer Stadtplanung und Umwelt
20.08.2023 16:00;0;0;0;Sonnig;33;33;0;Stadt Konstanz, Amt fuer Stadtplanung und Umwelt
20.08.2023 17:00;0;0;0;Sonnig;33;33;0;Stadt Konstanz, Amt fuer Stadtplanung und Umwelt
20.08.2023 18:00;0;0;0;Sonnig;29;30;0;Stadt Konstanz, Amt fuer Stadtplanung und Umwelt
20.08.2023 19:00;0;0;0;Sonnig;24;26;0;Stadt Konstanz, Amt fuer Stadtplanung und Umwelt
20.08.2023 20:00;0;0;0;Sonnig;22;25;0;Stadt Konstanz, Amt fuer Stadtplanung und Umwelt
20.08.2023 21:00;0;0;0;Sonnig;21;21;0;Stadt Konstanz, Amt fuer Stadtplanung und Umwelt
20.08.2023 22:00;0;0;0;Sonnig;21;21;0;Stadt Konstanz, Amt fuer Stadtplanung und Umwelt
20.08.2023 23:00;0;0;0;Sonnig;20;20;0;Stadt Konstanz, Amt fuer Stadtplanung und Umwelt
21.08.2023 00:00;0;0;0;Sonnig;19;19;0;Stadt Konstanz, Amt fuer Stadtplanung und Umwelt
21.08.2023 01:00;0;0;0;Sonnig;19;19;0;Stadt Konstanz, Amt fuer Stadtplanung und Umwelt
21.08.2023 02:00;0;0;0;Sonnig;18;18;0;Stadt Konstanz, Amt fuer Stadtplanung und Umwelt
21.08.2023 03:00;0;0;0;Sonnig;18;18;0;Stadt Konstanz, Amt fuer Stadtplanung und Umwelt
21.08.2023 04:00;0;0;0;Leichter Nebel;18;18;0;Stadt Konstanz, Amt fuer Stadtplanung und Umwelt
21.08.2023 05:00;0;0;0;Leichter Nebel;18;18;0;Stadt Konstanz, Amt fuer Stadtplanung und Umwelt
21.08.2023 06:00;0;0;0;Leichter Nebel;18;18;0;Stadt Konstanz, Amt fuer Stadtplanung und Umwelt
21.08.2023 07:00;0;0;0;Sonnig;20;20;0;Stadt Konstanz, Amt fuer Stadtplanung und Umwelt
21.08.2023 08:00;0;0;0;Sonnig;23;25;0;Stadt Konstanz, Amt fuer Stadtplanung und Umwelt
21.08.2023 09:00;0;0;0;Sonnig;26;27;0;Stadt Konstanz, Amt fuer Stadtplanung und Umwelt
21.08.2023 10:00;0;0;0;Sonnig;28;30;0;Stadt Konstanz, Amt fuer Stadtplanung und Umwelt
21.08.2023 11:00;0;0;0;Sonnig;30;32;0;Stadt Konstanz, Amt fuer Stadtplanung und Umwelt
21.08.2023 12:00;0;0;0;Sonnig;32;34;0;Stadt Konstanz, Amt fuer Stadtplanung und Umwelt
21.08.2023 13:00;0;0;0;Sonnig;33;35;0;Stadt Konstanz, Amt fuer Stadtplanung und Umwelt
21.08.2023 14:00;0;0;0;Sonnig;33;35;0;Stadt Konstanz, Amt fuer Stadtplanung und Umwelt
21.08.2023 15:00;0;0;0;Sonnig;33;34;0;Stadt Konstanz, Amt fuer Stadtplanung und Umwelt
21.08.2023 16:00;0;0;0;Sonnig;33;34;0;Stadt Konstanz, Amt fuer Stadtplanung und Umwelt
21.08.2023 17:00;0;0;0;Leicht bewoelkt;31;32;0;Stadt Konstanz, Amt fuer Stadtplanung und Umwelt
21.08.2023 18:00;0;0;0;Leicht bewoelkt;28;29;0;Stadt Konstanz, Amt fuer Stadtplanung und Umwelt
21.08.2023 19:00;0;0;0;Sonnig;25;27;0;Stadt Konstanz, Amt fuer Stadtplanung und Umwelt
21.08.2023 20:00;0;0;0;Sonnig;23;25;0;Stadt Konstanz, Amt fuer Stadtplanung und Umwelt
21.08.2023 21:00;0;0;0;Sonnig;22;22;0;Stadt Konstanz, Amt fuer Stadtplanung und Umwelt
21.08.2023 22:00;0;0;0;Sonnig;21;21;0;Stadt Konstanz, Amt fuer Stadtplanung und Umwelt
21.08.2023 23:00;0;0;0;Sonnig;21;21;0;Stadt Konstanz, Amt fuer Stadtplanung und Umwelt
22.08.2023 00:00;0;0;0;Sonnig;20;20;0;Stadt Konstanz, Amt fuer Stadtplanung und Umwelt
22.08.2023 01:00;0;0;0;Sonnig;19;19;0;Stadt Konstanz, Amt fuer Stadtplanung und Umwelt
22.08.2023 02:00;0;0;0;Sonnig;19;19;0;Stadt Konstanz, Amt fuer Stadtplanung und Umwelt
22.08.2023 03:00;0;0;0;Sonnig;19;19;0;Stadt Konstanz, Amt fuer Stadtplanung und Umwelt
22.08.2023 04:00;0;0;0;Sonnig;18;18;0;Stadt Konstanz, Amt fuer Stadtplanung und Umwelt
22.08.2023 05:00;0;0;0;Leichter Nebel;18;18;0;Stadt Konstanz, Amt fuer Stadtplanung und Umwelt
22.08.2023 06:00;0;0;0;Sonnig;18;18;0;Stadt Konstanz, Amt fuer Stadtplanung und Umwelt
22.08.2023 07:00;0;0;0;Sonnig;21;21;0;Stadt Konstanz, Amt fuer Stadtplanung und Umwelt
22.08.2023 08:00;0;0;0;Sonnig;24;26;0;Stadt Konstanz, Amt fuer Stadtplanung und Umwelt
22.08.2023 09:00;0;0;0;Sonnig;26;28;0;Stadt Konstanz, Amt fuer Stadtplanung und Umwelt
22.08.2023 10:00;0;0;0;Sonnig;29;30;0;Stadt Konstanz, Amt fuer Stadtplanung und Umwelt
22.08.2023 11:00;459;216;243;Sonnig;31;33;0;Stadt Konstanz, Amt fuer Stadtplanung und Umwelt
22.08.2023 12:00;730;310;420;Sonnig;32;34;0;Stadt Konstanz, Amt fuer Stadtplanung und Umwelt
22.08.2023 13:00;631;274;357;Sonnig;33;35;0;Stadt Konstanz, Amt fuer Stadtplanung und Umwelt
22.08.2023 14:00;633;302;331;Sonnig;33;35;0;Stadt Konstanz, Amt fuer Stadtplanung und Umwelt
22.08.2023 15:00;778;394;384;Sonnig;34;35;0;Stadt Konstanz, Amt fuer Stadtplanung und Umwelt
22.08.2023 16:00;836;423;413;Sonnig;33;35;0;Stadt Konstanz, Amt fuer Stadtplanung und Umwelt
22.08.2023 17:00;975;474;501;Sonnig;32;34;0;Stadt Konstanz, Amt fuer Stadtplanung und Umwelt
22.08.2023 18:00;938;443;495;Sonnig;29;31;0;Stadt Konstanz, Amt fuer Stadtplanung und Umwelt
22.08.2023 19:00;750;354;396;Stellenweiser Regenfall;24;26;0.1;Stadt Konstanz, Amt fuer Stadtplanung und Umwelt
22.08.2023 20:00;575;277;298;Stellenweiser Regenfall;22;22;0.2;Stadt Konstanz, Amt fuer Stadtplanung und Umwelt
22.08.2023 21:00;459;203;256;Sonnig;20;20;0;Stadt Konstanz, Amt fuer Stadtplanung und Umwelt
22.08.2023 22:00;360;152;208;Stellenweiser Regenfall;19;19;0.3;Stadt Konstanz, Amt fuer Stadtplanung und Umwelt
22.08.2023 23:00;178;71;107;Sonnig;18;18;0;Stadt Konstanz, Amt fuer Stadtplanung und Umwelt
23.08.2023 00:00;86;20;66;Stellenweiser Regenfall;18;18;0.3;Stadt Konstanz, Amt fuer Stadtplanung und Umwelt
23.08.2023 01:00;43;15;28;Stellenweiser Regenfall;18;18;1.2;Stadt Konstanz, Amt fuer Stadtplanung und Umwelt
23.08.2023 02:00;11;2;9;Sonnig;18;18;0;Stadt Konstanz, Amt fuer Stadtplanung und Umwelt
23.08.2023 03:00;9;4;5;Sonnig;17;17;0;Stadt Konstanz, Amt fuer Stadtplanung und Umwelt
23.08.2023 04:00;16;6;10;Sonnig;17;17;0;Stadt Konstanz, Amt fuer Stadtplanung und Umwelt
23.08.2023 05:00;65;46;19;Sonnig;17;17;0;Stadt Konstanz, Amt fuer Stadtplanung und Umwelt
23.08.2023 06:00;197;106;91;Sonnig;17;17;0;Stadt Konstanz, Amt fuer Stadtplanung und Umwelt
23.08.2023 07:00;428;241;187;Sonnig;19;19;0;Stadt Konstanz, Amt fuer Stadtplanung und Umwelt
23.08.2023 08:00;584;321;263;Sonnig;21;21;0;Stadt Konstanz, Amt fuer Stadtplanung und Umwelt
23.08.2023 09:00;670;379;291;Sonnig;24;26;0;Stadt Konstanz, Amt fuer Stadtplanung und Umwelt
23.08.2023 10:00;572;318;254;Sonnig;27;28;0;Stadt Konstanz, Amt fuer Stadtplanung und Umwelt
23.08.2023 11:00;651;334;317;Sonnig;29;31;0;Stadt Konstanz, Amt fuer Stadtplanung und Umwelt
23.08.2023 12:00;655;291;364;Sonnig;31;33;0;Stadt Konstanz, Amt fuer Stadtplanung und Umwelt
23.08.2023 13:00;640;315;325;Sonnig;32;34;0;Stadt Konstanz, Amt fuer Stadtplanung und Umwelt
23.08.2023 14:00;537;252;285;Sonnig;33;35;0;Stadt Konstanz, Amt fuer Stadtplanung und Umwelt
23.08.2023 15:00;647;312;335;Sonnig;33;34;0;Stadt Konstanz, Amt fuer Stadtplanung und Umwelt
23.08.2023 16:00;787;374;413;Sonnig;32;34;0;Stadt Konstanz, Amt fuer Stadtplanung und Umwelt
23.08.2023 17:00;869;408;461;Sonnig;31;34;0;Stadt Konstanz, Amt fuer Stadtplanung und Umwelt
23.08.2023 18:00;869;434;435;Sonnig;29;31;0;Stadt Konstanz, Amt fuer Stadtplanung und Umwelt
23.08.2023 19:00;629;305;324;Stellenweiser Regenfall;25;26;0.1;Stadt Konstanz, Amt fuer Stadtplanung und Umwelt
23.08.2023 20:00;549;246;303;Teilweise maeßiger Regenfall;21;21;0.6;Stadt Konstanz, Amt fuer Stadtplanung und Umwelt
23.08.2023 21:00;392;170;222;Stellenweiser Regenfall;20;20;0.4;Stadt Konstanz, Amt fuer Stadtplanung und Umwelt
23.08.2023 22:00;356;125;231;Stellenweiser Regenfall;19;19;1.1;Stadt Konstanz, Amt fuer Stadtplanung und Umwelt
23.08.2023 23:00;188;78;110;Stellenweiser Regenfall;18;18;0.3;Stadt Konstanz, Amt fuer Stadtplanung und Umwelt
24.08.2023 00:00;99;31;68;Sonnig;17;17;0;Stadt Konstanz, Amt fuer Stadtplanung und Umwelt
24.08.2023 01:00;43;20;23;Stellenweiser Regenfall;17;17;0.2;Stadt Konstanz, Amt fuer Stadtplanung und Umwelt
24.08.2023 02:00;16;5;11;Sonnig;16;16;0;Stadt Konstanz, Amt fuer Stadtplanung und Umwelt
24.08.2023 03:00;16;5;11;Sonnig;16;16;0;Stadt Konstanz, Amt fuer Stadtplanung und Umwelt
24.08.2023 04:00;17;10;7;Sonnig;16;16;0;Stadt Konstanz, Amt fuer Stadtplanung und Umwelt
24.08.2023 05:00;61;38;23;Sonnig;16;16;0;Stadt Konstanz, Amt fuer Stadtplanung und Umwelt
24.08.2023 06:00;183;99;84;Sonnig;16;16;0;Stadt Konstanz, Amt fuer Stadtplanung und Umwelt
24.08.2023 07:00;400;219;181;Sonnig;18;18;0;Stadt Konstanz, Amt fuer Stadtplanung und Umwelt
24.08.2023 08:00;588;327;261;Sonnig;21;21;0;Stadt Konstanz, Amt fuer Stadtplanung und Umwelt
24.08.2023 09:00;522;289;233;Sonnig;24;25;0;Stadt Konstanz, Amt fuer Stadtplanung und Umwelt
24.08.2023 10:00;563;277;286;Sonnig;27;28;0;Stadt Konstanz, Amt fuer Stadtplanung und Umwelt
24.08.2023 11:00;595;283;312;Sonnig;29;31;0;Stadt Konstanz, Amt fuer Stadtplanung und Umwelt
24.08.2023 12:00;645;315;330;Sonnig;30;31;0;Stadt Konstanz, Amt fuer Stadtplanung und Umwelt
24.08.2023 13:00;644;314;330;Sonnig;32;33;0;Stadt Konstanz, Amt fuer Stadtplanung und Umwelt
24.08.2023 14:00;637;326;311;Sonnig;32;33;0;Stadt Konstanz, Amt fuer Stadtplanung und Umwelt
24.08.2023 15:00;680;317;363;Sonnig;32;33;0;Stadt Konstanz, Amt fuer Stadtplanung und Umwelt
24.08.2023 16:00;758;348;410;Sonnig;33;33;0;Stadt Konstanz, Amt fuer Stadtplanung und Umwelt
24.08.2023 17:00;888;448;440;Sonnig;32;33;0;Stadt Konstanz, Amt fuer Stadtplanung und Umwelt
24.08.2023 18:00;855;395;460;Sonnig;29;30;0;Stadt Konstanz, Amt fuer Stadtplanung und Umwelt
24.08.2023 19:00;711;340;371;Sonnig;25;26;0;Stadt Konstanz, Amt fuer Stadtplanung und Umwelt
24.08.2023 20:00;601;222;379;Sonnig;23;25;0;Stadt Konstanz, Amt fuer Stadtplanung und Umwelt
24.08.2023 21:00;183;69;114;Stellenweise Gewitter und Niederschlaege;22;22;0;Stadt Konstanz, Amt fuer Stadtplanung und Umwelt
24.08.2023 22:00;216;87;129;Stellenweise Gewitter und Niederschlaege;22;22;0.1;Stadt Konstanz, Amt fuer Stadtplanung und Umwelt
24.08.2023 23:00;128;40;88;Stellenweise Gewitter und Niederschlaege;20;20;0;Stadt Konstanz, Amt fuer Stadtplanung und Umwelt
25.08.2023 00:00;75;25;50;Leichter Regenschauer;18;18;1.9;Stadt Konstanz, Amt fuer Stadtplanung und Umwelt
25.08.2023 01:00;26;13;13;Teilweise starker Regenfall;17;17;8;Stadt Konstanz, Amt fuer Stadtplanung und Umwelt
25.08.2023 02:00;12;4;8;Leichter Nebel;17;17;0;Stadt Konstanz, Amt fuer Stadtplanung und Umwelt
25.08.2023 03:00;3;2;1;Leichter Nebel;16;16;0;Stadt Konstanz, Amt fuer Stadtplanung und Umwelt
25.08.2023 04:00;9;4;5;Leicht bewoelkt;16;16;0;Stadt Konstanz, Amt fuer Stadtplanung und Umwelt
25.08.2023 05:00;43;31;12;Leichter Nebel;16;16;0;Stadt Konstanz, Amt fuer Stadtplanung und Umwelt
25.08.2023 06:00;105;66;39;Leichter Nebel;16;16;0;Stadt Konstanz, Amt fuer Stadtplanung und Umwelt
25.08.2023 07:00;261;145;116;Leicht bewoelkt;18;18;0;Stadt Konstanz, Amt fuer Stadtplanung und Umwelt
25.08.2023 08:00;440;253;187;Leicht bewoelkt;19;19;0;Stadt Konstanz, Amt fuer Stadtplanung und Umwelt
25.08.2023 09:00;313;181;132;Leicht bewoelkt;22;25;0;Stadt Konstanz, Amt fuer Stadtplanung und Umwelt
25.08.2023 10:00;414;207;207;Sonnig;26;27;0;Stadt Konstanz, Amt fuer Stadtplanung und Umwelt
25.08.2023 11:00;568;335;233;Leicht bewoelkt;28;29;0;Stadt Konstanz, Amt fuer Stadtplanung und Umwelt
25.08.2023 12:00;560;261;299;Stellenweise Gewitter und Niederschlaege;29;30;0;Stadt Konstanz, Amt fuer Stadtplanung und Umwelt
25.08.2023 13:00;555;267;288;Stellenweise Gewitter und Niederschlaege;30;30;0;Stadt Konstanz, Amt fuer Stadtplanung und Umwelt
25.08.2023 14:00;602;278;324;Sonnig;30;30;0;Stadt Konstanz, Amt fuer Stadtplanung und Umwelt
25.08.2023 15:00;593;277;316;Leicht bewoelkt;30;31;0;Stadt Konstanz, Amt fuer Stadtplanung und Umwelt
25.08.2023 16:00;641;312;329;Stellenweise Gewitter und Niederschlaege;29;30;0;Stadt Konstanz, Amt fuer Stadtplanung und Umwelt
25.08.2023 17:00;612;292;320;Sonnig;29;30;0;Stadt Konstanz, Amt fuer Stadtplanung und Umwelt
25.08.2023 18:00;574;246;328;Sonnig;26;27;0;Stadt Konstanz, Amt fuer Stadtplanung und Umwelt
25.08.2023 19:00;424;206;218;Sonnig;22;25;0;Stadt Konstanz, Amt fuer Stadtplanung und Umwelt
25.08.2023 20:00;347;144;203;Stellenweiser Regenfall;20;20;0.6;Stadt Konstanz, Amt fuer Stadtplanung und Umwelt
25.08.2023 21:00;188;87;101;Leichter Nebel;18;18;0;Stadt Konstanz, Amt fuer Stadtplanung und Umwelt
25.08.2023 22:00;193;88;105;Maeßiger bis starker Regenschauer;19;19;4.3;Stadt Konstanz, Amt fuer Stadtplanung und Umwelt
25.08.2023 23:00;162;45;117;Leichter Nebel;19;19;0;Stadt Konstanz, Amt fuer Stadtplanung und Umwelt
26.08.2023 00:00;124;55;69;Leichter Regenschauer;18;18;0.9;Stadt Konstanz, Amt fuer Stadtplanung und Umwelt
26.08.2023 01:00;50;14;36;Nebel;18;18;0;Stadt Konstanz, Amt fuer Stadtplanung und Umwelt
26.08.2023 02:00;56;14;42;Nebel;18;18;0;Stadt Konstanz, Amt fuer Stadtplanung und Umwelt
26.08.2023 03:00;28;17;11;Nebel;17;17;0;Stadt Konstanz, Amt fuer Stadtplanung und Umwelt
26.08.2023 04:00;26;13;13;Nieselregen;18;18;0.3;Stadt Konstanz, Amt fuer Stadtplanung und Umwelt
26.08.2023 05:00;39;21;18;Nebel;17;17;0;Stadt Konstanz, Amt fuer Stadtplanung und Umwelt
26.08.2023 06:00;43;29;14;Nebel;17;17;0.1;Stadt Konstanz, Amt fuer Stadtplanung und Umwelt
26.08.2023 07:00;72;33;39;Nebel;18;18;0;Stadt Konstanz, Amt fuer Stadtplanung und Umwelt
26.08.2023 08:00;181;101;80;Leicht bewoelkt;19;19;0;Stadt Konstanz, Amt fuer Stadtplanung und Umwelt
26.08.2023 09:00;395;230;165;Bewoelkt;20;20;0;Stadt Konstanz, Amt fuer Stadtplanung und Umwelt
26.08.2023 10:00;475;259;216;Stellenweiser Regenfall;21;21;0.1;Stadt Konstanz, Amt fuer Stadtplanung und Umwelt
26.08.2023 11:00;568;332;236;Stellenweise Gewitter und Niederschlaege;23;25;0;Stadt Konstanz, Amt fuer Stadtplanung und Umwelt
26.08.2023 12:00;589;260;329;Stellenweise Gewitter und Niederschlaege;24;25;0;Stadt Konstanz, Amt fuer Stadtplanung und Umwelt
26.08.2023 13:00;480;212;268;Stellenweise Gewitter und Niederschlaege;24;26;0;Stadt Konstanz, Amt fuer Stadtplanung und Umwelt
26.08.2023 14:00;309;144;165;Stellenweise Gewitter und Niederschlaege;26;27;0;Stadt Konstanz, Amt fuer Stadtplanung und Umwelt
26.08.2023 15:00;261;100;161;Stellenweise Gewitter und Niederschlaege;26;27;0;Stadt Konstanz, Amt fuer Stadtplanung und Umwelt
26.08.2023 16:00;190;86;104;Stellenweiser leichter Regenfall;20;20;1.4;Stadt Konstanz, Amt fuer Stadtplanung und Umwelt
26.08.2023 17:00;217;87;130;Stellenweiser leichter Regenfall;18;18;1.3;Stadt Konstanz, Amt fuer Stadtplanung und Umwelt
26.08.2023 18:00;265;137;128;Leichter Regenschauer;17;17;2;Stadt Konstanz, Amt fuer Stadtplanung und Umwelt
26.08.2023 19:00;257;113;144;Leichter Nebel;17;17;0;Stadt Konstanz, Amt fuer Stadtplanung und Umwelt
26.08.2023 20:00;248;124;124;Leichter Regenfall;16;16;1.4;Stadt Konstanz, Amt fuer Stadtplanung und Umwelt
26.08.2023 21:00;172;85;87;Nebel;16;16;0;Stadt Konstanz, Amt fuer Stadtplanung und Umwelt
26.08.2023 22:00;127;57;70;Leichter Regenfall;15;15;2.5;Stadt Konstanz, Amt fuer Stadtplanung und Umwelt
26.08.2023 23:00;151;60;91;Nebel;15;16;0;Stadt Konstanz, Amt fuer Stadtplanung und Umwelt
27.08.2023 00:00;93;29;64;Nebel;14;14;0.1;Stadt Konstanz, Amt fuer Stadtplanung und Umwelt
27.08.2023 01:00;76;20;56;Nebel;13;14;0;Stadt Konstanz, Amt fuer Stadtplanung und Umwelt
27.08.2023 02:00;57;11;46;Nebel;13;13;0;Stadt Konstanz, Amt fuer Stadtplanung und Umwelt
27.08.2023 03:00;26;6;20;Nebel;13;13;0;Stadt Konstanz, Amt fuer Stadtplanung und Umwelt
27.08.2023 04:00;34;22;12;Nebel;13;13;0;Stadt Konstanz, Amt fuer Stadtplanung und Umwelt
27.08.2023 05:00;20;11;9;Nieselregen;13;14;0.2;Stadt Konstanz, Amt fuer Stadtplanung und Umwelt
27.08.2023 06:00;23;15;8;Leichter Regenfall;14;14;1.1;Stadt Konstanz, Amt fuer Stadtplanung und Umwelt
27.08.2023 07:00;24;12;12;Starker Regenfall;14;15;8.4;Stadt Konstanz, Amt fuer Stadtplanung und Umwelt
27.08.2023 08:00;57;33;24;Nieselregen;15;16;0.5;Stadt Konstanz, Amt fuer Stadtplanung und Umwelt
27.08.2023 09:00;144;92;52;Nebel;15;15;0;Stadt Konstanz, Amt fuer Stadtplanung und Umwelt
27.08.2023 10:00;118;67;51;Leichter Regenfall;15;15;1.8;Stadt Konstanz, Amt fuer Stadtplanung und Umwelt
27.08.2023 11:00;202;102;100;Nebel;15;15;0;Stadt Konstanz, Amt fuer Stadtplanung und Umwelt
27.08.2023 12:00;224;108;116;Leichter Regenschauer;15;15;0.8;Stadt Konstanz, Amt fuer Stadtplanung und Umwelt
27.08.2023 13:00;260;115;145;Nebel;15;15;0;Stadt Konstanz, Amt fuer Stadtplanung und Umwelt
27.08.2023 14:00;286;122;164;Leichter Regenfall;14;15;1.8;Stadt Konstanz, Amt fuer Stadtplanung und Umwelt
27.08.2023 15:00;283;149;134;Nieselregen;14;15;0.3;Stadt Konstanz, Amt fuer Stadtplanung und Umwelt
27.08.2023 16:00;269;161;108;Maeßiger Regenfall;14;14;6.1;Stadt Konstanz, Amt fuer Stadtplanung und Umwelt
27.08.2023 17:00;230;104;126;Leichter Regenschauer;14;15;0.5;Stadt Konstanz, Amt fuer Stadtplanung und Umwelt
27.08.2023 18:00;184;80;104;Leichter Regenschauer;14;14;1.9;Stadt Konstanz, Amt fuer Stadtplanung und Umwelt
27.08.2023 19:00;178;77;101;Maeßiger Regenfall;14;14;5.3;Stadt Konstanz, Amt fuer Stadtplanung und Umwelt
27.08.2023 20:00;123;65;58;Leichter Regenfall;13;14;0.9;Stadt Konstanz, Amt fuer Stadtplanung und Umwelt
27.08.2023 21:00;85;32;53;Leichter Regenschauer;13;13;0.2;Stadt Konstanz, Amt fuer Stadtplanung und Umwelt
27.08.2023 22:00;90;23;67;Leichter Regenfall;12;12;1.6;Stadt Konstanz, Amt fuer Stadtplanung und Umwelt
27.08.2023 23:00;60;21;39;Nebel;12;12;0.1;Stadt Konstanz, Amt fuer Stadtplanung und Umwelt
28.08.2023 00:00;22;12;10;Leichter Regenschauer;13;13;0.4;Stadt Konstanz, Amt fuer Stadtplanung und Umwelt
28.08.2023 01:00;22;9;13;Leichter Regenfall;12;12;2;Stadt Konstanz, Amt fuer Stadtplanung und Umwelt
28.08.2023 02:00;5;2;3;Nieselregen;12;13;0.2;Stadt Konstanz, Amt fuer Stadtplanung und Umwelt
28.08.2023 03:00;6;2;4;Nieselregen;12;12;0.3;Stadt Konstanz, Amt fuer Stadtplanung und Umwelt
28.08.2023 04:00;3;1;2;Maeßiger Regenfall;12;12;2.5;Stadt Konstanz, Amt fuer Stadtplanung und Umwelt
28.08.2023 05:00;36;24;12;Leichter Regenfall;12;12;0.8;Stadt Konstanz, Amt fuer Stadtplanung und Umwelt
28.08.2023 06:00;92;44;48;Leichter Regenfall;12;11;1.2;Stadt Konstanz, Amt fuer Stadtplanung und Umwelt
28.08.2023 07:00;195;103;92;Teilweise maeßiger Regenfall;12;11;3.8;Stadt Konstanz, Amt fuer Stadtplanung und Umwelt
28.08.2023 08:00;296;147;149;Stellenweiser leichter Regenfall;12;11;1.5;Stadt Konstanz, Amt fuer Stadtplanung und Umwelt
28.08.2023 09:00;208;121;87;Stellenweiser leichter Regenfall;12;11;0.8;Stadt Konstanz, Amt fuer Stadtplanung und Umwelt
28.08.2023 10:00;183;94;89;Teilweise maeßiger Regenfall;12;11;3.4;Stadt Konstanz, Amt fuer Stadtplanung und Umwelt
28.08.2023 11:00;208;97;111;Stellenweiser leichter Regenfall;12;11;0.9;Stadt Konstanz, Amt fuer Stadtplanung und Umwelt
28.08.2023 12:00;270;143;127;Leichter Regenfall;12;12;1.2;Stadt Konstanz, Amt fuer Stadtplanung und Umwelt
28.08.2023 13:00;314;157;157;Teilweise maeßiger Regenfall;12;11;2.9;Stadt Konstanz, Amt fuer Stadtplanung und Umwelt
28.08.2023 14:00;297;167;130;Stellenweiser leichter Regenfall;12;11;1.1;Stadt Konstanz, Amt fuer Stadtplanung und Umwelt
28.08.2023 15:00;262;142;120;Leichter Nebel;12;12;0;Stadt Konstanz, Amt fuer Stadtplanung und Umwelt
28.08.2023 16:00;333;157;176;Stellenweiser leichter Regenfall;12;12;2.2;Stadt Konstanz, Amt fuer Stadtplanung und Umwelt
28.08.2023 17:00;392;176;216;Leichter Nebel;12;12;0;Stadt Konstanz, Amt fuer Stadtplanung und Umwelt
28.08.2023 18:00;264;113;151;Leichter Regenschauer;12;12;0.8;Stadt Konstanz, Amt fuer Stadtplanung und Umwelt
28.08.2023 19:00;211;82;129;Leichter Nebel;12;12;0;Stadt Konstanz, Amt fuer Stadtplanung und Umwelt
28.08.2023 20:00;126;47;79;Stellenweiser Nieselregen;11;11;0.6;Stadt Konstanz, Amt fuer Stadtplanung und Umwelt
28.08.2023 21:00;91;41;50;Nieselregen;11;11;0.3;Stadt Konstanz, Amt fuer Stadtplanung und Umwelt
28.08.2023 22:00;80;36;44;Leichter Regenfall;11;11;1.2;Stadt Konstanz, Amt fuer Stadtplanung und Umwelt
28.08.2023 23:00;32;10;22;Nieselregen;11;11;0.3;Stadt Konstanz, Amt fuer Stadtplanung und Umwelt
29.08.2023 00:00;21;10;11;Nieselregen;10;10;0.6;Stadt Konstanz, Amt fuer Stadtplanung und Umwelt
29.08.2023 01:00;12;3;9;Maeßiger Regenfall;10;10;2.6;Stadt Konstanz, Amt fuer Stadtplanung und Umwelt
29.08.2023 02:00;5;2;3;Nieselregen;10;10;0.7;Stadt Konstanz, Amt fuer Stadtplanung und Umwelt
29.08.2023 03:00;2;1;1;Nebel;10;10;0;Stadt Konstanz, Amt fuer Stadtplanung und Umwelt
29.08.2023 04:00;7;1;6;Maeßiger Regenfall;10;10;3.4;Stadt Konstanz, Amt fuer Stadtplanung und Umwelt
29.08.2023 05:00;30;21;9;Nebel;10;10;0.1;Stadt Konstanz, Amt fuer Stadtplanung und Umwelt
29.08.2023 06:00;96;52;44;Leichter Regenfall;10;10;1.1;Stadt Konstanz, Amt fuer Stadtplanung und Umwelt
29.08.2023 07:00;207;117;90;Nebel;10;10;0;Stadt Konstanz, Amt fuer Stadtplanung und Umwelt
29.08.2023 08:00;366;173;193;Leichter Regenfall;10;10;1.2;Stadt Konstanz, Amt fuer Stadtplanung und Umwelt
29.08.2023 09:00;261;164;97;Nebel;10;10;0;Stadt Konstanz, Amt fuer Stadtplanung und Umwelt
29.08.2023 10:00;193;111;82;Maeßiger Regenfall;10;10;3.1;Stadt Konstanz, Amt fuer Stadtplanung und Umwelt
29.08.2023 11:00;242;125;117;Nebel;11;11;0;Stadt Konstanz, Amt fuer Stadtplanung und Umwelt
29.08.2023 12:00;303;114;189;Leichter Regenfall;11;11;0.9;Stadt Konstanz, Amt fuer Stadtplanung und Umwelt
29.08.2023 13:00;359;187;172;Nebel;11;11;0;Stadt Konstanz, Amt fuer Stadtplanung und Umwelt
29.08.2023 14:00;364;202;162;Nieselregen;11;12;0.2;Stadt Konstanz, Amt fuer Stadtplanung und Umwelt
29.08.2023 15:00;351;159;192;Leichter Nebel;11;12;0;Stadt Konstanz, Amt fuer Stadtplanung und Umwelt
29.08.2023 16:00;452;197;255;Nieselregen;11;12;0.5;Stadt Konstanz, Amt fuer Stadtplanung und Umwelt
29.08.2023 17:00;510;236;274;Nebel;11;12;0;Stadt Konstanz, Amt fuer Stadtplanung und Umwelt
29.08.2023 18:00;435;180;255;Nebel;11;11;0.1;Stadt Konstanz, Amt fuer Stadtplanung und Umwelt
29.08.2023 19:00;351;163;188;Nebel;11;11;0;Stadt Konstanz, Amt fuer Stadtplanung und Umwelt
29.08.2023 20:00;229;113;116;Nebel;10;10;0;Stadt Konstanz, Amt fuer Stadtplanung und Umwelt
29.08.2023 21:00;169;75;94;Nebel;9;9;0;Stadt Konstanz, Amt fuer Stadtplanung und Umwelt
29.08.2023 22:00;140;43;97;Nebel;9;9;0;Stadt Konstanz, Amt fuer Stadtplanung und Umwelt
29.08.2023 23:00;63;21;42;Nebel;9;9;0;Stadt Konstanz, Amt fuer Stadtplanung und Umwelt
30.08.2023 00:00;45;25;20;Nebel;8;8;0;Stadt Konstanz, Amt fuer Stadtplanung und Umwelt
30.08.2023 01:00;28;13;15;Nebel;7;7;0;Stadt Konstanz, Amt fuer Stadtplanung und Umwelt
30.08.2023 02:00;13;8;5;Leichter Nebel;7;7;0;Stadt Konstanz, Amt fuer Stadtplanung und Umwelt
30.08.2023 03:00;16;5;11;Nebel;7;7;0;Stadt Konstanz, Amt fuer Stadtplanung und Umwelt
30.08.2023 04:00;10;3;7;Nebel;7;7;0;Stadt Konstanz, Amt fuer Stadtplanung und Umwelt
30.08.2023 05:00;49;34;15;Nebel;7;7;0;Stadt Konstanz, Amt fuer Stadtplanung und Umwelt
30.08.2023 06:00;171;101;70;Leichter Nebel;7;7;0;Stadt Konstanz, Amt fuer Stadtplanung und Umwelt
30.08.2023 07:00;327;196;131;Leichter Nebel;8;8;0;Stadt Konstanz, Amt fuer Stadtplanung und Umwelt
30.08.2023 08:00;502;259;243;Leicht bewoelkt;10;10;0;Stadt Konstanz, Amt fuer Stadtplanung und Umwelt
30.08.2023 09:00;457;285;172;Leicht bewoelkt;12;12;0;Stadt Konstanz, Amt fuer Stadtplanung und Umwelt
30.08.2023 10:00;449;248;201;Leicht bewoelkt;14;14;0;Stadt Konstanz, Amt fuer Stadtplanung und Umwelt
30.08.2023 11:00;525;286;239;Leicht bewoelkt;17;17;0;Stadt Konstanz, Amt fuer Stadtplanung und Umwelt
30.08.2023 12:00;546;254;292;Leicht bewoelkt;18;18;0;Stadt Konstanz, Amt fuer Stadtplanung und Umwelt
30.08.2023 13:00;579;300;279;Stellenweiser Regenfall;19;19;0.2;Stadt Konstanz, Amt fuer Stadtplanung und Umwelt
30.08.2023 14:00;606;317;289;Stellenweiser Regenfall;20;20;0.2;Stadt Konstanz, Amt fuer Stadtplanung und Umwelt
30.08.2023 15:00;673;323;350;Stellenweiser Regenfall;20;20;0.1;Stadt Konstanz, Amt fuer Stadtplanung und Umwelt
30.08.2023 16:00;832;380;452;Stellenweiser Regenfall;19;19;0.5;Stadt Konstanz, Amt fuer Stadtplanung und Umwelt
30.08.2023 17:00;946;462;484;Stellenweiser Regenfall;18;18;0.1;Stadt Konstanz, Amt fuer Stadtplanung und Umwelt
30.08.2023 18:00;698;297;401;Stellenweiser Regenfall;16;16;0.1;Stadt Konstanz, Amt fuer Stadtplanung und Umwelt
30.08.2023 19:00;504;228;276;Stellenweiser Regenfall;13;13;0.3;Stadt Konstanz, Amt fuer Stadtplanung und Umwelt
30.08.2023 20:00;393;143;250;Sonnig;11;11;0;Stadt Konstanz, Amt fuer Stadtplanung und Umwelt
30.08.2023 21:00;227;96;131;Sonnig;10;10;0;Stadt Konstanz, Amt fuer Stadtplanung und Umwelt
30.08.2023 22:00;197;84;113;Sonnig;9;9;0;Stadt Konstanz, Amt fuer Stadtplanung und Umwelt
30.08.2023 23:00;124;53;71;Sonnig;9;9;0;Stadt Konstanz, Amt fuer Stadtplanung und Umwelt
31.08.2023 00:00;52;18;34;Leichter Nebel;9;8;0;Stadt Konstanz, Amt fuer Stadtplanung und Umwelt
31.08.2023 01:00;37;12;25;Leichter Nebel;9;9;0;Stadt Konstanz, Amt fuer Stadtplanung und Umwelt
31.08.2023 02:00;17;3;14;Leichter Nebel;10;10;0.1;Stadt Konstanz, Amt fuer Stadtplanung und Umwelt
31.08.2023 03:00;14;6;8;Nebel;10;9;0;Stadt Konstanz, Amt fuer Stadtplanung und Umwelt
31.08.2023 04:00;9;6;3;Leichter Regenschauer;9;9;0.7;Stadt Konstanz, Amt fuer Stadtplanung und Umwelt
31.08.2023 05:00;46;33;13;Nebel;8;7;0;Stadt Konstanz, Amt fuer Stadtplanung und Umwelt
31.08.2023 06:00;146;86;60;Leichter Regenschauer;7;7;0.2;Stadt Konstanz, Amt fuer Stadtplanung und Umwelt
31.08.2023 07:00;326;182;144;Leichter Nebel;10;10;0;Stadt Konstanz, Amt fuer Stadtplanung und Umwelt
31.08.2023 08:00;488;242;246;Leicht bewoelkt;12;12;0;Stadt Konstanz, Amt fuer Stadtplanung und Umwelt
31.08.2023 09:00;491;273;218;Leicht bewoelkt;14;14;0;Stadt Konstanz, Amt fuer Stadtplanung und Umwelt
31.08.2023 10:00;428;240;188;Leicht bewoelkt;15;15;0;Stadt Konstanz, Amt fuer Stadtplanung und Umwelt
31.08.2023 11:00;425;211;214;Leicht bewoelkt;17;17;0;Stadt Konstanz, Amt fuer Stadtplanung und Umwelt
31.08.2023 12:00;566;279;287;Bewoelkt;19;19;0;Stadt Konstanz, Amt fuer Stadtplanung und Umwelt
31.08.2023 13:00;556;268;288;Leicht bewoelkt;19;19;0;Stadt Konstanz, Amt fuer Stadtplanung und Umwelt
31.08.2023 14:00;653;341;312;Stellenweiser Regenfall;20;20;0.1;Stadt Konstanz, Amt fuer Stadtplanung und Umwelt
31.08.2023 15:00;679;338;341;Leicht bewoelkt;20;20;0;Stadt Konstanz, Amt fuer Stadtplanung und Umwelt
31.08.2023 16:00;785;369;416;Stellenweiser Regenfall;19;19;0.1;Stadt Konstanz, Amt fuer Stadtplanung und Umwelt
31.08.2023 17:00;838;414;424;Leicht bewoelkt;19;19;0;Stadt Konstanz, Amt fuer Stadtplanung und Umwelt
31.08.2023 18:00;670;274;396;Leicht bewoelkt;17;17;0;Stadt Konstanz, Amt fuer Stadtplanung und Umwelt
31.08.2023 19:00;476;213;263;Leicht bewoelkt;14;15;0;Stadt Konstanz, Amt fuer Stadtplanung und Umwelt
31.08.2023 20:00;354;165;189;Leicht bewoelkt;13;14;0;Stadt Konstanz, Amt fuer Stadtplanung und Umwelt
31.08.2023 21:00;227;89;138;Leicht bewoelkt;13;13;0;Stadt Konstanz, Amt fuer Stadtplanung und Umwelt
31.08.2023 22:00;200;66;134;Leicht bewoelkt;12;13;0;Stadt Konstanz, Amt fuer Stadtplanung und Umwelt
31.08.2023 23:00;120;42;78;Leicht bewoelkt;12;13;0;Stadt Konstanz, Amt fuer Stadtplanung und Umwelt
01.09.2023 00:00;52;15;37;Leicht bewoelkt;13;13;0;Stadt Konstanz, Amt fuer Stadtplanung und Umwelt
01.09.2023 01:00;33;10;23;Leicht bewoelkt;12;12;0;Stadt Konstanz, Amt fuer Stadtplanung und Umwelt
01.09.2023 02:00;18;4;14;Leicht bewoelkt;12;12;0;Stadt Konstanz, Amt fuer Stadtplanung und Umwelt
01.09.2023 03:00;4;1;3;Leicht bewoelkt;10;10;0;Stadt Konstanz, Amt fuer Stadtplanung und Umwelt
01.09.2023 04:00;25;17;8;Leicht bewoelkt;9;9;0;Stadt Konstanz, Amt fuer Stadtplanung und Umwelt
01.09.2023 05:00;39;29;10;Leicht bewoelkt;9;9;0;Stadt Konstanz, Amt fuer Stadtplanung und Umwelt
01.09.2023 06:00;135;81;54;Leicht bewoelkt;10;10;0;Stadt Konstanz, Amt fuer Stadtplanung und Umwelt
01.09.2023 07:00;337;195;142;Leicht bewoelkt;12;12;0;Stadt Konstanz, Amt fuer Stadtplanung und Umwelt
01.09.2023 08:00;535;309;226;Leicht bewoelkt;14;15;0;Stadt Konstanz, Amt fuer Stadtplanung und Umwelt
01.09.2023 09:00;538;307;231;Sonnig;17;17;0;Stadt Konstanz, Amt fuer Stadtplanung und Umwelt
01.09.2023 10:00;583;320;263;Sonnig;19;19;0;Stadt Konstanz, Amt fuer Stadtplanung und Umwelt
01.09.2023 11:00;694;340;354;Sonnig;21;21;0;Stadt Konstanz, Amt fuer Stadtplanung und Umwelt
01.09.2023 12:00;697;315;382;Sonnig;23;25;0;Stadt Konstanz, Amt fuer Stadtplanung und Umwelt
01.09.2023 13:00;754;352;402;Leicht bewoelkt;23;25;0;Stadt Konstanz, Amt fuer Stadtplanung und Umwelt
01.09.2023 14:00;762;385;377;Leicht bewoelkt;24;25;0;Stadt Konstanz, Amt fuer Stadtplanung und Umwelt
01.09.2023 15:00;720;375;345;Sonnig;25;25;0;Stadt Konstanz, Amt fuer Stadtplanung und Umwelt
01.09.2023 16:00;833;383;450;Sonnig;24;25;0;Stadt Konstanz, Amt fuer Stadtplanung und Umwelt
01.09.2023 17:00;768;371;397;Sonnig;24;25;0;Stadt Konstanz, Amt fuer Stadtplanung und Umwelt
01.09.2023 18:00;736;372;364;Sonnig;21;21;0;Stadt Konstanz, Amt fuer Stadtplanung und Umwelt
01.09.2023 19:00;596;356;240;Sonnig;17;17;0;Stadt Konstanz, Amt fuer Stadtplanung und Umwelt
01.09.2023 20:00;581;302;279;Sonnig;15;15;0;Stadt Konstanz, Amt fuer Stadtplanung und Umwelt
01.09.2023 21:00;344;145;199;Sonnig;14;14;0;Stadt Konstanz, Amt fuer Stadtplanung und Umwelt
01.09.2023 22:00;338;93;245;Sonnig;14;14;0;Stadt Konstanz, Amt fuer Stadtplanung und Umwelt
01.09.2023 23:00;287;76;211;Sonnig;13;14;0;Stadt Konstanz, Amt fuer Stadtplanung und Umwelt
02.09.2023 00:00;176;48;128;Sonnig;13;13;0;Stadt Konstanz, Amt fuer Stadtplanung und Umwelt
02.09.2023 01:00;118;18;100;Sonnig;12;12;0;Stadt Konstanz, Amt fuer Stadtplanung und Umwelt
02.09.2023 02:00;84;20;64;Sonnig;12;13;0;Stadt Konstanz, Amt fuer Stadtplanung und Umwelt
02.09.2023 03:00;52;13;39;Sonnig;12;12;0;Stadt Konstanz, Amt fuer Stadtplanung und Umwelt
02.09.2023 04:00;17;9;8;Sonnig;12;12;0;Stadt Konstanz, Amt fuer Stadtplanung und Umwelt
02.09.2023 05:00;41;25;16;Sonnig;11;11;0;Stadt Konstanz, Amt fuer Stadtplanung und Umwelt
02.09.2023 06:00;43;32;11;Leichter Nebel;11;11;0;Stadt Konstanz, Amt fuer Stadtplanung und Umwelt
02.09.2023 07:00;78;41;37;Sonnig;14;14;0;Stadt Konstanz, Amt fuer Stadtplanung und Umwelt
02.09.2023 08:00;218;115;103;Sonnig;17;17;0;Stadt Konstanz, Amt fuer Stadtplanung und Umwelt
02.09.2023 09:00;415;228;187;Sonnig;20;20;0;Stadt Konstanz, Amt fuer Stadtplanung und Umwelt
02.09.2023 10:00;638;366;272;Sonnig;22;22;0;Stadt Konstanz, Amt fuer Stadtplanung und Umwelt
02.09.2023 11:00;642;343;299;Sonnig;24;25;0;Stadt Konstanz, Amt fuer Stadtplanung und Umwelt
02.09.2023 12:00;647;350;297;Sonnig;25;26;0;Stadt Konstanz, Amt fuer Stadtplanung und Umwelt
02.09.2023 13:00;744;347;397;Sonnig;26;26;0;Stadt Konstanz, Amt fuer Stadtplanung und Umwelt
02.09.2023 14:00;735;334;401;Sonnig;27;27;0;Stadt Konstanz, Amt fuer Stadtplanung und Umwelt
02.09.2023 15:00;726;337;389;Sonnig;27;27;0;Stadt Konstanz, Amt fuer Stadtplanung und Umwelt
02.09.2023 16:00;637;262;375;Sonnig;26;27;0;Stadt Konstanz, Amt fuer Stadtplanung und Umwelt
02.09.2023 17:00;583;294;289;Sonnig;25;26;0;Stadt Konstanz, Amt fuer Stadtplanung und Umwelt
02.09.2023 18:00;658;277;381;Sonnig;21;21;0;Stadt Konstanz, Amt fuer Stadtplanung und Umwelt
02.09.2023 19:00;578;280;298;Sonnig;18;18;0;Stadt Konstanz, Amt fuer Stadtplanung und Umwelt
02.09.2023 20:00;414;178;236;Sonnig;16;16;0;Stadt Konstanz, Amt fuer Stadtplanung und Umwelt
02.09.2023 21:00;263;112;151;Sonnig;15;15;0;Stadt Konstanz, Amt fuer Stadtplanung und Umwelt
02.09.2023 22:00;248;111;137;Sonnig;15;15;0;Stadt Konstanz, Amt fuer Stadtplanung und Umwelt
02.09.2023 23:00;196;109;87;Sonnig;15;15;0;Stadt Konstanz, Amt fuer Stadtplanung und Umwelt
03.09.2023 00:00;153;68;85;Sonnig;14;15;0;Stadt Konstanz, Amt fuer Stadtplanung und Umwelt
03.09.2023 01:00;93;30;63;Sonnig;14;14;0;Stadt Konstanz, Amt fuer Stadtplanung und Umwelt
03.09.2023 02:00;65;17;48;Sonnig;13;14;0;Stadt Konstanz, Amt fuer Stadtplanung und Umwelt
03.09.2023 03:00;32;9;23;Sonnig;13;14;0;Stadt Konstanz, Amt fuer Stadtplanung und Umwelt
03.09.2023 04:00;19;7;12;Sonnig;13;13;0;Stadt Konstanz, Amt fuer Stadtplanung und Umwelt
03.09.2023 05:00;27;17;10;Sonnig;13;13;0;Stadt Konstanz, Amt fuer Stadtplanung und Umwelt
03.09.2023 06:00;39;25;14;Leichter Nebel;12;12;0;Stadt Konstanz, Amt fuer Stadtplanung und Umwelt
03.09.2023 07:00;65;40;25;Sonnig;15;15;0;Stadt Konstanz, Amt fuer Stadtplanung und Umwelt
03.09.2023 08:00;132;77;55;Sonnig;17;17;0;Stadt Konstanz, Amt fuer Stadtplanung und Umwelt
03.09.2023 09:00;300;160;140;Sonnig;19;19;0;Stadt Konstanz, Amt fuer Stadtplanung und Umwelt
03.09.2023 10:00;384;205;179;Sonnig;21;21;0;Stadt Konstanz, Amt fuer Stadtplanung und Umwelt
03.09.2023 11:00;484;222;262;Sonnig;24;25;0;Stadt Konstanz, Amt fuer Stadtplanung und Umwelt
03.09.2023 12:00;549;277;272;Sonnig;25;26;0;Stadt Konstanz, Amt fuer Stadtplanung und Umwelt
03.09.2023 13:00;536;274;262;Sonnig;26;26;0;Stadt Konstanz, Amt fuer Stadtplanung und Umwelt
03.09.2023 14:00;561;266;295;Sonnig;26;27;0;Stadt Konstanz, Amt fuer Stadtplanung und Umwelt
03.09.2023 15:00;566;303;263;Sonnig;26;27;0;Stadt Konstanz, Amt fuer Stadtplanung und Umwelt
03.09.2023 16:00;537;252;285;Sonnig;26;26;0;Stadt Konstanz, Amt fuer Stadtplanung und Umwelt
03.09.2023 17:00;589;289;300;Sonnig;25;26;0;Stadt Konstanz, Amt fuer Stadtplanung und Umwelt
03.09.2023 18:00;535;258;277;Sonnig;22;22;0;Stadt Konstanz, Amt fuer Stadtplanung und Umwelt
03.09.2023 19:00;436;226;210;Sonnig;18;18;0;Stadt Konstanz, Amt fuer Stadtplanung und Umwelt
03.09.2023 20:00;308;114;194;Sonnig;17;17;0;Stadt Konstanz, Amt fuer Stadtplanung und Umwelt
03.09.2023 21:00;204;84;120;Leichter Nebel;16;16;0;Stadt Konstanz, Amt fuer Stadtplanung und Umwelt
03.09.2023 22:00;132;50;82;Leichter Nebel;16;16;0;Stadt Konstanz, Amt fuer Stadtplanung und Umwelt
03.09.2023 23:00;51;18;33;Leichter Nebel;15;15;0;Stadt Konstanz, Amt fuer Stadtplanung und Umwelt
04.09.2023 00:00;43;20;23;Leichter Nebel;14;13;0;Stadt Konstanz, Amt fuer Stadtplanung und Umwelt
04.09.2023 01:00;16;7;9;Leichter Nebel;13;13;0;Stadt Konstanz, Amt fuer Stadtplanung und Umwelt
04.09.2023 02:00;7;5;2;Leichter Nebel;13;12;0;Stadt Konstanz, Amt fuer Stadtplanung und Umwelt
04.09.2023 03:00;8;1;7;Leichter Nebel;13;12;0;Stadt Konstanz, Amt fuer Stadtplanung und Umwelt
04.09.2023 04:00;16;10;6;Sonnig;12;12;0;Stadt Konstanz, Amt fuer Stadtplanung und Umwelt
04.09.2023 05:00;55;38;17;Sonnig;12;12;0;Stadt Konstanz, Amt fuer Stadtplanung und Umwelt
04.09.2023 06:00;218;124;94;Sonnig;12;12;0;Stadt Konstanz, Amt fuer Stadtplanung und Umwelt
04.09.2023 07:00;459;266;193;Sonnig;14;14;0;Stadt Konstanz, Amt fuer Stadtplanung und Umwelt
04.09.2023 08:00;654;347;307;Sonnig;17;17;0;Stadt Konstanz, Amt fuer Stadtplanung und Umwelt
04.09.2023 09:00;565;325;240;Sonnig;19;19;0;Stadt Konstanz, Amt fuer Stadtplanung und Umwelt
04.09.2023 10:00;553;305;248;Sonnig;21;21;0;Stadt Konstanz, Amt fuer Stadtplanung und Umwelt
04.09.2023 11:00;639;311;328;Sonnig;23;25;0;Stadt Konstanz, Amt fuer Stadtplanung und Umwelt
04.09.2023 12:00;647;299;348;Sonnig;24;25;0;Stadt Konstanz, Amt fuer Stadtplanung und Umwelt
04.09.2023 13:00;719;322;397;Sonnig;25;26;0;Stadt Konstanz, Amt fuer Stadtplanung und Umwelt
04.09.2023 14:00;733;345;388;Sonnig;26;26;0;Stadt Konstanz, Amt fuer Stadtplanung und Umwelt
04.09.2023 15:00;793;376;417;Sonnig;25;26;0;Stadt Konstanz, Amt fuer Stadtplanung und Umwelt
04.09.2023 16:00;988;472;516;Sonnig;25;26;0;Stadt Konstanz, Amt fuer Stadtplanung und Umwelt
04.09.2023 17:00;973;448;525;Sonnig;23;25;0;Stadt Konstanz, Amt fuer Stadtplanung und Umwelt
04.09.2023 18:00;896;404;492;Sonnig;20;20;0;Stadt Konstanz, Amt fuer Stadtplanung und Umwelt
04.09.2023 19:00;690;338;352;Sonnig;17;17;0;Stadt Konstanz, Amt fuer Stadtplanung und Umwelt
04.09.2023 20:00;442;168;274;Sonnig;16;16;0;Stadt Konstanz, Amt fuer Stadtplanung und Umwelt
04.09.2023 21:00;313;105;208;Sonnig;16;16;0;Stadt Konstanz, Amt fuer Stadtplanung und Umwelt
04.09.2023 22:00;220;101;119;Sonnig;15;15;0;Stadt Konstanz, Amt fuer Stadtplanung und Umwelt
04.09.2023 23:00;79;32;47;Sonnig;14;14;0;Stadt Konstanz, Amt fuer Stadtplanung und Umwelt
05.09.2023 00:00;36;17;19;Sonnig;13;13;0;Stadt Konstanz, Amt fuer Stadtplanung und Umwelt
05.09.2023 01:00;39;9;30;Sonnig;12;12;0;Stadt Konstanz, Amt fuer Stadtplanung und Umwelt
05.09.2023 02:00;18;7;11;Sonnig;12;12;0;Stadt Konstanz, Amt fuer Stadtplanung und Umwelt
05.09.2023 03:00;10;4;6;Sonnig;11;11;0;Stadt Konstanz, Amt fuer Stadtplanung und Umwelt
05.09.2023 04:00;17;10;7;Sonnig;11;10;0;Stadt Konstanz, Amt fuer Stadtplanung und Umwelt
05.09.2023 05:00;53;41;12;Sonnig;10;10;0;Stadt Konstanz, Amt fuer Stadtplanung und Umwelt
05.09.2023 06:00;205;121;84;Sonnig;10;10;0;Stadt Konstanz, Amt fuer Stadtplanung und Umwelt
05.09.2023 07:00;500;278;222;Sonnig;13;12;0;Stadt Konstanz, Amt fuer Stadtplanung und Umwelt
05.09.2023 08:00;771;426;345;Sonnig;15;15;0;Stadt Konstanz, Amt fuer Stadtplanung und Umwelt
05.09.2023 09:00;630;374;256;Sonnig;18;18;0;Stadt Konstanz, Amt fuer Stadtplanung und Umwelt
05.09.2023 10:00;608;351;257;Sonnig;20;20;0;Stadt Konstanz, Amt fuer Stadtplanung und Umwelt
05.09.2023 11:00;737;354;383;Sonnig;22;25;0;Stadt Konstanz, Amt fuer Stadtplanung und Umwelt
05.09.2023 12:00;718;322;396;Sonnig;24;25;0;Stadt Konstanz, Amt fuer Stadtplanung und Umwelt
05.09.2023 13:00;779;373;406;Sonnig;26;26;0;Stadt Konstanz, Amt fuer Stadtplanung und Umwelt
05.09.2023 14:00;813;399;414;Sonnig;26;26;0;Stadt Konstanz, Amt fuer Stadtplanung und Umwelt
05.09.2023 15:00;866;436;430;Sonnig;26;26;0;Stadt Konstanz, Amt fuer Stadtplanung und Umwelt
05.09.2023 16:00;1082;505;577;Sonnig;25;26;0;Stadt Konstanz, Amt fuer Stadtplanung und Umwelt
05.09.2023 17:00;1117;506;611;Sonnig;23;25;0;Stadt Konstanz, Amt fuer Stadtplanung und Umwelt
05.09.2023 18:00;950;417;533;Sonnig;20;20;0;Stadt Konstanz, Amt fuer Stadtplanung und Umwelt
05.09.2023 19:00;752;370;382;Sonnig;16;16;0;Stadt Konstanz, Amt fuer Stadtplanung und Umwelt
05.09.2023 20:00;555;222;333;Sonnig;14;14;0;Stadt Konstanz, Amt fuer Stadtplanung und Umwelt
05.09.2023 21:00;331;122;209;Sonnig;13;13;0;Stadt Konstanz, Amt fuer Stadtplanung und Umwelt
05.09.2023 22:00;237;96;141;Sonnig;13;12;0;Stadt Konstanz, Amt fuer Stadtplanung und Umwelt
05.09.2023 23:00;110;41;69;Sonnig;12;11;0;Stadt Konstanz, Amt fuer Stadtplanung und Umwelt
06.09.2023 00:00;73;26;47;Sonnig;12;11;0;Stadt Konstanz, Amt fuer Stadtplanung und Umwelt
06.09.2023 01:00;22;10;12;Leichter Nebel;11;11;0;Stadt Konstanz, Amt fuer Stadtplanung und Umwelt
06.09.2023 02:00;20;9;11;Leichter Nebel;11;11;0;Stadt Konstanz, Amt fuer Stadtplanung und Umwelt
06.09.2023 03:00;11;2;9;Leichter Nebel;10;10;0;Stadt Konstanz, Amt fuer Stadtplanung und Umwelt
06.09.2023 04:00;23;12;11;Leichter Nebel;10;10;0;Stadt Konstanz, Amt fuer Stadtplanung und Umwelt
06.09.2023 05:00;53;39;14;Leichter Nebel;10;10;0;Stadt Konstanz, Amt fuer Stadtplanung und Umwelt
06.09.2023 06:00;191;107;84;Leichter Nebel;10;10;0;Stadt Konstanz, Amt fuer Stadtplanung und Umwelt
06.09.2023 07:00;491;300;191;Sonnig;12;12;0;Stadt Konstanz, Amt fuer Stadtplanung und Umwelt
06.09.2023 08:00;781;420;361;Sonnig;15;15;0;Stadt Konstanz, Amt fuer Stadtplanung und Umwelt
06.09.2023 09:00;655;362;293;Sonnig;18;18;0;Stadt Konstanz, Amt fuer Stadtplanung und Umwelt
06.09.2023 10:00;627;346;281;Sonnig;20;20;0;Stadt Konstanz, Amt fuer Stadtplanung und Umwelt
06.09.2023 11:00;724;381;343;Sonnig;23;25;0;Stadt Konstanz, Amt fuer Stadtplanung und Umwelt
06.09.2023 12:00;736;343;393;Sonnig;24;26;0;Stadt Konstanz, Amt fuer Stadtplanung und Umwelt
06.09.2023 13:00;783;341;442;Sonnig;25;26;0;Stadt Konstanz, Amt fuer Stadtplanung und Umwelt
06.09.2023 14:00;825;389;436;Sonnig;26;27;0;Stadt Konstanz, Amt fuer Stadtplanung und Umwelt
06.09.2023 15:00;894;443;451;Sonnig;26;27;0;Stadt Konstanz, Amt fuer Stadtplanung und Umwelt
06.09.2023 16:00;1031;487;544;Sonnig;26;27;0;Stadt Konstanz, Amt fuer Stadtplanung und Umwelt
06.09.2023 17:00;1138;550;588;Sonnig;24;26;0;Stadt Konstanz, Amt fuer Stadtplanung und Umwelt
06.09.2023 18:00;1008;471;537;Sonnig;21;21;0;Stadt Konstanz, Amt fuer Stadtplanung und Umwelt
06.09.2023 19:00;749;334;415;Sonnig;17;17;0;Stadt Konstanz, Amt fuer Stadtplanung und Umwelt
06.09.2023 20:00;594;247;347;Sonnig;16;16;0;Stadt Konstanz, Amt fuer Stadtplanung und Umwelt
06.09.2023 21:00;398;158;240;Sonnig;15;15;0;Stadt Konstanz, Amt fuer Stadtplanung und Umwelt
06.09.2023 22:00;285;99;186;Sonnig;14;14;0;Stadt Konstanz, Amt fuer Stadtplanung und Umwelt
06.09.2023 23:00;153;50;103;Sonnig;13;13;0;Stadt Konstanz, Amt fuer Stadtplanung und Umwelt
07.09.2023 00:00;92;28;64;Sonnig;13;13;0;Stadt Konstanz, Amt fuer Stadtplanung und Umwelt
07.09.2023 01:00;37;8;29;Sonnig;12;12;0;Stadt Konstanz, Amt fuer Stadtplanung und Umwelt
07.09.2023 02:00;17;3;14;Sonnig;12;12;0;Stadt Konstanz, Amt fuer Stadtplanung und Umwelt
07.09.2023 03:00;15;8;7;Sonnig;11;11;0;Stadt Konstanz, Amt fuer Stadtplanung und Umwelt
07.09.2023 04:00;15;9;6;Sonnig;11;11;0;Stadt Konstanz, Amt fuer Stadtplanung und Umwelt
07.09.2023 05:00;61;39;22;Sonnig;11;11;0;Stadt Konstanz, Amt fuer Stadtplanung und Umwelt
07.09.2023 06:00;215;125;90;Sonnig;11;11;0;Stadt Konstanz, Amt fuer Stadtplanung und Umwelt
07.09.2023 07:00;472;280;192;Sonnig;13;13;0;Stadt Konstanz, Amt fuer Stadtplanung und Umwelt
07.09.2023 08:00;741;390;351;Sonnig;17;17;0;Stadt Konstanz, Amt fuer Stadtplanung und Umwelt
07.09.2023 09:00;617;361;256;Sonnig;19;19;0;Stadt Konstanz, Amt fuer Stadtplanung und Umwelt
07.09.2023 10:00;587;342;245;Sonnig;22;22;0;Stadt Konstanz, Amt fuer Stadtplanung und Umwelt
07.09.2023 11:00;650;304;346;Sonnig;24;25;0;Stadt Konstanz, Amt fuer Stadtplanung und Umwelt
07.09.2023 12:00;744;369;375;Sonnig;26;27;0;Stadt Konstanz, Amt fuer Stadtplanung und Umwelt
07.09.2023 13:00;803;350;453;Sonnig;27;28;0;Stadt Konstanz, Amt fuer Stadtplanung und Umwelt
07.09.2023 14:00;806;424;382;Sonnig;28;28;0;Stadt Konstanz, Amt fuer Stadtplanung und Umwelt
07.09.2023 15:00;863;411;452;Sonnig;28;28;0;Stadt Konstanz, Amt fuer Stadtplanung und Umwelt
07.09.2023 16:00;972;479;493;Sonnig;28;28;0;Stadt Konstanz, Amt fuer Stadtplanung und Umwelt
07.09.2023 17:00;1041;472;569;Sonnig;27;28;0;Stadt Konstanz, Amt fuer Stadtplanung und Umwelt
07.09.2023 18:00;936;427;509;Sonnig;23;25;0;Stadt Konstanz, Amt fuer Stadtplanung und Umwelt
07.09.2023 19:00;705;324;381;Sonnig;19;19;0;Stadt Konstanz, Amt fuer Stadtplanung und Umwelt
07.09.2023 20:00;581;231;350;Sonnig;18;18;0;Stadt Konstanz, Amt fuer Stadtplanung und Umwelt
07.09.2023 21:00;386;167;219;Leichter Nebel;17;17;0;Stadt Konstanz, Amt fuer Stadtplanung und Umwelt
07.09.2023 22:00;288;102;186;Leichter Nebel;17;17;0;Stadt Konstanz, Amt fuer Stadtplanung und Umwelt
07.09.2023 23:00;136;61;75;Leichter Nebel;16;16;0;Stadt Konstanz, Amt fuer Stadtplanung und Umwelt
08.09.2023 00:00;55;15;40;Sonnig;15;15;0;Stadt Konstanz, Amt fuer Stadtplanung und Umwelt
08.09.2023 01:00;44;9;35;Sonnig;15;15;0;Stadt Konstanz, Amt fuer Stadtplanung und Umwelt
08.09.2023 02:00;13;3;10;Sonnig;14;15;0;Stadt Konstanz, Amt fuer Stadtplanung und Umwelt
08.09.2023 03:00;10;2;8;Leichter Nebel;14;14;0;Stadt Konstanz, Amt fuer Stadtplanung und Umwelt
08.09.2023 04:00;17;10;7;Leichter Nebel;14;14;0;Stadt Konstanz, Amt fuer Stadtplanung und Umwelt
08.09.2023 05:00;53;37;16;Leichter Nebel;14;14;0;Stadt Konstanz, Amt fuer Stadtplanung und Umwelt
08.09.2023 06:00;187;99;88;Leichter Nebel;13;13;0;Stadt Konstanz, Amt fuer Stadtplanung und Umwelt
08.09.2023 07:00;448;263;185;Leicht bewoelkt;15;15;0;Stadt Konstanz, Amt fuer Stadtplanung und Umwelt
08.09.2023 08:00;735;414;321;Sonnig;19;19;0;Stadt Konstanz, Amt fuer Stadtplanung und Umwelt
08.09.2023 09:00;646;363;283;Sonnig;22;22;0;Stadt Konstanz, Amt fuer Stadtplanung und Umwelt
08.09.2023 10:00;712;411;301;Sonnig;24;26;0;Stadt Konstanz, Amt fuer Stadtplanung und Umwelt
08.09.2023 11:00;764;411;353;Sonnig;26;27;0;Stadt Konstanz, Amt fuer Stadtplanung und Umwelt
08.09.2023 12:00;809;384;425;Sonnig;28;29;0;Stadt Konstanz, Amt fuer Stadtplanung und Umwelt
08.09.2023 13:00;889;417;472;Sonnig;29;30;0;Stadt Konstanz, Amt fuer Stadtplanung und Umwelt
08.09.2023 14:00;904;443;461;Sonnig;30;30;0;Stadt Konstanz, Amt fuer Stadtplanung und Umwelt
08.09.2023 15:00;851;399;452;Sonnig;30;30;0;Stadt Konstanz, Amt fuer Stadtplanung und Umwelt
08.09.2023 16:00;814;387;427;Sonnig;29;30;0;Stadt Konstanz, Amt fuer Stadtplanung und Umwelt
08.09.2023 17:00;883;448;435;Sonnig;28;30;0;Stadt Konstanz, Amt fuer Stadtplanung und Umwelt
08.09.2023 18:00;866;441;425;Sonnig;24;26;0;Stadt Konstanz, Amt fuer Stadtplanung und Umwelt
08.09.2023 19:00;713;342;371;Sonnig;21;21;0;Stadt Konstanz, Amt fuer Stadtplanung und Umwelt
08.09.2023 20:00;560;273;287;Sonnig;20;20;0;Stadt Konstanz, Amt fuer Stadtplanung und Umwelt
08.09.2023 21:00;338;143;195;Sonnig;19;18;0;Stadt Konstanz, Amt fuer Stadtplanung und Umwelt
08.09.2023 22:00;303;92;211;Sonnig;18;18;0;Stadt Konstanz, Amt fuer Stadtplanung und Umwelt
08.09.2023 23:00;193;71;122;Sonnig;17;17;0;Stadt Konstanz, Amt fuer Stadtplanung und Umwelt
09.09.2023 00:00;146;53;93;Sonnig;17;17;0;Stadt Konstanz, Amt fuer Stadtplanung und Umwelt
09.09.2023 01:00;94;41;53;Sonnig;16;16;0;Stadt Konstanz, Amt fuer Stadtplanung und Umwelt
09.09.2023 02:00;67;10;57;Leichter Nebel;16;16;0;Stadt Konstanz, Amt fuer Stadtplanung und Umwelt
09.09.2023 03:00;57;11;46;Leichter Nebel;16;16;0;Stadt Konstanz, Amt fuer Stadtplanung und Umwelt
09.09.2023 04:00;24;11;13;Leichter Nebel;16;16;0;Stadt Konstanz, Amt fuer Stadtplanung und Umwelt
09.09.2023 05:00;51;22;29;Leichter Nebel;15;15;0;Stadt Konstanz, Amt fuer Stadtplanung und Umwelt
09.09.2023 06:00;84;53;31;Leichter Nebel;15;15;0;Stadt Konstanz, Amt fuer Stadtplanung und Umwelt
09.09.2023 07:00;269;90;179;Leicht bewoelkt;17;17;0;Stadt Konstanz, Amt fuer Stadtplanung und Umwelt
09.09.2023 08:00;411;152;259;Sonnig;20;20;0;Stadt Konstanz, Amt fuer Stadtplanung und Umwelt
09.09.2023 09:00;603;298;305;Sonnig;22;25;0;Stadt Konstanz, Amt fuer Stadtplanung und Umwelt
09.09.2023 10:00;766;400;366;Sonnig;25;26;0;Stadt Konstanz, Amt fuer Stadtplanung und Umwelt
09.09.2023 11:00;831;457;374;Sonnig;27;28;0;Stadt Konstanz, Amt fuer Stadtplanung und Umwelt
09.09.2023 12:00;920;415;505;Sonnig;28;30;0;Stadt Konstanz, Amt fuer Stadtplanung und Umwelt
09.09.2023 13:00;922;356;566;Sonnig;30;30;0;Stadt Konstanz, Amt fuer Stadtplanung und Umwelt
09.09.2023 14:00;903;384;519;Sonnig;30;30;0;Stadt Konstanz, Amt fuer Stadtplanung und Umwelt
09.09.2023 15:00;923;400;523;Sonnig;30;30;0;Stadt Konstanz, Amt fuer Stadtplanung und Umwelt
09.09.2023 16:00;842;338;504;Sonnig;29;29;0;Stadt Konstanz, Amt fuer Stadtplanung und Umwelt
09.09.2023 17:00;878;377;501;Sonnig;28;30;0;Stadt Konstanz, Amt fuer Stadtplanung und Umwelt
09.09.2023 18:00;725;291;434;Sonnig;24;25;0;Stadt Konstanz, Amt fuer Stadtplanung und Umwelt
09.09.2023 19:00;677;325;352;Sonnig;21;21;0;Stadt Konstanz, Amt fuer Stadtplanung und Umwelt
09.09.2023 20:00;515;243;272;Sonnig;20;20;0;Stadt Konstanz, Amt fuer Stadtplanung und Umwelt
09.09.2023 21:00;396;196;200;Sonnig;19;19;0;Stadt Konstanz, Amt fuer Stadtplanung und Umwelt
09.09.2023 22:00;349;152;197;Sonnig;18;18;0;Stadt Konstanz, Amt fuer Stadtplanung und Umwelt
09.09.2023 23:00;218;82;136;Sonnig;17;17;0;Stadt Konstanz, Amt fuer Stadtplanung und Umwelt
10.09.2023 00:00;184;71;113;Leichter Nebel;17;17;0;Stadt Konstanz, Amt fuer Stadtplanung und Umwelt
10.09.2023 01:00;155;46;109;Leichter Nebel;17;17;0;Stadt Konstanz, Amt fuer Stadtplanung und Umwelt
10.09.2023 02:00;75;21;54;Leichter Nebel;17;17;0;Stadt Konstanz, Amt fuer Stadtplanung und Umwelt
10.09.2023 03:00;59;24;35;Leichter Nebel;16;16;0;Stadt Konstanz, Amt fuer Stadtplanung und Umwelt
10.09.2023 04:00;28;12;16;Leichter Nebel;16;16;0;Stadt Konstanz, Amt fuer Stadtplanung und Umwelt
10.09.2023 05:00;22;16;6;Leichter Nebel;16;16;0;Stadt Konstanz, Amt fuer Stadtplanung und Umwelt
10.09.2023 06:00;35;26;9;Leichter Nebel;16;16;0;Stadt Konstanz, Amt fuer Stadtplanung und Umwelt
10.09.2023 07:00;50;33;17;Leichter Nebel;17;17;0;Stadt Konstanz, Amt fuer Stadtplanung und Umwelt
10.09.2023 08:00;139;78;61;Leicht bewoelkt;20;20;0;Stadt Konstanz, Amt fuer Stadtplanung und Umwelt
10.09.2023 09:00;296;149;147;Leicht bewoelkt;22;25;0;Stadt Konstanz, Amt fuer Stadtplanung und Umwelt
10.09.2023 10:00;431;191;240;Sonnig;25;26;0;Stadt Konstanz, Amt fuer Stadtplanung und Umwelt
10.09.2023 11:00;555;286;269;Sonnig;27;28;0;Stadt Konstanz, Amt fuer Stadtplanung und Umwelt
10.09.2023 12:00;548;237;311;Sonnig;28;29;0;Stadt Konstanz, Amt fuer Stadtplanung und Umwelt
10.09.2023 13:00;530;252;278;Sonnig;29;30;0;Stadt Konstanz, Amt fuer Stadtplanung und Umwelt
10.09.2023 14:00;645;320;325;Sonnig;30;30;0;Stadt Konstanz, Amt fuer Stadtplanung und Umwelt
10.09.2023 15:00;553;290;263;Sonnig;29;30;0;Stadt Konstanz, Amt fuer Stadtplanung und Umwelt
10.09.2023 16:00;564;292;272;Sonnig;29;29;0;Stadt Konstanz, Amt fuer Stadtplanung und Umwelt
10.09.2023 17:00;623;338;285;Sonnig;28;29;0;Stadt Konstanz, Amt fuer Stadtplanung und Umwelt
10.09.2023 18:00;580;283;297;Sonnig;24;25;0;Stadt Konstanz, Amt fuer Stadtplanung und Umwelt
10.09.2023 19:00;523;231;292;Sonnig;20;20;0;Stadt Konstanz, Amt fuer Stadtplanung und Umwelt
10.09.2023 20:00;398;186;212;Sonnig;19;19;0;Stadt Konstanz, Amt fuer Stadtplanung und Umwelt
10.09.2023 21:00;244;101;143;Sonnig;18;18;0;Stadt Konstanz, Amt fuer Stadtplanung und Umwelt
10.09.2023 22:00;133;50;83;Sonnig;17;17;0;Stadt Konstanz, Amt fuer Stadtplanung und Umwelt
10.09.2023 23:00;72;19;53;Sonnig;17;17;0;Stadt Konstanz, Amt fuer Stadtplanung und Umwelt
11.09.2023 00:00;30;16;14;Sonnig;16;16;0;Stadt Konstanz, Amt fuer Stadtplanung und Umwelt
11.09.2023 01:00;17;4;13;Sonnig;16;16;0;Stadt Konstanz, Amt fuer Stadtplanung und Umwelt
11.09.2023 02:00;10;3;7;Sonnig;16;16;0;Stadt Konstanz, Amt fuer Stadtplanung und Umwelt
11.09.2023 03:00;9;4;5;Leichter Nebel;15;15;0;Stadt Konstanz, Amt fuer Stadtplanung und Umwelt
11.09.2023 04:00;17;10;7;Leichter Nebel;15;15;0;Stadt Konstanz, Amt fuer Stadtplanung und Umwelt
11.09.2023 05:00;55;39;16;Sonnig;15;15;0;Stadt Konstanz, Amt fuer Stadtplanung und Umwelt
11.09.2023 06:00;211;109;102;Sonnig;14;14;0;Stadt Konstanz, Amt fuer Stadtplanung und Umwelt
11.09.2023 07:00;900;636;264;Sonnig;16;16;0;Stadt Konstanz, Amt fuer Stadtplanung und Umwelt
11.09.2023 08:00;966;477;489;Sonnig;19;19;0;Stadt Konstanz, Amt fuer Stadtplanung und Umwelt
11.09.2023 09:00;719;426;293;Sonnig;22;22;0;Stadt Konstanz, Amt fuer Stadtplanung und Umwelt
11.09.2023 10:00;631;341;290;Sonnig;24;26;0;Stadt Konstanz, Amt fuer Stadtplanung und Umwelt
11.09.2023 11:00;635;288;347;Sonnig;27;27;0;Stadt Konstanz, Amt fuer Stadtplanung und Umwelt
11.09.2023 12:00;930;462;468;Sonnig;28;29;0;Stadt Konstanz, Amt fuer Stadtplanung und Umwelt
11.09.2023 13:00;1047;401;646;Sonnig;30;30;0;Stadt Konstanz, Amt fuer Stadtplanung und Umwelt
11.09.2023 14:00;830;419;411;Sonnig;30;30;0;Stadt Konstanz, Amt fuer Stadtplanung und Umwelt
11.09.2023 15:00;874;448;426;Sonnig;30;29;0;Stadt Konstanz, Amt fuer Stadtplanung und Umwelt
11.09.2023 16:00;1098;519;579;Sonnig;29;29;0;Stadt Konstanz, Amt fuer Stadtplanung und Umwelt
11.09.2023 17:00;1086;532;554;Sonnig;27;28;0;Stadt Konstanz, Amt fuer Stadtplanung und Umwelt
11.09.2023 18:00;1072;485;587;Sonnig;23;25;0;Stadt Konstanz, Amt fuer Stadtplanung und Umwelt
11.09.2023 19:00;772;313;459;Sonnig;20;20;0;Stadt Konstanz, Amt fuer Stadtplanung und Umwelt
11.09.2023 20:00;543;205;338;Sonnig;19;19;0;Stadt Konstanz, Amt fuer Stadtplanung und Umwelt
11.09.2023 21:00;347;137;210;Sonnig;18;18;0;Stadt Konstanz, Amt fuer Stadtplanung und Umwelt
11.09.2023 22:00;218;83;135;Sonnig;18;18;0;Stadt Konstanz, Amt fuer Stadtplanung und Umwelt
11.09.2023 23:00;87;43;44;Sonnig;17;17;0;Stadt Konstanz, Amt fuer Stadtplanung und Umwelt
12.09.2023 00:00;40;17;23;Sonnig;16;16;0;Stadt Konstanz, Amt fuer Stadtplanung und Umwelt
12.09.2023 01:00;24;6;18;Sonnig;16;16;0;Stadt Konstanz, Amt fuer Stadtplanung und Umwelt
12.09.2023 02:00;13;2;11;Sonnig;15;15;0;Stadt Konstanz, Amt fuer Stadtplanung und Umwelt
12.09.2023 03:00;5;0;5;Sonnig;14;14;0;Stadt Konstanz, Amt fuer Stadtplanung und Umwelt
12.09.2023 04:00;13;6;7;Sonnig;14;14;0;Stadt Konstanz, Amt fuer Stadtplanung und Umwelt
12.09.2023 05:00;66;44;22;Sonnig;14;14;0;Stadt Konstanz, Amt fuer Stadtplanung und Umwelt
12.09.2023 06:00;235;140;95;Sonnig;13;13;0;Stadt Konstanz, Amt fuer Stadtplanung und Umwelt
12.09.2023 07:00;1113;715;398;Sonnig;15;15;0;Stadt Konstanz, Amt fuer Stadtplanung und Umwelt
12.09.2023 08:00;913;532;381;Sonnig;18;18;0;Stadt Konstanz, Amt fuer Stadtplanung und Umwelt
12.09.2023 09:00;742;430;312;Leicht bewoelkt;21;21;0;Stadt Konstanz, Amt fuer Stadtplanung und Umwelt
12.09.2023 10:00;614;331;283;Leicht bewoelkt;23;25;0;Stadt Konstanz, Amt fuer Stadtplanung und Umwelt
12.09.2023 11:00;752;359;393;Leicht bewoelkt;25;26;0;Stadt Konstanz, Amt fuer Stadtplanung und Umwelt
12.09.2023 12:00;776;339;437;Leicht bewoelkt;27;27;0;Stadt Konstanz, Amt fuer Stadtplanung und Umwelt
12.09.2023 13:00;1100;497;603;Leicht bewoelkt;28;28;0;Stadt Konstanz, Amt fuer Stadtplanung und Umwelt
12.09.2023 14:00;915;464;451;Leicht bewoelkt;28;28;0;Stadt Konstanz, Amt fuer Stadtplanung und Umwelt
12.09.2023 15:00;1081;481;600;Stellenweise Gewitter und Niederschlaege;28;28;0;Stadt Konstanz, Amt fuer Stadtplanung und Umwelt
12.09.2023 16:00;1322;560;762;Stellenweise Gewitter und Niederschlaege;27;28;0;Stadt Konstanz, Amt fuer Stadtplanung und Umwelt
12.09.2023 17:00;1033;452;581;Sonnig;26;27;0;Stadt Konstanz, Amt fuer Stadtplanung und Umwelt
12.09.2023 18:00;861;396;465;Sonnig;22;25;0;Stadt Konstanz, Amt fuer Stadtplanung und Umwelt
12.09.2023 19:00;615;283;332;Sonnig;20;20;0;Stadt Konstanz, Amt fuer Stadtplanung und Umwelt
12.09.2023 20:00;445;216;229;Leicht bewoelkt;18;18;0;Stadt Konstanz, Amt fuer Stadtplanung und Umwelt
12.09.2023 21:00;309;117;192;Sonnig;17;17;0;Stadt Konstanz, Amt fuer Stadtplanung und Umwelt
12.09.2023 22:00;204;76;128;Sonnig;15;15;0;Stadt Konstanz, Amt fuer Stadtplanung und Umwelt
12.09.2023 23:00;96;28;68;Leichter Nebel;15;15;0;Stadt Konstanz, Amt fuer Stadtplanung und Umwelt
13.09.2023 00:00;64;25;39;Leichter Nebel;14;15;0;Stadt Konstanz, Amt fuer Stadtplanung und Umwelt
13.09.2023 01:00;18;7;11;Leichter Nebel;14;14;0;Stadt Konstanz, Amt fuer Stadtplanung und Umwelt
13.09.2023 02:00;16;7;9;Leichter Nebel;14;14;0;Stadt Konstanz, Amt fuer Stadtplanung und Umwelt
13.09.2023 03:00;8;2;6;Nebel;14;14;0;Stadt Konstanz, Amt fuer Stadtplanung und Umwelt
13.09.2023 04:00;12;6;6;Nebel;15;15;0;Stadt Konstanz, Amt fuer Stadtplanung und Umwelt
13.09.2023 05:00;57;39;18;Nebel;16;16;0;Stadt Konstanz, Amt fuer Stadtplanung und Umwelt
13.09.2023 06:00;212;112;100;Nebel;16;16;0;Stadt Konstanz, Amt fuer Stadtplanung und Umwelt
13.09.2023 07:00;775;409;366;Nebel;16;16;0;Stadt Konstanz, Amt fuer Stadtplanung und Umwelt
13.09.2023 08:00;788;417;371;Nebel;16;16;0;Stadt Konstanz, Amt fuer Stadtplanung und Umwelt
13.09.2023 09:00;813;564;249;Nebel;16;16;0;Stadt Konstanz, Amt fuer Stadtplanung und Umwelt
13.09.2023 10:00;450;233;217;Leichter Nebel;17;17;0;Stadt Konstanz, Amt fuer Stadtplanung und Umwelt
13.09.2023 11:00;502;256;246;Leicht bewoelkt;18;18;0;Stadt Konstanz, Amt fuer Stadtplanung und Umwelt
13.09.2023 12:00;708;346;362;Bedeckt;18;18;0;Stadt Konstanz, Amt fuer Stadtplanung und Umwelt
13.09.2023 13:00;963;425;538;Leicht bewoelkt;18;18;0;Stadt Konstanz, Amt fuer Stadtplanung und Umwelt
13.09.2023 14:00;637;329;308;Bewoelkt;18;18;0;Stadt Konstanz, Amt fuer Stadtplanung und Umwelt
13.09.2023 15:00;912;426;486;Leicht bewoelkt;18;18;0;Stadt Konstanz, Amt fuer Stadtplanung und Umwelt
13.09.2023 16:00;839;390;449;Leicht bewoelkt;19;19;0;Stadt Konstanz, Amt fuer Stadtplanung und Umwelt
13.09.2023 17:00;885;409;476;Leicht bewoelkt;19;19;0;Stadt Konstanz, Amt fuer Stadtplanung und Umwelt
13.09.2023 18:00;495;197;298;Leicht bewoelkt;17;17;0;Stadt Konstanz, Amt fuer Stadtplanung und Umwelt
13.09.2023 19:00;323;154;169;Leichter Nebel;15;15;0;Stadt Konstanz, Amt fuer Stadtplanung und Umwelt
13.09.2023 20:00;216;82;134;Leichter Nebel;15;15;0;Stadt Konstanz, Amt fuer Stadtplanung und Umwelt
13.09.2023 21:00;197;88;109;Leichter Nebel;14;15;0;Stadt Konstanz, Amt fuer Stadtplanung und Umwelt
13.09.2023 22:00;124;58;66;Leichter Nebel;14;15;0;Stadt Konstanz, Amt fuer Stadtplanung und Umwelt
13.09.2023 23:00;62;20;42;Leichter Nebel;14;15;0;Stadt Konstanz, Amt fuer Stadtplanung und Umwelt
14.09.2023 00:00;48;16;32;Nebel;15;15;0;Stadt Konstanz, Amt fuer Stadtplanung und Umwelt
14.09.2023 01:00;23;2;21;Nebel;15;15;0;Stadt Konstanz, Amt fuer Stadtplanung und Umwelt
14.09.2023 02:00;12;4;8;Bedeckt;15;15;0;Stadt Konstanz, Amt fuer Stadtplanung und Umwelt
14.09.2023 03:00;7;5;2;Nebel;15;15;0;Stadt Konstanz, Amt fuer Stadtplanung und Umwelt
14.09.2023 04:00;7;3;4;Nebel;15;16;0;Stadt Konstanz, Amt fuer Stadtplanung und Umwelt
14.09.2023 05:00;52;33;19;Nebel;15;16;0;Stadt Konstanz, Amt fuer Stadtplanung und Umwelt
14.09.2023 06:00;190;98;92;Nebel;15;15;0;Stadt Konstanz, Amt fuer Stadtplanung und Umwelt
14.09.2023 07:00;960;599;361;Leichter Nebel;15;15;0;Stadt Konstanz, Amt fuer Stadtplanung und Umwelt
14.09.2023 08:00;738;410;328;Bedeckt;16;16;0;Stadt Konstanz, Amt fuer Stadtplanung und Umwelt
14.09.2023 09:00;667;380;287;Bedeckt;17;17;0;Stadt Konstanz, Amt fuer Stadtplanung und Umwelt
14.09.2023 10:00;481;260;221;Bewoelkt;18;18;0;Stadt Konstanz, Amt fuer Stadtplanung und Umwelt
14.09.2023 11:00;646;326;320;Leicht bewoelkt;18;18;0;Stadt Konstanz, Amt fuer Stadtplanung und Umwelt
14.09.2023 12:00;729;329;400;Leicht bewoelkt;18;18;0;Stadt Konstanz, Amt fuer Stadtplanung und Umwelt
14.09.2023 13:00;998;441;557;Leicht bewoelkt;19;19;0;Stadt Konstanz, Amt fuer Stadtplanung und Umwelt
14.09.2023 14:00;811;402;409;Leicht bewoelkt;20;20;0;Stadt Konstanz, Amt fuer Stadtplanung und Umwelt
14.09.2023 15:00;1025;471;554;Leicht bewoelkt;20;20;0;Stadt Konstanz, Amt fuer Stadtplanung und Umwelt
14.09.2023 16:00;1010;510;500;Leicht bewoelkt;20;20;0;Stadt Konstanz, Amt fuer Stadtplanung und Umwelt
14.09.2023 17:00;1180;562;618;Leicht bewoelkt;19;19;0;Stadt Konstanz, Amt fuer Stadtplanung und Umwelt
14.09.2023 18:00;894;350;544;Leicht bewoelkt;17;17;0;Stadt Konstanz, Amt fuer Stadtplanung und Umwelt
14.09.2023 19:00;636;298;338;Bewoelkt;15;15;0;Stadt Konstanz, Amt fuer Stadtplanung und Umwelt
14.09.2023 20:00;449;212;237;Leicht bewoelkt;15;15;0;Stadt Konstanz, Amt fuer Stadtplanung und Umwelt
14.09.2023 21:00;286;106;180;Leichter Nebel;14;14;0;Stadt Konstanz, Amt fuer Stadtplanung und Umwelt
14.09.2023 22:00;215;78;137;Leichter Nebel;14;14;0;Stadt Konstanz, Amt fuer Stadtplanung und Umwelt
14.09.2023 23:00;94;32;62;Leichter Nebel;14;13;0;Stadt Konstanz, Amt fuer Stadtplanung und Umwelt
15.09.2023 00:00;56;24;32;Sonnig;13;13;0;Stadt Konstanz, Amt fuer Stadtplanung und Umwelt
15.09.2023 01:00;32;12;20;Sonnig;12;12;0;Stadt Konstanz, Amt fuer Stadtplanung und Umwelt
15.09.2023 02:00;12;4;8;Sonnig;12;11;0;Stadt Konstanz, Amt fuer Stadtplanung und Umwelt
15.09.2023 03:00;4;1;3;Sonnig;11;11;0;Stadt Konstanz, Amt fuer Stadtplanung und Umwelt
15.09.2023 04:00;9;5;4;Leicht bewoelkt;11;10;0;Stadt Konstanz, Amt fuer Stadtplanung und Umwelt
15.09.2023 05:00;55;39;16;Leichter Nebel;11;10;0;Stadt Konstanz, Amt fuer Stadtplanung und Umwelt
15.09.2023 06:00;175;100;75;Leichter Nebel;10;10;0;Stadt Konstanz, Amt fuer Stadtplanung und Umwelt
15.09.2023 07:00;1008;649;359;Leicht bewoelkt;12;12;0;Stadt Konstanz, Amt fuer Stadtplanung und Umwelt
15.09.2023 08:00;757;439;318;Leicht bewoelkt;15;16;0;Stadt Konstanz, Amt fuer Stadtplanung und Umwelt
15.09.2023 09:00;750;437;313;Leicht bewoelkt;17;17;0;Stadt Konstanz, Amt fuer Stadtplanung und Umwelt
15.09.2023 10:00;601;321;280;Leicht bewoelkt;19;19;0;Stadt Konstanz, Amt fuer Stadtplanung und Umwelt
15.09.2023 11:00;697;351;346;Sonnig;21;21;0;Stadt Konstanz, Amt fuer Stadtplanung und Umwelt
15.09.2023 12:00;750;335;415;Sonnig;23;25;0;Stadt Konstanz, Amt fuer Stadtplanung und Umwelt
15.09.2023 13:00;1228;522;706;Sonnig;24;25;0;Stadt Konstanz, Amt fuer Stadtplanung und Umwelt
15.09.2023 14:00;992;493;499;Sonnig;24;26;0;Stadt Konstanz, Amt fuer Stadtplanung und Umwelt
15.09.2023 15:00;917;410;507;Sonnig;24;26;0;Stadt Konstanz, Amt fuer Stadtplanung und Umwelt
15.09.2023 16:00;941;437;504;Sonnig;24;25;0;Stadt Konstanz, Amt fuer Stadtplanung und Umwelt
15.09.2023 17:00;938;433;505;Sonnig;23;25;0;Stadt Konstanz, Amt fuer Stadtplanung und Umwelt
15.09.2023 18:00;901;399;502;Sonnig;20;20;0;Stadt Konstanz, Amt fuer Stadtplanung und Umwelt
15.09.2023 19:00;701;341;360;Sonnig;16;16;0;Stadt Konstanz, Amt fuer Stadtplanung und Umwelt
15.09.2023 20:00;490;250;240;Sonnig;15;15;0;Stadt Konstanz, Amt fuer Stadtplanung und Umwelt
15.09.2023 21:00;369;170;199;Leichter Nebel;15;15;0;Stadt Konstanz, Amt fuer Stadtplanung und Umwelt
15.09.2023 22:00;336;127;209;Leichter Nebel;14;15;0;Stadt Konstanz, Amt fuer Stadtplanung und Umwelt
15.09.2023 23:00;222;85;137;Leichter Nebel;14;14;0;Stadt Konstanz, Amt fuer Stadtplanung und Umwelt
16.09.2023 00:00;143;44;99;Leichter Nebel;14;14;0;Stadt Konstanz, Amt fuer Stadtplanung und Umwelt
16.09.2023 01:00;126;46;80;Leichter Nebel;13;13;0;Stadt Konstanz, Amt fuer Stadtplanung und Umwelt
16.09.2023 02:00;75;24;51;Leichter Nebel;13;14;0;Stadt Konstanz, Amt fuer Stadtplanung und Umwelt
16.09.2023 03:00;42;4;38;Leichter Nebel;13;13;0;Stadt Konstanz, Amt fuer Stadtplanung und Umwelt
16.09.2023 04:00;22;12;10;Nebel;12;12;0;Stadt Konstanz, Amt fuer Stadtplanung und Umwelt
16.09.2023 05:00;38;18;20;Nebel;12;12;0;Stadt Konstanz, Amt fuer Stadtplanung und Umwelt
16.09.2023 06:00;44;34;10;Nebel;12;12;0;Stadt Konstanz, Amt fuer Stadtplanung und Umwelt
16.09.2023 07:00;94;52;42;Leichter Nebel;13;14;0;Stadt Konstanz, Amt fuer Stadtplanung und Umwelt
16.09.2023 08:00;215;118;97;Leicht bewoelkt;16;16;0;Stadt Konstanz, Amt fuer Stadtplanung und Umwelt
16.09.2023 09:00;444;272;172;Leicht bewoelkt;18;18;0;Stadt Konstanz, Amt fuer Stadtplanung und Umwelt
16.09.2023 10:00;593;327;266;Leicht bewoelkt;20;20;0;Stadt Konstanz, Amt fuer Stadtplanung und Umwelt
16.09.2023 11:00;691;405;286;Sonnig;22;22;0;Stadt Konstanz, Amt fuer Stadtplanung und Umwelt
16.09.2023 12:00;751;404;347;Leicht bewoelkt;22;25;0;Stadt Konstanz, Amt fuer Stadtplanung und Umwelt
16.09.2023 13:00;714;381;333;Leicht bewoelkt;24;25;0;Stadt Konstanz, Amt fuer Stadtplanung und Umwelt
16.09.2023 14:00;931;480;451;Sonnig;25;26;0;Stadt Konstanz, Amt fuer Stadtplanung und Umwelt
16.09.2023 15:00;844;427;417;Sonnig;25;26;0;Stadt Konstanz, Amt fuer Stadtplanung und Umwelt
16.09.2023 16:00;800;410;390;Sonnig;25;26;0;Stadt Konstanz, Amt fuer Stadtplanung und Umwelt
16.09.2023 17:00;785;336;449;Leicht bewoelkt;24;25;0;Stadt Konstanz, Amt fuer Stadtplanung und Umwelt
16.09.2023 18:00;732;356;376;Sonnig;20;20;0;Stadt Konstanz, Amt fuer Stadtplanung und Umwelt
16.09.2023 19:00;577;293;284;Stellenweiser Regenfall;17;17;0.2;Stadt Konstanz, Amt fuer Stadtplanung und Umwelt
16.09.2023 20:00;406;180;226;Leichter Regenschauer;16;16;0.9;Stadt Konstanz, Amt fuer Stadtplanung und Umwelt
16.09.2023 21:00;304;143;161;Stellenweiser Regenfall;16;16;0.1;Stadt Konstanz, Amt fuer Stadtplanung und Umwelt
16.09.2023 22:00;287;104;183;Leicht bewoelkt;16;16;0;Stadt Konstanz, Amt fuer Stadtplanung und Umwelt
16.09.2023 23:00;273;59;214;Leichter Nebel;15;15;0;Stadt Konstanz, Amt fuer Stadtplanung und Umwelt
17.09.2023 00:00;192;39;153;Leichter Nebel;14;14;0;Stadt Konstanz, Amt fuer Stadtplanung und Umwelt
17.09.2023 01:00;126;36;90;Leichter Nebel;14;14;0;Stadt Konstanz, Amt fuer Stadtplanung und Umwelt
17.09.2023 02:00;71;21;50;Leichter Nebel;13;13;0;Stadt Konstanz, Amt fuer Stadtplanung und Umwelt
17.09.2023 03:00;62;27;35;Leichter Nebel;13;13;0;Stadt Konstanz, Amt fuer Stadtplanung und Umwelt
17.09.2023 04:00;32;17;15;Leichter Nebel;13;13;0;Stadt Konstanz, Amt fuer Stadtplanung und Umwelt
17.09.2023 05:00;27;16;11;Leichter Nebel;12;12;0;Stadt Konstanz, Amt fuer Stadtplanung und Umwelt
17.09.2023 06:00;31;19;12;Leicht bewoelkt;12;12;0;Stadt Konstanz, Amt fuer Stadtplanung und Umwelt
17.09.2023 07:00;56;35;21;Leichter Nebel;13;13;0;Stadt Konstanz, Amt fuer Stadtplanung und Umwelt
17.09.2023 08:00;140;60;80;Leicht bewoelkt;16;16;0;Stadt Konstanz, Amt fuer Stadtplanung und Umwelt
17.09.2023 09:00;299;168;131;Leicht bewoelkt;18;18;0;Stadt Konstanz, Amt fuer Stadtplanung und Umwelt
17.09.2023 10:00;413;190;223;Sonnig;21;21;0;Stadt Konstanz, Amt fuer Stadtplanung und Umwelt
17.09.2023 11:00;539;271;268;Sonnig;24;25;0;Stadt Konstanz, Amt fuer Stadtplanung und Umwelt
17.09.2023 12:00;578;284;294;Sonnig;25;26;0;Stadt Konstanz, Amt fuer Stadtplanung und Umwelt
17.09.2023 13:00;612;309;303;Sonnig;26;26;0;Stadt Konstanz, Amt fuer Stadtplanung und Umwelt
17.09.2023 14:00;628;304;324;Sonnig;26;27;0;Stadt Konstanz, Amt fuer Stadtplanung und Umwelt
17.09.2023 15:00;590;298;292;Sonnig;26;27;0;Stadt Konstanz, Amt fuer Stadtplanung und Umwelt
17.09.2023 16:00;588;330;258;Sonnig;25;26;0;Stadt Konstanz, Amt fuer Stadtplanung und Umwelt
17.09.2023 17:00;591;271;320;Sonnig;23;25;0;Stadt Konstanz, Amt fuer Stadtplanung und Umwelt
17.09.2023 18:00;572;269;303;Sonnig;20;20;0;Stadt Konstanz, Amt fuer Stadtplanung und Umwelt
17.09.2023 19:00;520;249;271;Sonnig;18;18;0;Stadt Konstanz, Amt fuer Stadtplanung und Umwelt
17.09.2023 20:00;272;120;152;Sonnig;17;17;0;Stadt Konstanz, Amt fuer Stadtplanung und Umwelt
17.09.2023 21:00;181;75;106;Sonnig;16;16;0;Stadt Konstanz, Amt fuer Stadtplanung und Umwelt
17.09.2023 22:00;122;39;83;Leicht bewoelkt;16;16;0;Stadt Konstanz, Amt fuer Stadtplanung und Umwelt
17.09.2023 23:00;39;16;23;Sonnig;16;16;0;Stadt Konstanz, Amt fuer Stadtplanung und Umwelt
18.09.2023 00:00;34;13;21;Leichter Nebel;15;16;0;Stadt Konstanz, Amt fuer Stadtplanung und Umwelt
18.09.2023 01:00;7;4;3;Leichter Nebel;14;14;0;Stadt Konstanz, Amt fuer Stadtplanung und Umwelt
18.09.2023 02:00;16;4;12;Leichter Nebel;14;14;0;Stadt Konstanz, Amt fuer Stadtplanung und Umwelt
18.09.2023 03:00;4;0;4;Leichter Nebel;14;14;0;Stadt Konstanz, Amt fuer Stadtplanung und Umwelt
18.09.2023 04:00;19;13;6;Leichter Nebel;14;14;0;Stadt Konstanz, Amt fuer Stadtplanung und Umwelt
18.09.2023 05:00;57;38;19;Nebel;13;13;0;Stadt Konstanz, Amt fuer Stadtplanung und Umwelt
18.09.2023 06:00;204;111;93;Leichter Nebel;13;13;0;Stadt Konstanz, Amt fuer Stadtplanung und Umwelt
18.09.2023 07:00;1081;679;402;Bewoelkt;14;15;0;Stadt Konstanz, Amt fuer Stadtplanung und Umwelt
18.09.2023 08:00;745;424;321;Leicht bewoelkt;17;17;0;Stadt Konstanz, Amt fuer Stadtplanung und Umwelt
18.09.2023 09:00;706;392;314;Sonnig;19;19;0;Stadt Konstanz, Amt fuer Stadtplanung und Umwelt
18.09.2023 10:00;430;203;227;Leicht bewoelkt;21;21;0;Stadt Konstanz, Amt fuer Stadtplanung und Umwelt
18.09.2023 11:00;353;153;200;Leicht bewoelkt;22;22;0;Stadt Konstanz, Amt fuer Stadtplanung und Umwelt
18.09.2023 12:00;378;161;217;Bedeckt;23;25;0;Stadt Konstanz, Amt fuer Stadtplanung und Umwelt
18.09.2023 13:00;664;265;399;Leichter Regenfall;18;18;2.3;Stadt Konstanz, Amt fuer Stadtplanung und Umwelt
18.09.2023 14:00;491;238;253;Maeßiger Regenfall;16;16;2.7;Stadt Konstanz, Amt fuer Stadtplanung und Umwelt
18.09.2023 15:00;846;419;427;Maeßiger Regenfall;15;15;6;Stadt Konstanz, Amt fuer Stadtplanung und Umwelt
18.09.2023 16:00;747;310;437;Leichter Regenfall;16;16;1.4;Stadt Konstanz, Amt fuer Stadtplanung und Umwelt
18.09.2023 17:00;886;400;486;Nebel;16;16;0.1;Stadt Konstanz, Amt fuer Stadtplanung und Umwelt
18.09.2023 18:00;755;343;412;Nebel;16;16;0;Stadt Konstanz, Amt fuer Stadtplanung und Umwelt
18.09.2023 19:00;549;233;316;Nebel;15;15;0;Stadt Konstanz, Amt fuer Stadtplanung und Umwelt
18.09.2023 20:00;330;153;177;Nebel;15;15;0;Stadt Konstanz, Amt fuer Stadtplanung und Umwelt
18.09.2023 21:00;237;95;142;Nieselregen;15;15;0.3;Stadt Konstanz, Amt fuer Stadtplanung und Umwelt
18.09.2023 22:00;164;61;103;Leichter Regenschauer;14;14;0.5;Stadt Konstanz, Amt fuer Stadtplanung und Umwelt
18.09.2023 23:00;80;30;50;Leichter Regenschauer;14;14;0.3;Stadt Konstanz, Amt fuer Stadtplanung und Umwelt
19.09.2023 00:00;34;15;19;Leichter Nebel;12;13;0;Stadt Konstanz, Amt fuer Stadtplanung und Umwelt
19.09.2023 01:00;23;9;14;Leichter Nebel;13;13;0.1;Stadt Konstanz, Amt fuer Stadtplanung und Umwelt
19.09.2023 02:00;18;6;12;Nebel;12;12;0;Stadt Konstanz, Amt fuer Stadtplanung und Umwelt
19.09.2023 03:00;9;6;3;Nebel;12;12;0;Stadt Konstanz, Amt fuer Stadtplanung und Umwelt
19.09.2023 04:00;10;4;6;Nebel;12;11;0.1;Stadt Konstanz, Amt fuer Stadtplanung und Umwelt
19.09.2023 05:00;53;37;16;Nebel;12;12;0;Stadt Konstanz, Amt fuer Stadtplanung und Umwelt
19.09.2023 06:00;218;119;99;Nebel;12;11;0;Stadt Konstanz, Amt fuer Stadtplanung und Umwelt
19.09.2023 07:00;1015;637;378;Nebel;13;13;0;Stadt Konstanz, Amt fuer Stadtplanung und Umwelt
19.09.2023 08:00;952;513;439;Bedeckt;15;14;0;Stadt Konstanz, Amt fuer Stadtplanung und Umwelt
19.09.2023 09:00;698;419;279;Stellenweiser Regenfall;15;15;0;Stadt Konstanz, Amt fuer Stadtplanung und Umwelt
19.09.2023 10:00;555;310;245;Stellenweiser Regenfall;16;16;0.1;Stadt Konstanz, Amt fuer Stadtplanung und Umwelt
19.09.2023 11:00;700;309;391;Stellenweiser Regenfall;18;18;0;Stadt Konstanz, Amt fuer Stadtplanung und Umwelt
19.09.2023 12:00;763;324;439;Stellenweiser Regenfall;20;20;0;Stadt Konstanz, Amt fuer Stadtplanung und Umwelt
19.09.2023 13:00;942;433;509;Stellenweiser Regenfall;20;20;0;Stadt Konstanz, Amt fuer Stadtplanung und Umwelt
19.09.2023 14:00;766;374;392;Bewoelkt;21;21;0;Stadt Konstanz, Amt fuer Stadtplanung und Umwelt
19.09.2023 15:00;1101;560;541;Leicht bewoelkt;21;21;0;Stadt Konstanz, Amt fuer Stadtplanung und Umwelt
19.09.2023 16:00;1080;490;590;Sonnig;21;21;0;Stadt Konstanz, Amt fuer Stadtplanung und Umwelt
19.09.2023 17:00;1279;595;684;Sonnig;20;20;0;Stadt Konstanz, Amt fuer Stadtplanung und Umwelt
19.09.2023 18:00;1013;422;591;Sonnig;16;16;0;Stadt Konstanz, Amt fuer Stadtplanung und Umwelt
19.09.2023 19:00;775;382;393;Sonnig;13;14;0;Stadt Konstanz, Amt fuer Stadtplanung und Umwelt
19.09.2023 20:00;482;213;269;Sonnig;12;12;0;Stadt Konstanz, Amt fuer Stadtplanung und Umwelt
19.09.2023 21:00;331;108;223;Sonnig;12;12;0;Stadt Konstanz, Amt fuer Stadtplanung und Umwelt
19.09.2023 22:00;218;91;127;Leicht bewoelkt;11;11;0;Stadt Konstanz, Amt fuer Stadtplanung und Umwelt
19.09.2023 23:00;127;50;77;Leicht bewoelkt;11;11;0;Stadt Konstanz, Amt fuer Stadtplanung und Umwelt
20.09.2023 00:00;68;27;41;Sonnig;10;10;0;Stadt Konstanz, Amt fuer Stadtplanung und Umwelt
20.09.2023 01:00;34;15;19;Sonnig;10;10;0;Stadt Konstanz, Amt fuer Stadtplanung und Umwelt
20.09.2023 02:00;12;5;7;Sonnig;10;10;0;Stadt Konstanz, Amt fuer Stadtplanung und Umwelt
20.09.2023 03:00;11;6;5;Sonnig;9;9;0;Stadt Konstanz, Amt fuer Stadtplanung und Umwelt
20.09.2023 04:00;15;11;4;Sonnig;9;9;0;Stadt Konstanz, Amt fuer Stadtplanung und Umwelt
20.09.2023 05:00;63;38;25;Sonnig;9;9;0;Stadt Konstanz, Amt fuer Stadtplanung und Umwelt
20.09.2023 06:00;242;133;109;Sonnig;9;9;0;Stadt Konstanz, Amt fuer Stadtplanung und Umwelt
20.09.2023 07:00;1096;670;426;Sonnig;10;10;0;Stadt Konstanz, Amt fuer Stadtplanung und Umwelt
20.09.2023 08:00;820;471;349;Sonnig;14;14;0;Stadt Konstanz, Amt fuer Stadtplanung und Umwelt
20.09.2023 09:00;758;435;323;Sonnig;16;16;0;Stadt Konstanz, Amt fuer Stadtplanung und Umwelt
20.09.2023 10:00;622;328;294;Sonnig;19;19;0;Stadt Konstanz, Amt fuer Stadtplanung und Umwelt
20.09.2023 11:00;660;325;335;Sonnig;21;21;0;Stadt Konstanz, Amt fuer Stadtplanung und Umwelt
20.09.2023 12:00;795;347;448;Sonnig;23;25;0;Stadt Konstanz, Amt fuer Stadtplanung und Umwelt
20.09.2023 13:00;1096;529;567;Sonnig;24;25;0;Stadt Konstanz, Amt fuer Stadtplanung und Umwelt
20.09.2023 14:00;946;452;494;Sonnig;24;25;0;Stadt Konstanz, Amt fuer Stadtplanung und Umwelt
20.09.2023 15:00;1065;495;570;Sonnig;24;25;0;Stadt Konstanz, Amt fuer Stadtplanung und Umwelt
20.09.2023 16:00;1123;517;606;Sonnig;23;25;0;Stadt Konstanz, Amt fuer Stadtplanung und Umwelt
20.09.2023 17:00;1210;580;630;Sonnig;22;22;0;Stadt Konstanz, Amt fuer Stadtplanung und Umwelt
20.09.2023 18:00;1061;504;557;Sonnig;18;18;0;Stadt Konstanz, Amt fuer Stadtplanung und Umwelt
20.09.2023 19:00;750;345;405;Leicht bewoelkt;16;16;0;Stadt Konstanz, Amt fuer Stadtplanung und Umwelt
20.09.2023 20:00;562;261;301;Leicht bewoelkt;15;15;0;Stadt Konstanz, Amt fuer Stadtplanung und Umwelt
20.09.2023 21:00;352;106;246;Leicht bewoelkt;14;14;0;Stadt Konstanz, Amt fuer Stadtplanung und Umwelt
20.09.2023 22:00;273;83;190;Leicht bewoelkt;14;14;0;Stadt Konstanz, Amt fuer Stadtplanung und Umwelt
20.09.2023 23:00;147;52;95;Leicht bewoelkt;13;13;0;Stadt Konstanz, Amt fuer Stadtplanung und Umwelt
21.09.2023 00:00;56;18;38;Sonnig;12;12;0;Stadt Konstanz, Amt fuer Stadtplanung und Umwelt
21.09.2023 01:00;37;12;25;Sonnig;12;12;0;Stadt Konstanz, Amt fuer Stadtplanung und Umwelt
21.09.2023 02:00;16;4;12;Sonnig;11;11;0;Stadt Konstanz, Amt fuer Stadtplanung und Umwelt
21.09.2023 03:00;9;4;5;Sonnig;11;11;0;Stadt Konstanz, Amt fuer Stadtplanung und Umwelt
21.09.2023 04:00;6;1;5;Leicht bewoelkt;11;11;0;Stadt Konstanz, Amt fuer Stadtplanung und Umwelt
21.09.2023 05:00;64;47;17;Leichter Nebel;11;11;0;Stadt Konstanz, Amt fuer Stadtplanung und Umwelt
21.09.2023 06:00;216;109;107;Leichter Nebel;11;11;0;Stadt Konstanz, Amt fuer Stadtplanung und Umwelt
21.09.2023 07:00;1050;619;431;Sonnig;12;12;0;Stadt Konstanz, Amt fuer Stadtplanung und Umwelt
21.09.2023 08:00;869;488;381;Sonnig;15;15;0;Stadt Konstanz, Amt fuer Stadtplanung und Umwelt
21.09.2023 09:00;717;428;289;Sonnig;17;17;0;Stadt Konstanz, Amt fuer Stadtplanung und Umwelt
21.09.2023 10:00;579;321;258;Sonnig;20;20;0;Stadt Konstanz, Amt fuer Stadtplanung und Umwelt
21.09.2023 11:00;661;318;343;Sonnig;22;22;0;Stadt Konstanz, Amt fuer Stadtplanung und Umwelt
21.09.2023 12:00;831;362;469;Sonnig;23;25;0;Stadt Konstanz, Amt fuer Stadtplanung und Umwelt
21.09.2023 13:00;1054;388;666;Sonnig;24;25;0;Stadt Konstanz, Amt fuer Stadtplanung und Umwelt
21.09.2023 14:00;807;378;429;Sonnig;24;25;0;Stadt Konstanz, Amt fuer Stadtplanung und Umwelt
21.09.2023 15:00;1168;573;595;Sonnig;24;25;0;Stadt Konstanz, Amt fuer Stadtplanung und Umwelt
21.09.2023 16:00;1091;514;577;Sonnig;24;25;0;Stadt Konstanz, Amt fuer Stadtplanung und Umwelt
21.09.2023 17:00;1211;569;642;Sonnig;22;25;0;Stadt Konstanz, Amt fuer Stadtplanung und Umwelt
21.09.2023 18:00;1022;473;549;Sonnig;18;18;0;Stadt Konstanz, Amt fuer Stadtplanung und Umwelt
21.09.2023 19:00;729;347;382;Stellenweiser Nieselregen;16;16;0.4;Stadt Konstanz, Amt fuer Stadtplanung und Umwelt
21.09.2023 20:00;464;209;255;Leichter Regenschauer;15;15;0.4;Stadt Konstanz, Amt fuer Stadtplanung und Umwelt
21.09.2023 21:00;351;123;228;Stellenweiser Nieselregen;15;15;0.4;Stadt Konstanz, Amt fuer Stadtplanung und Umwelt
21.09.2023 22:00;249;75;174;Stellenweiser Regenfall;15;14;0.1;Stadt Konstanz, Amt fuer Stadtplanung und Umwelt
21.09.2023 23:00;96;34;62;Leichter Nebel;14;13;0;Stadt Konstanz, Amt fuer Stadtplanung und Umwelt
22.09.2023 00:00;49;19;30;Leichter Regenschauer;13;13;0.5;Stadt Konstanz, Amt fuer Stadtplanung und Umwelt
22.09.2023 01:00;28;8;20;Nieselregen;13;12;0.4;Stadt Konstanz, Amt fuer Stadtplanung und Umwelt
22.09.2023 02:00;11;2;9;Leichter Regenfall;12;11;1.6;Stadt Konstanz, Amt fuer Stadtplanung und Umwelt
22.09.2023 03:00;9;3;6;Nieselregen;12;11;0.6;Stadt Konstanz, Amt fuer Stadtplanung und Umwelt
22.09.2023 04:00;11;7;4;Leichter Regenfall;11;11;2.3;Stadt Konstanz, Amt fuer Stadtplanung und Umwelt
22.09.2023 05:00;34;26;8;Maeßiger Regenfall;11;11;3.3;Stadt Konstanz, Amt fuer Stadtplanung und Umwelt
22.09.2023 06:00;124;63;61;Leichter Regenfall;11;11;1.3;Stadt Konstanz, Amt fuer Stadtplanung und Umwelt
22.09.2023 07:00;700;420;280;Leichter Regenschauer;11;10;0.2;Stadt Konstanz, Amt fuer Stadtplanung und Umwelt
22.09.2023 08:00;520;293;227;Nieselregen;12;11;0.2;Stadt Konstanz, Amt fuer Stadtplanung und Umwelt
22.09.2023 09:00;498;298;200;Leichter Regenfall;11;11;1.1;Stadt Konstanz, Amt fuer Stadtplanung und Umwelt
22.09.2023 10:00;335;181;154;Stellenweiser Regenfall;11;11;0.1;Stadt Konstanz, Amt fuer Stadtplanung und Umwelt
22.09.2023 11:00;479;241;238;Stellenweiser Regenfall;12;11;0;Stadt Konstanz, Amt fuer Stadtplanung und Umwelt
22.09.2023 12:00;609;295;314;Stellenweiser Regenfall;13;13;0;Stadt Konstanz, Amt fuer Stadtplanung und Umwelt
22.09.2023 13:00;866;331;535;Stellenweiser Regenfall;14;14;0.1;Stadt Konstanz, Amt fuer Stadtplanung und Umwelt
22.09.2023 14:00;677;345;332;Stellenweiser Regenfall;13;14;0;Stadt Konstanz, Amt fuer Stadtplanung und Umwelt
22.09.2023 15:00;653;306;347;Stellenweiser Regenfall;15;15;0;Stadt Konstanz, Amt fuer Stadtplanung und Umwelt
22.09.2023 16:00;751;377;374;Stellenweiser Regenfall;15;15;0.2;Stadt Konstanz, Amt fuer Stadtplanung und Umwelt
22.09.2023 17:00;733;328;405;Stellenweiser Regenfall;13;13;0.4;Stadt Konstanz, Amt fuer Stadtplanung und Umwelt
22.09.2023 18:00;690;322;368;Stellenweiser Regenfall;12;13;0.1;Stadt Konstanz, Amt fuer Stadtplanung und Umwelt
22.09.2023 19:00;535;271;264;Stellenweiser Regenfall;11;11;0.1;Stadt Konstanz, Amt fuer Stadtplanung und Umwelt
22.09.2023 20:00;363;181;182;Nieselregen;10;11;0.3;Stadt Konstanz, Amt fuer Stadtplanung und Umwelt
22.09.2023 21:00;250;108;142;Leichter Nebel;10;10;0.1;Stadt Konstanz, Amt fuer Stadtplanung und Umwelt
22.09.2023 22:00;247;98;149;Stellenweise Gewitter und Niederschlaege;10;10;0;Stadt Konstanz, Amt fuer Stadtplanung und Umwelt
22.09.2023 23:00;166;66;100;Leichter Nebel;10;10;0.1;Stadt Konstanz, Amt fuer Stadtplanung und Umwelt
23.09.2023 00:00;101;30;71;Leichter Nebel;10;10;0;Stadt Konstanz, Amt fuer Stadtplanung und Umwelt
23.09.2023 01:00;103;33;70;Leichter Nebel;9;9;0.1;Stadt Konstanz, Amt fuer Stadtplanung und Umwelt
23.09.2023 02:00;67;16;51;Leichter Nebel;9;9;0.1;Stadt Konstanz, Amt fuer Stadtplanung und Umwelt
23.09.2023 03:00;70;23;47;Leichter Nebel;8;8;0.1;Stadt Konstanz, Amt fuer Stadtplanung und Umwelt
23.09.2023 04:00;27;5;22;Leichter Nebel;8;8;0;Stadt Konstanz, Amt fuer Stadtplanung und Umwelt
23.09.2023 05:00;37;15;22;Leichter Nebel;7;7;0;Stadt Konstanz, Amt fuer Stadtplanung und Umwelt
23.09.2023 06:00;45;29;16;Leichter Nebel;7;6;0;Stadt Konstanz, Amt fuer Stadtplanung und Umwelt
23.09.2023 07:00;86;41;45;Bedeckt;8;7;0;Stadt Konstanz, Amt fuer Stadtplanung und Umwelt
23.09.2023 08:00;191;105;86;Bewoelkt;10;11;0;Stadt Konstanz, Amt fuer Stadtplanung und Umwelt
23.09.2023 09:00;404;224;180;Stellenweiser Regenfall;12;12;0;Stadt Konstanz, Amt fuer Stadtplanung und Umwelt
23.09.2023 10:00;501;276;225;Leicht bewoelkt;14;14;0;Stadt Konstanz, Amt fuer Stadtplanung und Umwelt
23.09.2023 11:00;618;350;268;Stellenweiser Regenfall;16;16;0;Stadt Konstanz, Amt fuer Stadtplanung und Umwelt
23.09.2023 12:00;658;331;327;Stellenweiser Regenfall;17;17;0;Stadt Konstanz, Amt fuer Stadtplanung und Umwelt
23.09.2023 13:00;634;318;316;Stellenweiser Regenfall;16;16;0;Stadt Konstanz, Amt fuer Stadtplanung und Umwelt
23.09.2023 14:00;644;329;315;Stellenweiser Regenfall;15;15;0;Stadt Konstanz, Amt fuer Stadtplanung und Umwelt
23.09.2023 15:00;675;313;362;Sonnig;15;15;0;Stadt Konstanz, Amt fuer Stadtplanung und Umwelt
23.09.2023 16:00;629;268;361;Sonnig;15;15;0;Stadt Konstanz, Amt fuer Stadtplanung und Umwelt
23.09.2023 17:00;537;252;285;Stellenweiser Regenfall;14;14;0;Stadt Konstanz, Amt fuer Stadtplanung und Umwelt
23.09.2023 18:00;570;236;334;Sonnig;12;12;0;Stadt Konstanz, Amt fuer Stadtplanung und Umwelt
23.09.2023 19:00;426;253;173;Leicht bewoelkt;9;9;0;Stadt Konstanz, Amt fuer Stadtplanung und Umwelt
23.09.2023 20:00;339;173;166;Bewoelkt;10;10;0;Stadt Konstanz, Amt fuer Stadtplanung und Umwelt
23.09.2023 21:00;274;142;132;Bewoelkt;10;10;0;Stadt Konstanz, Amt fuer Stadtplanung und Umwelt
23.09.2023 22:00;243;84;159;Bewoelkt;10;10;0;Stadt Konstanz, Amt fuer Stadtplanung und Umwelt
23.09.2023 23:00;193;65;128;Bedeckt;10;10;0;Stadt Konstanz, Amt fuer Stadtplanung und Umwelt
24.09.2023 00:00;160;49;111;Sonnig;9;9;0;Stadt Konstanz, Amt fuer Stadtplanung und Umwelt
24.09.2023 01:00;104;31;73;Sonnig;8;9;0;Stadt Konstanz, Amt fuer Stadtplanung und Umwelt
24.09.2023 02:00;76;19;57;Sonnig;8;7;0;Stadt Konstanz, Amt fuer Stadtplanung und Umwelt
24.09.2023 03:00;49;12;37;Sonnig;6;6;0;Stadt Konstanz, Amt fuer Stadtplanung und Umwelt
24.09.2023 04:00;40;14;26;Sonnig;6;6;0;Stadt Konstanz, Amt fuer Stadtplanung und Umwelt
24.09.2023 05:00;25;17;8;Sonnig;6;5;0;Stadt Konstanz, Amt fuer Stadtplanung und Umwelt
24.09.2023 06:00;43;30;13;Sonnig;5;5;0;Stadt Konstanz, Amt fuer Stadtplanung und Umwelt
24.09.2023 07:00;79;49;30;Sonnig;6;6;0;Stadt Konstanz, Amt fuer Stadtplanung und Umwelt
24.09.2023 08:00;93;45;48;Sonnig;10;10;0;Stadt Konstanz, Amt fuer Stadtplanung und Umwelt
24.09.2023 09:00;215;90;125;Sonnig;12;12;0;Stadt Konstanz, Amt fuer Stadtplanung und Umwelt
24.09.2023 10:00;312;150;162;Sonnig;14;14;0;Stadt Konstanz, Amt fuer Stadtplanung und Umwelt
24.09.2023 11:00;471;244;227;Sonnig;16;16;0;Stadt Konstanz, Amt fuer Stadtplanung und Umwelt
24.09.2023 12:00;487;193;294;Sonnig;18;18;0;Stadt Konstanz, Amt fuer Stadtplanung und Umwelt
24.09.2023 13:00;532;224;308;Sonnig;18;18;0;Stadt Konstanz, Amt fuer Stadtplanung und Umwelt
24.09.2023 14:00;607;317;290;Sonnig;19;19;0;Stadt Konstanz, Amt fuer Stadtplanung und Umwelt
24.09.2023 15:00;578;287;291;Sonnig;19;19;0;Stadt Konstanz, Amt fuer Stadtplanung und Umwelt
24.09.2023 16:00;605;311;294;Sonnig;18;18;0;Stadt Konstanz, Amt fuer Stadtplanung und Umwelt
24.09.2023 17:00;554;273;281;Sonnig;16;16;0;Stadt Konstanz, Amt fuer Stadtplanung und Umwelt
24.09.2023 18:00;498;230;268;Sonnig;12;11;0;Stadt Konstanz, Amt fuer Stadtplanung und Umwelt
24.09.2023 19:00;358;173;185;Sonnig;10;9;0;Stadt Konstanz, Amt fuer Stadtplanung und Umwelt
24.09.2023 20:00;272;142;130;Sonnig;9;7;0;Stadt Konstanz, Amt fuer Stadtplanung und Umwelt
24.09.2023 21:00;155;56;99;Sonnig;8;7;0;Stadt Konstanz, Amt fuer Stadtplanung und Umwelt
24.09.2023 22:00;126;47;79;Sonnig;7;6;0;Stadt Konstanz, Amt fuer Stadtplanung und Umwelt
24.09.2023 23:00;67;24;43;Sonnig;7;6;0;Stadt Konstanz, Amt fuer Stadtplanung und Umwelt
25.09.2023 00:00;17;5;12;Sonnig;6;5;0;Stadt Konstanz, Amt fuer Stadtplanung und Umwelt
25.09.2023 01:00;13;4;9;Sonnig;6;5;0;Stadt Konstanz, Amt fuer Stadtplanung und Umwelt
25.09.2023 02:00;11;6;5;Sonnig;5;4;0;Stadt Konstanz, Amt fuer Stadtplanung und Umwelt
25.09.2023 03:00;8;3;5;Sonnig;5;4;0;Stadt Konstanz, Amt fuer Stadtplanung und Umwelt
25.09.2023 04:00;9;5;4;Leichter Nebel;4;4;0;Stadt Konstanz, Amt fuer Stadtplanung und Umwelt
25.09.2023 05:00;70;47;23;Leichter Nebel;4;3;0;Stadt Konstanz, Amt fuer Stadtplanung und Umwelt
25.09.2023 06:00;217;114;103;Leichter Nebel;4;3;0;Stadt Konstanz, Amt fuer Stadtplanung und Umwelt
25.09.2023 07:00;951;638;313;Sonnig;4;4;0;Stadt Konstanz, Amt fuer Stadtplanung und Umwelt
25.09.2023 08:00;804;481;323;Sonnig;8;8;0;Stadt Konstanz, Amt fuer Stadtplanung und Umwelt
25.09.2023 09:00;643;395;248;Sonnig;11;11;0;Stadt Konstanz, Amt fuer Stadtplanung und Umwelt
25.09.2023 10:00;494;247;247;Sonnig;14;14;0;Stadt Konstanz, Amt fuer Stadtplanung und Umwelt
25.09.2023 11:00;686;312;374;Sonnig;16;16;0;Stadt Konstanz, Amt fuer Stadtplanung und Umwelt
25.09.2023 12:00;656;303;353;Sonnig;18;18;0;Stadt Konstanz, Amt fuer Stadtplanung und Umwelt
25.09.2023 13:00;1023;459;564;Sonnig;19;19;0;Stadt Konstanz, Amt fuer Stadtplanung und Umwelt
25.09.2023 14:00;822;406;416;Sonnig;20;20;0;Stadt Konstanz, Amt fuer Stadtplanung und Umwelt
25.09.2023 15:00;1048;485;563;Sonnig;20;20;0;Stadt Konstanz, Amt fuer Stadtplanung und Umwelt
25.09.2023 16:00;1016;473;543;Sonnig;19;19;0;Stadt Konstanz, Amt fuer Stadtplanung und Umwelt
25.09.2023 17:00;1158;498;660;Sonnig;18;18;0;Stadt Konstanz, Amt fuer Stadtplanung und Umwelt
25.09.2023 18:00;892;339;553;Sonnig;13;13;0;Stadt Konstanz, Amt fuer Stadtplanung und Umwelt
25.09.2023 19:00;640;288;352;Sonnig;11;11;0;Stadt Konstanz, Amt fuer Stadtplanung und Umwelt
25.09.2023 20:00;457;217;240;Sonnig;10;9;0;Stadt Konstanz, Amt fuer Stadtplanung und Umwelt
25.09.2023 21:00;257;101;156;Sonnig;9;9;0;Stadt Konstanz, Amt fuer Stadtplanung und Umwelt
25.09.2023 22:00;212;87;125;Sonnig;8;8;0;Stadt Konstanz, Amt fuer Stadtplanung und Umwelt
25.09.2023 23:00;93;24;69;Sonnig;8;8;0;Stadt Konstanz, Amt fuer Stadtplanung und Umwelt
26.09.2023 00:00;39;12;27;Sonnig;8;8;0;Stadt Konstanz, Amt fuer Stadtplanung und Umwelt
26.09.2023 01:00;39;9;30;Sonnig;8;8;0;Stadt Konstanz, Amt fuer Stadtplanung und Umwelt
26.09.2023 02:00;17;10;7;Leichter Nebel;7;7;0;Stadt Konstanz, Amt fuer Stadtplanung und Umwelt
26.09.2023 03:00;9;3;6;Leichter Nebel;7;7;0;Stadt Konstanz, Amt fuer Stadtplanung und Umwelt
26.09.2023 04:00;10;4;6;Leichter Nebel;7;7;0;Stadt Konstanz, Amt fuer Stadtplanung und Umwelt
26.09.2023 05:00;65;48;17;Leichter Nebel;6;6;0;Stadt Konstanz, Amt fuer Stadtplanung und Umwelt
26.09.2023 06:00;223;131;92;Leichter Nebel;6;6;0;Stadt Konstanz, Amt fuer Stadtplanung und Umwelt
26.09.2023 07:00;939;617;322;Leichter Nebel;7;7;0;Stadt Konstanz, Amt fuer Stadtplanung und Umwelt
26.09.2023 08:00;902;493;409;Sonnig;10;10;0;Stadt Konstanz, Amt fuer Stadtplanung und Umwelt
26.09.2023 09:00;659;417;242;Sonnig;13;13;0;Stadt Konstanz, Amt fuer Stadtplanung und Umwelt
26.09.2023 10:00;494;265;229;Sonnig;16;16;0;Stadt Konstanz, Amt fuer Stadtplanung und Umwelt
26.09.2023 11:00;695;328;367;Sonnig;18;18;0;Stadt Konstanz, Amt fuer Stadtplanung und Umwelt
26.09.2023 12:00;815;349;466;Sonnig;20;20;0;Stadt Konstanz, Amt fuer Stadtplanung und Umwelt
26.09.2023 13:00;897;402;495;Sonnig;21;21;0;Stadt Konstanz, Amt fuer Stadtplanung und Umwelt
26.09.2023 14:00;870;440;430;Sonnig;22;24;0;Stadt Konstanz, Amt fuer Stadtplanung und Umwelt
26.09.2023 15:00;1173;554;619;Sonnig;22;24;0;Stadt Konstanz, Amt fuer Stadtplanung und Umwelt
26.09.2023 16:00;1087;510;577;Sonnig;22;22;0;Stadt Konstanz, Amt fuer Stadtplanung und Umwelt
26.09.2023 17:00;1266;581;685;Sonnig;19;19;0;Stadt Konstanz, Amt fuer Stadtplanung und Umwelt
26.09.2023 18:00;997;452;545;Sonnig;14;14;0;Stadt Konstanz, Amt fuer Stadtplanung und Umwelt
26.09.2023 19:00;760;355;405;Sonnig;12;12;0;Stadt Konstanz, Amt fuer Stadtplanung und Umwelt
26.09.2023 20:00;401;166;235;Sonnig;11;12;0;Stadt Konstanz, Amt fuer Stadtplanung und Umwelt
26.09.2023 21:00;293;105;188;Sonnig;10;11;0;Stadt Konstanz, Amt fuer Stadtplanung und Umwelt
26.09.2023 22:00;223;78;145;Sonnig;10;10;0;Stadt Konstanz, Amt fuer Stadtplanung und Umwelt
26.09.2023 23:00;115;27;88;Sonnig;9;9;0;Stadt Konstanz, Amt fuer Stadtplanung und Umwelt
27.09.2023 00:00;44;20;24;Sonnig;9;9;0;Stadt Konstanz, Amt fuer Stadtplanung und Umwelt
27.09.2023 01:00;26;16;10;Bewoelkt;9;9;0;Stadt Konstanz, Amt fuer Stadtplanung und Umwelt
27.09.2023 02:00;17;3;14;Leicht bewoelkt;9;9;0;Stadt Konstanz, Amt fuer Stadtplanung und Umwelt
27.09.2023 03:00;8;0;8;Bewoelkt;9;9;0;Stadt Konstanz, Amt fuer Stadtplanung und Umwelt
27.09.2023 04:00;15;11;4;Sonnig;8;8;0;Stadt Konstanz, Amt fuer Stadtplanung und Umwelt
27.09.2023 05:00;57;43;14;Sonnig;8;8;0;Stadt Konstanz, Amt fuer Stadtplanung und Umwelt
27.09.2023 06:00;226;115;111;Sonnig;8;8;0;Stadt Konstanz, Amt fuer Stadtplanung und Umwelt
27.09.2023 07:00;903;557;346;Sonnig;8;8;0;Stadt Konstanz, Amt fuer Stadtplanung und Umwelt
27.09.2023 08:00;796;466;330;Sonnig;12;12;0;Stadt Konstanz, Amt fuer Stadtplanung und Umwelt
27.09.2023 09:00;623;363;260;Sonnig;15;15;0;Stadt Konstanz, Amt fuer Stadtplanung und Umwelt
27.09.2023 10:00;499;292;207;Sonnig;18;18;0;Stadt Konstanz, Amt fuer Stadtplanung und Umwelt
27.09.2023 11:00;576;289;287;Sonnig;20;20;0;Stadt Konstanz, Amt fuer Stadtplanung und Umwelt
27.09.2023 12:00;755;354;401;Sonnig;22;24;0;Stadt Konstanz, Amt fuer Stadtplanung und Umwelt
27.09.2023 13:00;1047;476;571;Sonnig;23;24;0;Stadt Konstanz, Amt fuer Stadtplanung und Umwelt
27.09.2023 14:00;783;390;393;Sonnig;23;24;0;Stadt Konstanz, Amt fuer Stadtplanung und Umwelt
27.09.2023 15:00;1064;489;575;Sonnig;23;24;0;Stadt Konstanz, Amt fuer Stadtplanung und Umwelt
27.09.2023 16:00;1024;482;542;Sonnig;23;25;0;Stadt Konstanz, Amt fuer Stadtplanung und Umwelt
27.09.2023 17:00;1230;588;642;Sonnig;19;19;0;Stadt Konstanz, Amt fuer Stadtplanung und Umwelt
27.09.2023 18:00;1043;423;620;Sonnig;15;15;0;Stadt Konstanz, Amt fuer Stadtplanung und Umwelt
27.09.2023 19:00;736;331;405;Sonnig;13;13;0;Stadt Konstanz, Amt fuer Stadtplanung und Umwelt
27.09.2023 20:00;474;200;274;Sonnig;12;12;0;Stadt Konstanz, Amt fuer Stadtplanung und Umwelt
27.09.2023 21:00;376;143;233;Leicht bewoelkt;12;12;0;Stadt Konstanz, Amt fuer Stadtplanung und Umwelt
27.09.2023 22:00;261;115;146;Bedeckt;11;11;0;Stadt Konstanz, Amt fuer Stadtplanung und Umwelt
27.09.2023 23:00;120;34;86;Leicht bewoelkt;11;11;0;Stadt Konstanz, Amt fuer Stadtplanung und Umwelt
28.09.2023 00:00;66;22;44;Sonnig;10;10;0;Stadt Konstanz, Amt fuer Stadtplanung und Umwelt
28.09.2023 01:00;35;8;27;Sonnig;10;10;0;Stadt Konstanz, Amt fuer Stadtplanung und Umwelt
28.09.2023 02:00;8;6;2;Bedeckt;10;10;0;Stadt Konstanz, Amt fuer Stadtplanung und Umwelt
28.09.2023 03:00;4;3;1;Bedeckt;10;10;0;Stadt Konstanz, Amt fuer Stadtplanung und Umwelt
28.09.2023 04:00;9;5;4;Bedeckt;10;10;0;Stadt Konstanz, Amt fuer Stadtplanung und Umwelt
28.09.2023 05:00;53;36;17;Bewoelkt;10;10;0;Stadt Konstanz, Amt fuer Stadtplanung und Umwelt
28.09.2023 06:00;224;122;102;Bedeckt;10;10;0;Stadt Konstanz, Amt fuer Stadtplanung und Umwelt
28.09.2023 07:00;904;579;325;Sonnig;10;10;0;Stadt Konstanz, Amt fuer Stadtplanung und Umwelt
28.09.2023 08:00;829;490;339;Sonnig;13;13;0;Stadt Konstanz, Amt fuer Stadtplanung und Umwelt
28.09.2023 09:00;680;422;258;Sonnig;16;16;0;Stadt Konstanz, Amt fuer Stadtplanung und Umwelt
28.09.2023 10:00;558;301;257;Sonnig;18;18;0;Stadt Konstanz, Amt fuer Stadtplanung und Umwelt
28.09.2023 11:00;642;318;324;Sonnig;20;20;0;Stadt Konstanz, Amt fuer Stadtplanung und Umwelt
28.09.2023 12:00;770;375;395;Leicht bewoelkt;22;24;0;Stadt Konstanz, Amt fuer Stadtplanung und Umwelt
28.09.2023 13:00;1049;435;614;Leicht bewoelkt;23;25;0;Stadt Konstanz, Amt fuer Stadtplanung und Umwelt
28.09.2023 14:00;876;387;489;Sonnig;24;25;0;Stadt Konstanz, Amt fuer Stadtplanung und Umwelt
28.09.2023 15:00;1142;564;578;Leicht bewoelkt;24;25;0;Stadt Konstanz, Amt fuer Stadtplanung und Umwelt
28.09.2023 16:00;1124;551;573;Bedeckt;23;25;0;Stadt Konstanz, Amt fuer Stadtplanung und Umwelt
28.09.2023 17:00;1169;517;652;Leicht bewoelkt;20;20;0;Stadt Konstanz, Amt fuer Stadtplanung und Umwelt
28.09.2023 18:00;1126;503;623;Leicht bewoelkt;16;16;0;Stadt Konstanz, Amt fuer Stadtplanung und Umwelt
28.09.2023 19:00;776;367;409;Sonnig;15;15;0;Stadt Konstanz, Amt fuer Stadtplanung und Umwelt
28.09.2023 20:00;484;193;291;Sonnig;14;15;0;Stadt Konstanz, Amt fuer Stadtplanung und Umwelt
28.09.2023 21:00;329;113;216;Sonnig;13;14;0;Stadt Konstanz, Amt fuer Stadtplanung und Umwelt
28.09.2023 22:00;251;84;167;Sonnig;13;13;0;Stadt Konstanz, Amt fuer Stadtplanung und Umwelt
28.09.2023 23:00;125;38;87;Sonnig;13;13;0;Stadt Konstanz, Amt fuer Stadtplanung und Umwelt
29.09.2023 00:00;57;10;47;Sonnig;12;12;0;Stadt Konstanz, Amt fuer Stadtplanung und Umwelt
29.09.2023 01:00;39;2;37;Sonnig;11;11;0;Stadt Konstanz, Amt fuer Stadtplanung und Umwelt
29.09.2023 02:00;18;5;13;Sonnig;11;11;0;Stadt Konstanz, Amt fuer Stadtplanung und Umwelt
29.09.2023 03:00;5;2;3;Leicht bewoelkt;11;11;0;Stadt Konstanz, Amt fuer Stadtplanung und Umwelt
29.09.2023 04:00;8;4;4;Sonnig;10;10;0;Stadt Konstanz, Amt fuer Stadtplanung und Umwelt
29.09.2023 05:00;38;24;14;Sonnig;10;10;0;Stadt Konstanz, Amt fuer Stadtplanung und Umwelt
29.09.2023 06:00;178;99;79;Sonnig;10;10;0;Stadt Konstanz, Amt fuer Stadtplanung und Umwelt
29.09.2023 07:00;843;556;287;Sonnig;11;11;0;Stadt Konstanz, Amt fuer Stadtplanung und Umwelt
29.09.2023 08:00;787;466;321;Sonnig;13;13;0;Stadt Konstanz, Amt fuer Stadtplanung und Umwelt
29.09.2023 09:00;677;395;282;Sonnig;17;17;0;Stadt Konstanz, Amt fuer Stadtplanung und Umwelt
29.09.2023 10:00;594;318;276;Sonnig;20;20;0;Stadt Konstanz, Amt fuer Stadtplanung und Umwelt
29.09.2023 11:00;783;410;373;Sonnig;22;22;0;Stadt Konstanz, Amt fuer Stadtplanung und Umwelt
29.09.2023 12:00;904;408;496;Sonnig;23;25;0;Stadt Konstanz, Amt fuer Stadtplanung und Umwelt
29.09.2023 13:00;1059;456;603;Sonnig;25;25;0;Stadt Konstanz, Amt fuer Stadtplanung und Umwelt
29.09.2023 14:00;947;482;465;Sonnig;25;26;0;Stadt Konstanz, Amt fuer Stadtplanung und Umwelt
29.09.2023 15:00;967;472;495;Sonnig;25;26;0;Stadt Konstanz, Amt fuer Stadtplanung und Umwelt
29.09.2023 16:00;868;421;447;Sonnig;24;25;0;Stadt Konstanz, Amt fuer Stadtplanung und Umwelt
29.09.2023 17:00;928;434;494;Leicht bewoelkt;21;21;0;Stadt Konstanz, Amt fuer Stadtplanung und Umwelt
29.09.2023 18:00;850;371;479;Leicht bewoelkt;18;18;0;Stadt Konstanz, Amt fuer Stadtplanung und Umwelt
29.09.2023 19:00;601;268;333;Sonnig;16;16;0;Stadt Konstanz, Amt fuer Stadtplanung und Umwelt
29.09.2023 20:00;465;202;263;Stellenweiser Regenfall;15;16;0;Stadt Konstanz, Amt fuer Stadtplanung und Umwelt
29.09.2023 21:00;317;160;157;Leicht bewoelkt;15;15;0;Stadt Konstanz, Amt fuer Stadtplanung und Umwelt
29.09.2023 22:00;273;111;162;Stellenweiser Regenfall;14;15;0.3;Stadt Konstanz, Amt fuer Stadtplanung und Umwelt
29.09.2023 23:00;254;90;164;Leicht bewoelkt;15;15;0;Stadt Konstanz, Amt fuer Stadtplanung und Umwelt
30.09.2023 00:00;151;46;105;Sonnig;12;12;0;Stadt Konstanz, Amt fuer Stadtplanung und Umwelt
30.09.2023 01:00;89;25;64;Sonnig;11;11;0;Stadt Konstanz, Amt fuer Stadtplanung und Umwelt
30.09.2023 02:00;61;26;35;Sonnig;10;10;0;Stadt Konstanz, Amt fuer Stadtplanung und Umwelt
30.09.2023 03:00;37;17;20;Sonnig;10;10;0;Stadt Konstanz, Amt fuer Stadtplanung und Umwelt
30.09.2023 04:00;39;22;17;Sonnig;10;10;0;Stadt Konstanz, Amt fuer Stadtplanung und Umwelt
30.09.2023 05:00;36;19;17;Sonnig;10;10;0;Stadt Konstanz, Amt fuer Stadtplanung und Umwelt
30.09.2023 06:00;53;28;25;Sonnig;10;10;0;Stadt Konstanz, Amt fuer Stadtplanung und Umwelt
30.09.2023 07:00;79;43;36;Sonnig;11;11;0;Stadt Konstanz, Amt fuer Stadtplanung und Umwelt
30.09.2023 08:00;230;130;100;Sonnig;13;13;0;Stadt Konstanz, Amt fuer Stadtplanung und Umwelt
30.09.2023 09:00;420;268;152;Sonnig;16;16;0;Stadt Konstanz, Amt fuer Stadtplanung und Umwelt
30.09.2023 10:00;572;312;260;Sonnig;18;18;0;Stadt Konstanz, Amt fuer Stadtplanung und Umwelt
30.09.2023 11:00;740;394;346;Sonnig;20;20;0;Stadt Konstanz, Amt fuer Stadtplanung und Umwelt
30.09.2023 12:00;719;377;342;Sonnig;21;21;0;Stadt Konstanz, Amt fuer Stadtplanung und Umwelt
30.09.2023 13:00;682;357;325;Sonnig;22;22;0;Stadt Konstanz, Amt fuer Stadtplanung und Umwelt
30.09.2023 14:00;749;378;371;Sonnig;22;22;0;Stadt Konstanz, Amt fuer Stadtplanung und Umwelt
30.09.2023 15:00;776;346;430;Sonnig;21;21;0;Stadt Konstanz, Amt fuer Stadtplanung und Umwelt
30.09.2023 16:00;801;382;419;Sonnig;21;21;0;Stadt Konstanz, Amt fuer Stadtplanung und Umwelt
30.09.2023 17:00;720;307;413;Sonnig;19;19;0;Stadt Konstanz, Amt fuer Stadtplanung und Umwelt
30.09.2023 18:00;605;273;332;Sonnig;15;15;0;Stadt Konstanz, Amt fuer Stadtplanung und Umwelt
30.09.2023 19:00;510;249;261;Sonnig;13;14;0;Stadt Konstanz, Amt fuer Stadtplanung und Umwelt
30.09.2023 20:00;381;158;223;Sonnig;12;12;0;Stadt Konstanz, Amt fuer Stadtplanung und Umwelt
30.09.2023 21:00;300;142;158;Sonnig;11;11;0;Stadt Konstanz, Amt fuer Stadtplanung und Umwelt
30.09.2023 22:00;202;89;113;Sonnig;11;10;0;Stadt Konstanz, Amt fuer Stadtplanung und Umwelt
30.09.2023 23:00;164;51;113;Leichter Nebel;10;10;0;Stadt Konstanz, Amt fuer Stadtplanung und Umwelt
01.10.2023 00:00;141;45;96;Sonnig;10;11;0;Stadt Konstanz, Amt fuer Stadtplanung und Umwelt
01.10.2023 01:00;115;52;63;Sonnig;10;11;0;Stadt Konstanz, Amt fuer Stadtplanung und Umwelt
01.10.2023 02:00;64;27;37;Sonnig;10;10;0;Stadt Konstanz, Amt fuer Stadtplanung und Umwelt
01.10.2023 03:00;64;22;42;Leichter Nebel;9;9;0;Stadt Konstanz, Amt fuer Stadtplanung und Umwelt
01.10.2023 04:00;19;10;9;Leichter Nebel;9;9;0;Stadt Konstanz, Amt fuer Stadtplanung und Umwelt
01.10.2023 05:00;36;18;18;Leichter Nebel;9;9;0;Stadt Konstanz, Amt fuer Stadtplanung und Umwelt
01.10.2023 06:00;34;20;14;Leichter Nebel;9;9;0;Stadt Konstanz, Amt fuer Stadtplanung und Umwelt
01.10.2023 07:00;59;32;27;Leichter Nebel;9;9;0;Stadt Konstanz, Amt fuer Stadtplanung und Umwelt
01.10.2023 08:00;103;47;56;Sonnig;13;13;0;Stadt Konstanz, Amt fuer Stadtplanung und Umwelt
01.10.2023 09:00;276;138;138;Sonnig;16;16;0;Stadt Konstanz, Amt fuer Stadtplanung und Umwelt
01.10.2023 10:00;354;169;185;Sonnig;18;18;0;Stadt Konstanz, Amt fuer Stadtplanung und Umwelt
01.10.2023 11:00;483;251;232;Sonnig;21;21;0;Stadt Konstanz, Amt fuer Stadtplanung und Umwelt
01.10.2023 12:00;555;279;276;Sonnig;22;24;0;Stadt Konstanz, Amt fuer Stadtplanung und Umwelt
01.10.2023 13:00;589;316;273;Sonnig;23;25;0;Stadt Konstanz, Amt fuer Stadtplanung und Umwelt
01.10.2023 14:00;692;334;358;Sonnig;24;25;0;Stadt Konstanz, Amt fuer Stadtplanung und Umwelt
01.10.2023 15:00;597;304;293;Sonnig;24;25;0;Stadt Konstanz, Amt fuer Stadtplanung und Umwelt
01.10.2023 16:00;667;341;326;Sonnig;23;25;0;Stadt Konstanz, Amt fuer Stadtplanung und Umwelt
01.10.2023 17:00;685;349;336;Leicht bewoelkt;20;20;0;Stadt Konstanz, Amt fuer Stadtplanung und Umwelt
01.10.2023 18:00;541;274;267;Sonnig;16;16;0;Stadt Konstanz, Amt fuer Stadtplanung und Umwelt
01.10.2023 19:00;417;171;246;Sonnig;14;14;0;Stadt Konstanz, Amt fuer Stadtplanung und Umwelt
01.10.2023 20:00;266;120;146;Sonnig;13;14;0;Stadt Konstanz, Amt fuer Stadtplanung und Umwelt
01.10.2023 21:00;168;68;100;Sonnig;12;13;0;Stadt Konstanz, Amt fuer Stadtplanung und Umwelt
01.10.2023 22:00;126;45;81;Sonnig;12;12;0;Stadt Konstanz, Amt fuer Stadtplanung und Umwelt
01.10.2023 23:00;65;30;35;Sonnig;11;11;0;Stadt Konstanz, Amt fuer Stadtplanung und Umwelt
02.10.2023 00:00;31;10;21;Sonnig;11;11;0;Stadt Konstanz, Amt fuer Stadtplanung und Umwelt
02.10.2023 01:00;15;8;7;Sonnig;11;11;0;Stadt Konstanz, Amt fuer Stadtplanung und Umwelt
02.10.2023 02:00;17;9;8;Sonnig;11;11;0;Stadt Konstanz, Amt fuer Stadtplanung und Umwelt
02.10.2023 03:00;5;2;3;Sonnig;10;10;0;Stadt Konstanz, Amt fuer Stadtplanung und Umwelt
02.10.2023 04:00;9;2;7;Sonnig;10;10;0;Stadt Konstanz, Amt fuer Stadtplanung und Umwelt
02.10.2023 05:00;56;46;10;Sonnig;10;10;0;Stadt Konstanz, Amt fuer Stadtplanung und Umwelt
02.10.2023 06:00;141;80;61;Sonnig;10;10;0;Stadt Konstanz, Amt fuer Stadtplanung und Umwelt
02.10.2023 07:00;776;559;217;Sonnig;10;10;0;Stadt Konstanz, Amt fuer Stadtplanung und Umwelt
02.10.2023 08:00;552;329;223;Sonnig;13;13;0;Stadt Konstanz, Amt fuer Stadtplanung und Umwelt
02.10.2023 09:00;553;341;212;Sonnig;16;16;0;Stadt Konstanz, Amt fuer Stadtplanung und Umwelt
02.10.2023 10:00;560;339;221;Sonnig;19;19;0;Stadt Konstanz, Amt fuer Stadtplanung und Umwelt
02.10.2023 11:00;695;346;349;Sonnig;21;21;0;Stadt Konstanz, Amt fuer Stadtplanung und Umwelt
02.10.2023 12:00;844;421;423;Sonnig;23;25;0;Stadt Konstanz, Amt fuer Stadtplanung und Umwelt
02.10.2023 13:00;1020;454;566;Sonnig;24;25;0;Stadt Konstanz, Amt fuer Stadtplanung und Umwelt
02.10.2023 14:00;899;449;450;Sonnig;25;26;0;Stadt Konstanz, Amt fuer Stadtplanung und Umwelt
02.10.2023 15:00;1107;477;630;Sonnig;25;26;0;Stadt Konstanz, Amt fuer Stadtplanung und Umwelt
02.10.2023 16:00;1109;497;612;Sonnig;24;25;0;Stadt Konstanz, Amt fuer Stadtplanung und Umwelt
02.10.2023 17:00;1049;423;626;Sonnig;20;20;0;Stadt Konstanz, Amt fuer Stadtplanung und Umwelt
02.10.2023 18:00;948;422;526;Sonnig;17;17;0;Stadt Konstanz, Amt fuer Stadtplanung und Umwelt
02.10.2023 19:00;637;295;342;Sonnig;15;15;0;Stadt Konstanz, Amt fuer Stadtplanung und Umwelt
02.10.2023 20:00;478;220;258;Sonnig;14;14;0;Stadt Konstanz, Amt fuer Stadtplanung und Umwelt
02.10.2023 21:00;291;128;163;Sonnig;14;14;0;Stadt Konstanz, Amt fuer Stadtplanung und Umwelt
02.10.2023 22:00;226;97;129;Sonnig;13;13;0;Stadt Konstanz, Amt fuer Stadtplanung und Umwelt
02.10.2023 23:00;129;48;81;Sonnig;13;13;0;Stadt Konstanz, Amt fuer Stadtplanung und Umwelt
03.10.2023 00:00;96;37;59;Sonnig;12;12;0;Stadt Konstanz, Amt fuer Stadtplanung und Umwelt
03.10.2023 01:00;62;24;38;Sonnig;12;12;0;Stadt Konstanz, Amt fuer Stadtplanung und Umwelt
03.10.2023 02:00;43;19;24;Bedeckt;12;12;0;Stadt Konstanz, Amt fuer Stadtplanung und Umwelt
03.10.2023 03:00;20;8;12;Leicht bewoelkt;12;12;0;Stadt Konstanz, Amt fuer Stadtplanung und Umwelt
03.10.2023 04:00;11;6;5;Sonnig;12;12;0;Stadt Konstanz, Amt fuer Stadtplanung und Umwelt
03.10.2023 05:00;41;31;10;Sonnig;11;12;0;Stadt Konstanz, Amt fuer Stadtplanung und Umwelt
03.10.2023 06:00;82;58;24;Sonnig;11;12;0;Stadt Konstanz, Amt fuer Stadtplanung und Umwelt
03.10.2023 07:00;114;90;24;Sonnig;11;12;0;Stadt Konstanz, Amt fuer Stadtplanung und Umwelt
03.10.2023 08:00;168;101;67;Sonnig;14;14;0;Stadt Konstanz, Amt fuer Stadtplanung und Umwelt
03.10.2023 09:00;295;157;138;Sonnig;18;18;0;Stadt Konstanz, Amt fuer Stadtplanung und Umwelt
03.10.2023 10:00;356;186;170;Sonnig;21;21;0;Stadt Konstanz, Amt fuer Stadtplanung und Umwelt
03.10.2023 11:00;443;264;179;Sonnig;23;25;0;Stadt Konstanz, Amt fuer Stadtplanung und Umwelt
03.10.2023 12:00;504;256;248;Sonnig;24;25;0;Stadt Konstanz, Amt fuer Stadtplanung und Umwelt
03.10.2023 13:00;547;262;285;Sonnig;25;25;0;Stadt Konstanz, Amt fuer Stadtplanung und Umwelt
03.10.2023 14:00;581;275;306;Sonnig;25;26;0;Stadt Konstanz, Amt fuer Stadtplanung und Umwelt
03.10.2023 15:00;584;281;303;Sonnig;25;26;0;Stadt Konstanz, Amt fuer Stadtplanung und Umwelt
03.10.2023 16:00;678;283;395;Sonnig;23;25;0;Stadt Konstanz, Amt fuer Stadtplanung und Umwelt
03.10.2023 17:00;754;314;440;Stellenweiser Regenfall;21;21;0.2;Stadt Konstanz, Amt fuer Stadtplanung und Umwelt
03.10.2023 18:00;417;198;219;Leichter Regenschauer;18;18;0.5;Stadt Konstanz, Amt fuer Stadtplanung und Umwelt
03.10.2023 19:00;342;163;179;Leichter Regenschauer;16;16;0.4;Stadt Konstanz, Amt fuer Stadtplanung und Umwelt
03.10.2023 20:00;216;80;136;Stellenweiser Regenfall;14;13;0.1;Stadt Konstanz, Amt fuer Stadtplanung und Umwelt
03.10.2023 21:00;177;63;114;Bedeckt;14;14;0;Stadt Konstanz, Amt fuer Stadtplanung und Umwelt
03.10.2023 22:00;113;55;58;Stellenweiser Regenfall;14;15;0;Stadt Konstanz, Amt fuer Stadtplanung und Umwelt
03.10.2023 23:00;107;40;67;Stellenweiser Regenfall;14;14;0.1;Stadt Konstanz, Amt fuer Stadtplanung und Umwelt
04.10.2023 00:00;46;23;23;Leicht bewoelkt;12;12;0;Stadt Konstanz, Amt fuer Stadtplanung und Umwelt
04.10.2023 01:00;17;9;8;Sonnig;9;9;0;Stadt Konstanz, Amt fuer Stadtplanung und Umwelt
04.10.2023 02:00;15;5;10;Sonnig;8;8;0;Stadt Konstanz, Amt fuer Stadtplanung und Umwelt
04.10.2023 03:00;2;0;2;Sonnig;8;7;0;Stadt Konstanz, Amt fuer Stadtplanung und Umwelt
04.10.2023 04:00;4;2;2;Sonnig;7;7;0;Stadt Konstanz, Amt fuer Stadtplanung und Umwelt
04.10.2023 05:00;73;60;13;Sonnig;7;7;0;Stadt Konstanz, Amt fuer Stadtplanung und Umwelt
04.10.2023 06:00;198;105;93;Sonnig;7;7;0;Stadt Konstanz, Amt fuer Stadtplanung und Umwelt
04.10.2023 07:00;1093;681;412;Sonnig;8;8;0;Stadt Konstanz, Amt fuer Stadtplanung und Umwelt
04.10.2023 08:00;851;475;376;Sonnig;11;11;0;Stadt Konstanz, Amt fuer Stadtplanung und Umwelt
04.10.2023 09:00;802;483;319;Sonnig;13;13;0;Stadt Konstanz, Amt fuer Stadtplanung und Umwelt
04.10.2023 10:00;662;373;289;Sonnig;15;15;0;Stadt Konstanz, Amt fuer Stadtplanung und Umwelt
04.10.2023 11:00;723;385;338;Sonnig;17;17;0;Stadt Konstanz, Amt fuer Stadtplanung und Umwelt
04.10.2023 12:00;884;407;477;Leicht bewoelkt;18;18;0;Stadt Konstanz, Amt fuer Stadtplanung und Umwelt
04.10.2023 13:00;1270;600;670;Bedeckt;18;18;0;Stadt Konstanz, Amt fuer Stadtplanung und Umwelt
04.10.2023 14:00;910;431;479;Bedeckt;18;18;0;Stadt Konstanz, Amt fuer Stadtplanung und Umwelt
04.10.2023 15:00;1104;482;622;Leicht bewoelkt;18;18;0;Stadt Konstanz, Amt fuer Stadtplanung und Umwelt
04.10.2023 16:00;1084;472;612;Bedeckt;18;18;0;Stadt Konstanz, Amt fuer Stadtplanung und Umwelt
04.10.2023 17:00;1354;629;725;Bewoelkt;15;15;0;Stadt Konstanz, Amt fuer Stadtplanung und Umwelt
04.10.2023 18:00;1067;430;637;Sonnig;11;11;0;Stadt Konstanz, Amt fuer Stadtplanung und Umwelt
04.10.2023 19:00;775;366;409;Sonnig;10;11;0;Stadt Konstanz, Amt fuer Stadtplanung und Umwelt
04.10.2023 20:00;557;267;290;Sonnig;10;10;0;Stadt Konstanz, Amt fuer Stadtplanung und Umwelt
04.10.2023 21:00;332;143;189;Leicht bewoelkt;9;9;0;Stadt Konstanz, Amt fuer Stadtplanung und Umwelt
04.10.2023 22:00;230;82;148;Sonnig;8;8;0;Stadt Konstanz, Amt fuer Stadtplanung und Umwelt
04.10.2023 23:00;170;59;111;Sonnig;7;7;0;Stadt Konstanz, Amt fuer Stadtplanung und Umwelt
05.10.2023 00:00;44;20;24;Sonnig;7;7;0;Stadt Konstanz, Amt fuer Stadtplanung und Umwelt
05.10.2023 01:00;30;4;26;Sonnig;7;7;0;Stadt Konstanz, Amt fuer Stadtplanung und Umwelt
05.10.2023 02:00;14;1;13;Sonnig;7;7;0;Stadt Konstanz, Amt fuer Stadtplanung und Umwelt
05.10.2023 03:00;7;1;6;Sonnig;6;6;0;Stadt Konstanz, Amt fuer Stadtplanung und Umwelt
05.10.2023 04:00;14;6;8;Leicht bewoelkt;6;6;0;Stadt Konstanz, Amt fuer Stadtplanung und Umwelt
05.10.2023 05:00;64;47;17;Sonnig;6;6;0;Stadt Konstanz, Amt fuer Stadtplanung und Umwelt
05.10.2023 06:00;210;115;95;Leicht bewoelkt;6;6;0;Stadt Konstanz, Amt fuer Stadtplanung und Umwelt
05.10.2023 07:00;1131;699;432;Leicht bewoelkt;7;7;0;Stadt Konstanz, Amt fuer Stadtplanung und Umwelt
05.10.2023 08:00;846;476;370;Leicht bewoelkt;10;10;0;Stadt Konstanz, Amt fuer Stadtplanung und Umwelt
05.10.2023 09:00;944;605;339;Leicht bewoelkt;12;12;0;Stadt Konstanz, Amt fuer Stadtplanung und Umwelt
05.10.2023 10:00;543;293;250;Leicht bewoelkt;14;14;0;Stadt Konstanz, Amt fuer Stadtplanung und Umwelt
05.10.2023 11:00;709;392;317;Leicht bewoelkt;16;16;0;Stadt Konstanz, Amt fuer Stadtplanung und Umwelt
05.10.2023 12:00;816;361;455;Leicht bewoelkt;17;17;0;Stadt Konstanz, Amt fuer Stadtplanung und Umwelt
05.10.2023 13:00;1160;489;671;Leicht bewoelkt;19;19;0;Stadt Konstanz, Amt fuer Stadtplanung und Umwelt
05.10.2023 14:00;842;401;441;Leicht bewoelkt;19;19;0;Stadt Konstanz, Amt fuer Stadtplanung und Umwelt
05.10.2023 15:00;1192;540;652;Leicht bewoelkt;18;18;0;Stadt Konstanz, Amt fuer Stadtplanung und Umwelt
05.10.2023 16:00;1069;502;567;Leicht bewoelkt;18;18;0;Stadt Konstanz, Amt fuer Stadtplanung und Umwelt
05.10.2023 17:00;1380;597;783;Leicht bewoelkt;16;16;0;Stadt Konstanz, Amt fuer Stadtplanung und Umwelt
05.10.2023 18:00;1017;434;583;Leicht bewoelkt;14;14;0;Stadt Konstanz, Amt fuer Stadtplanung und Umwelt
05.10.2023 19:00;720;363;357;Leicht bewoelkt;13;13;0;Stadt Konstanz, Amt fuer Stadtplanung und Umwelt
05.10.2023 20:00;478;232;246;Leicht bewoelkt;12;12;0;Stadt Konstanz, Amt fuer Stadtplanung und Umwelt
05.10.2023 21:00;351;141;210;Leicht bewoelkt;11;11;0;Stadt Konstanz, Amt fuer Stadtplanung und Umwelt
05.10.2023 22:00;263;105;158;Leicht bewoelkt;11;11;0;Stadt Konstanz, Amt fuer Stadtplanung und Umwelt
05.10.2023 23:00;150;59;91;Leicht bewoelkt;11;11;0;Stadt Konstanz, Amt fuer Stadtplanung und Umwelt
06.10.2023 00:00;81;17;64;Sonnig;8;8;0;Stadt Konstanz, Amt fuer Stadtplanung und Umwelt
06.10.2023 01:00;45;11;34;Sonnig;7;7;0;Stadt Konstanz, Amt fuer Stadtplanung und Umwelt
06.10.2023 02:00;16;7;9;Sonnig;7;7;0;Stadt Konstanz, Amt fuer Stadtplanung und Umwelt
06.10.2023 03:00;9;2;7;Sonnig;7;7;0;Stadt Konstanz, Amt fuer Stadtplanung und Umwelt
06.10.2023 04:00;9;5;4;Sonnig;7;7;0;Stadt Konstanz, Amt fuer Stadtplanung und Umwelt
06.10.2023 05:00;48;37;11;Leicht bewoelkt;6;6;0;Stadt Konstanz, Amt fuer Stadtplanung und Umwelt
06.10.2023 06:00;174;95;79;Leicht bewoelkt;6;6;0;Stadt Konstanz, Amt fuer Stadtplanung und Umwelt
06.10.2023 07:00;1039;652;387;Leicht bewoelkt;6;6;0;Stadt Konstanz, Amt fuer Stadtplanung und Umwelt
06.10.2023 08:00;819;453;366;Leicht bewoelkt;10;10;0;Stadt Konstanz, Amt fuer Stadtplanung und Umwelt
06.10.2023 09:00;810;468;342;Sonnig;12;12;0;Stadt Konstanz, Amt fuer Stadtplanung und Umwelt
06.10.2023 10:00;589;329;260;Sonnig;14;14;0;Stadt Konstanz, Amt fuer Stadtplanung und Umwelt
06.10.2023 11:00;913;395;518;Sonnig;16;16;0;Stadt Konstanz, Amt fuer Stadtplanung und Umwelt
06.10.2023 12:00;981;491;490;Sonnig;18;18;0;Stadt Konstanz, Amt fuer Stadtplanung und Umwelt
06.10.2023 13:00;1129;509;620;Sonnig;19;19;0;Stadt Konstanz, Amt fuer Stadtplanung und Umwelt
06.10.2023 14:00;973;463;510;Sonnig;20;20;0;Stadt Konstanz, Amt fuer Stadtplanung und Umwelt
06.10.2023 15:00;1043;482;561;Sonnig;20;20;0;Stadt Konstanz, Amt fuer Stadtplanung und Umwelt
06.10.2023 16:00;995;481;514;Sonnig;19;19;0;Stadt Konstanz, Amt fuer Stadtplanung und Umwelt
06.10.2023 17:00;1040;507;533;Sonnig;16;16;0;Stadt Konstanz, Amt fuer Stadtplanung und Umwelt
06.10.2023 18:00;1024;563;461;Sonnig;12;12;0;Stadt Konstanz, Amt fuer Stadtplanung und Umwelt
06.10.2023 19:00;803;510;293;Sonnig;11;11;0;Stadt Konstanz, Amt fuer Stadtplanung und Umwelt
06.10.2023 20:00;558;326;232;Sonnig;10;10;0;Stadt Konstanz, Amt fuer Stadtplanung und Umwelt
06.10.2023 21:00;380;139;241;Sonnig;9;9;0;Stadt Konstanz, Amt fuer Stadtplanung und Umwelt
06.10.2023 22:00;411;96;315;Sonnig;9;9;0;Stadt Konstanz, Amt fuer Stadtplanung und Umwelt
06.10.2023 23:00;352;86;266;Sonnig;9;9;0;Stadt Konstanz, Amt fuer Stadtplanung und Umwelt
07.10.2023 00:00;227;38;189;Sonnig;8;8;0;Stadt Konstanz, Amt fuer Stadtplanung und Umwelt
07.10.2023 01:00;153;29;124;Sonnig;8;8;0;Stadt Konstanz, Amt fuer Stadtplanung und Umwelt
07.10.2023 02:00;92;21;71;Sonnig;7;7;0;Stadt Konstanz, Amt fuer Stadtplanung und Umwelt
07.10.2023 03:00;64;15;49;Sonnig;7;7;0;Stadt Konstanz, Amt fuer Stadtplanung und Umwelt
07.10.2023 04:00;34;11;23;Sonnig;6;6;0;Stadt Konstanz, Amt fuer Stadtplanung und Umwelt
07.10.2023 05:00;40;20;20;Sonnig;6;6;0;Stadt Konstanz, Amt fuer Stadtplanung und Umwelt
07.10.2023 06:00;52;34;18;Sonnig;6;6;0;Stadt Konstanz, Amt fuer Stadtplanung und Umwelt
07.10.2023 07:00;95;59;36;Sonnig;6;6;0;Stadt Konstanz, Amt fuer Stadtplanung und Umwelt
07.10.2023 08:00;222;121;101;Sonnig;9;9;0;Stadt Konstanz, Amt fuer Stadtplanung und Umwelt
07.10.2023 09:00;405;248;157;Sonnig;13;13;0;Stadt Konstanz, Amt fuer Stadtplanung und Umwelt
07.10.2023 10:00;464;242;222;Sonnig;16;16;0;Stadt Konstanz, Amt fuer Stadtplanung und Umwelt
07.10.2023 11:00;657;358;299;Sonnig;18;18;0;Stadt Konstanz, Amt fuer Stadtplanung und Umwelt
07.10.2023 12:00;667;336;331;Sonnig;20;20;0;Stadt Konstanz, Amt fuer Stadtplanung und Umwelt
07.10.2023 13:00;777;376;401;Sonnig;21;21;0;Stadt Konstanz, Amt fuer Stadtplanung und Umwelt
07.10.2023 14:00;777;405;372;Sonnig;22;22;0;Stadt Konstanz, Amt fuer Stadtplanung und Umwelt
07.10.2023 15:00;786;381;405;Sonnig;22;22;0;Stadt Konstanz, Amt fuer Stadtplanung und Umwelt
07.10.2023 16:00;789;363;426;Sonnig;21;21;0;Stadt Konstanz, Amt fuer Stadtplanung und Umwelt
07.10.2023 17:00;700;307;393;Sonnig;17;17;0;Stadt Konstanz, Amt fuer Stadtplanung und Umwelt
07.10.2023 18:00;724;307;417;Sonnig;13;13;0;Stadt Konstanz, Amt fuer Stadtplanung und Umwelt
07.10.2023 19:00;502;256;246;Sonnig;12;13;0;Stadt Konstanz, Amt fuer Stadtplanung und Umwelt
07.10.2023 20:00;346;168;178;Sonnig;12;12;0;Stadt Konstanz, Amt fuer Stadtplanung und Umwelt
07.10.2023 21:00;254;110;144;Sonnig;11;11;0;Stadt Konstanz, Amt fuer Stadtplanung und Umwelt
07.10.2023 22:00;249;117;132;Sonnig;10;10;0;Stadt Konstanz, Amt fuer Stadtplanung und Umwelt
07.10.2023 23:00;199;84;115;Sonnig;10;10;0;Stadt Konstanz, Amt fuer Stadtplanung und Umwelt
08.10.2023 00:00;170;59;111;Sonnig;10;10;0;Stadt Konstanz, Amt fuer Stadtplanung und Umwelt
08.10.2023 01:00;102;28;74;Sonnig;10;10;0;Stadt Konstanz, Amt fuer Stadtplanung und Umwelt
08.10.2023 02:00;74;28;46;Sonnig;9;9;0;Stadt Konstanz, Amt fuer Stadtplanung und Umwelt
08.10.2023 03:00;64;20;44;Sonnig;9;9;0;Stadt Konstanz, Amt fuer Stadtplanung und Umwelt
08.10.2023 04:00;41;30;11;Sonnig;9;9;0;Stadt Konstanz, Amt fuer Stadtplanung und Umwelt
08.10.2023 05:00;26;11;15;Sonnig;9;9;0;Stadt Konstanz, Amt fuer Stadtplanung und Umwelt
08.10.2023 06:00;36;24;12;Sonnig;9;9;0;Stadt Konstanz, Amt fuer Stadtplanung und Umwelt
08.10.2023 07:00;70;36;34;Sonnig;9;9;0;Stadt Konstanz, Amt fuer Stadtplanung und Umwelt
08.10.2023 08:00;109;63;46;Sonnig;12;12;0;Stadt Konstanz, Amt fuer Stadtplanung und Umwelt
08.10.2023 09:00;284;150;134;Sonnig;15;15;0;Stadt Konstanz, Amt fuer Stadtplanung und Umwelt
08.10.2023 10:00;372;202;170;Leicht bewoelkt;18;18;0;Stadt Konstanz, Amt fuer Stadtplanung und Umwelt
08.10.2023 11:00;488;258;230;Leicht bewoelkt;21;21;0;Stadt Konstanz, Amt fuer Stadtplanung und Umwelt
08.10.2023 12:00;767;457;310;Leicht bewoelkt;22;24;0;Stadt Konstanz, Amt fuer Stadtplanung und Umwelt
08.10.2023 13:00;771;463;308;Sonnig;23;24;0;Stadt Konstanz, Amt fuer Stadtplanung und Umwelt
08.10.2023 14:00;892;465;427;Sonnig;23;24;0;Stadt Konstanz, Amt fuer Stadtplanung und Umwelt
08.10.2023 15:00;758;370;388;Sonnig;23;25;0;Stadt Konstanz, Amt fuer Stadtplanung und Umwelt
08.10.2023 16:00;901;407;494;Sonnig;22;25;0;Stadt Konstanz, Amt fuer Stadtplanung und Umwelt
08.10.2023 17:00;771;297;474;Leicht bewoelkt;19;19;0;Stadt Konstanz, Amt fuer Stadtplanung und Umwelt
08.10.2023 18:00;569;193;376;Leicht bewoelkt;16;16;0;Stadt Konstanz, Amt fuer Stadtplanung und Umwelt
08.10.2023 19:00;406;173;233;Sonnig;16;16;0;Stadt Konstanz, Amt fuer Stadtplanung und Umwelt
08.10.2023 20:00;259;108;151;Sonnig;14;14;0;Stadt Konstanz, Amt fuer Stadtplanung und Umwelt
08.10.2023 21:00;146;71;75;Sonnig;13;13;0;Stadt Konstanz, Amt fuer Stadtplanung und Umwelt
08.10.2023 22:00;141;61;80;Sonnig;12;11;0;Stadt Konstanz, Amt fuer Stadtplanung und Umwelt
08.10.2023 23:00;59;19;40;Sonnig;11;10;0;Stadt Konstanz, Amt fuer Stadtplanung und Umwelt
09.10.2023 00:00;23;11;12;Sonnig;10;10;0;Stadt Konstanz, Amt fuer Stadtplanung und Umwelt
09.10.2023 01:00;13;8;5;Sonnig;10;10;0;Stadt Konstanz, Amt fuer Stadtplanung und Umwelt
09.10.2023 02:00;7;5;2;Sonnig;9;10;0;Stadt Konstanz, Amt fuer Stadtplanung und Umwelt
09.10.2023 03:00;2;1;1;Sonnig;9;9;0;Stadt Konstanz, Amt fuer Stadtplanung und Umwelt
09.10.2023 04:00;13;6;7;Sonnig;9;9;0;Stadt Konstanz, Amt fuer Stadtplanung und Umwelt
09.10.2023 05:00;63;40;23;Leicht bewoelkt;9;9;0;Stadt Konstanz, Amt fuer Stadtplanung und Umwelt
09.10.2023 06:00;200;114;86;Sonnig;9;9;0;Stadt Konstanz, Amt fuer Stadtplanung und Umwelt
09.10.2023 07:00;1178;784;394;Sonnig;9;9;0;Stadt Konstanz, Amt fuer Stadtplanung und Umwelt
09.10.2023 08:00;816;438;378;Sonnig;12;12;0;Stadt Konstanz, Amt fuer Stadtplanung und Umwelt
09.10.2023 09:00;887;557;330;Sonnig;15;15;0;Stadt Konstanz, Amt fuer Stadtplanung und Umwelt
09.10.2023 10:00;504;271;233;Sonnig;18;18;0;Stadt Konstanz, Amt fuer Stadtplanung und Umwelt
09.10.2023 11:00;727;355;372;Sonnig;20;20;0;Stadt Konstanz, Amt fuer Stadtplanung und Umwelt
09.10.2023 12:00;762;357;405;Sonnig;22;22;0;Stadt Konstanz, Amt fuer Stadtplanung und Umwelt
09.10.2023 13:00;1127;500;627;Sonnig;23;25;0;Stadt Konstanz, Amt fuer Stadtplanung und Umwelt
09.10.2023 14:00;850;442;408;Sonnig;24;25;0;Stadt Konstanz, Amt fuer Stadtplanung und Umwelt
09.10.2023 15:00;1196;535;661;Leicht bewoelkt;24;25;0;Stadt Konstanz, Amt fuer Stadtplanung und Umwelt
09.10.2023 16:00;1139;515;624;Bewoelkt;23;25;0;Stadt Konstanz, Amt fuer Stadtplanung und Umwelt
09.10.2023 17:00;1247;535;712;Leicht bewoelkt;19;19;0;Stadt Konstanz, Amt fuer Stadtplanung und Umwelt
09.10.2023 18:00;923;409;514;Leicht bewoelkt;16;16;0;Stadt Konstanz, Amt fuer Stadtplanung und Umwelt
09.10.2023 19:00;659;311;348;Sonnig;15;16;0;Stadt Konstanz, Amt fuer Stadtplanung und Umwelt
09.10.2023 20:00;402;211;191;Leicht bewoelkt;14;15;0;Stadt Konstanz, Amt fuer Stadtplanung und Umwelt
09.10.2023 21:00;309;117;192;Leicht bewoelkt;15;15;0;Stadt Konstanz, Amt fuer Stadtplanung und Umwelt
09.10.2023 22:00;203;82;121;Leicht bewoelkt;15;15;0;Stadt Konstanz, Amt fuer Stadtplanung und Umwelt
09.10.2023 23:00;102;44;58;Leicht bewoelkt;14;14;0;Stadt Konstanz, Amt fuer Stadtplanung und Umwelt
10.10.2023 00:00;58;12;46;Leicht bewoelkt;14;14;0;Stadt Konstanz, Amt fuer Stadtplanung und Umwelt
10.10.2023 01:00;37;17;20;Sonnig;13;13;0;Stadt Konstanz, Amt fuer Stadtplanung und Umwelt
10.10.2023 02:00;13;5;8;Sonnig;12;12;0;Stadt Konstanz, Amt fuer Stadtplanung und Umwelt
10.10.2023 03:00;14;11;3;Sonnig;12;12;0;Stadt Konstanz, Amt fuer Stadtplanung und Umwelt
10.10.2023 04:00;14;8;6;Sonnig;11;11;0;Stadt Konstanz, Amt fuer Stadtplanung und Umwelt
10.10.2023 05:00;67;51;16;Sonnig;10;10;0;Stadt Konstanz, Amt fuer Stadtplanung und Umwelt
10.10.2023 06:00;215;127;88;Leicht bewoelkt;10;10;0;Stadt Konstanz, Amt fuer Stadtplanung und Umwelt
10.10.2023 07:00;1239;874;365;Leicht bewoelkt;10;10;0;Stadt Konstanz, Amt fuer Stadtplanung und Umwelt
10.10.2023 08:00;868;474;394;Leicht bewoelkt;13;13;0;Stadt Konstanz, Amt fuer Stadtplanung und Umwelt
10.10.2023 09:00;872;549;323;Sonnig;16;16;0;Stadt Konstanz, Amt fuer Stadtplanung und Umwelt
10.10.2023 10:00;505;274;231;Sonnig;19;19;0;Stadt Konstanz, Amt fuer Stadtplanung und Umwelt
10.10.2023 11:00;743;346;397;Sonnig;21;21;0;Stadt Konstanz, Amt fuer Stadtplanung und Umwelt
10.10.2023 12:00;855;358;497;Sonnig;23;24;0;Stadt Konstanz, Amt fuer Stadtplanung und Umwelt
10.10.2023 13:00;1139;518;621;Sonnig;24;25;0;Stadt Konstanz, Amt fuer Stadtplanung und Umwelt
10.10.2023 14:00;939;470;469;Sonnig;24;25;0;Stadt Konstanz, Amt fuer Stadtplanung und Umwelt
10.10.2023 15:00;1231;578;653;Sonnig;24;25;0;Stadt Konstanz, Amt fuer Stadtplanung und Umwelt
10.10.2023 16:00;1203;542;661;Sonnig;23;25;0;Stadt Konstanz, Amt fuer Stadtplanung und Umwelt
10.10.2023 17:00;1422;600;822;Sonnig;18;18;0;Stadt Konstanz, Amt fuer Stadtplanung und Umwelt
10.10.2023 18:00;1114;439;675;Sonnig;15;15;0;Stadt Konstanz, Amt fuer Stadtplanung und Umwelt
10.10.2023 19:00;861;442;419;Sonnig;14;14;0;Stadt Konstanz, Amt fuer Stadtplanung und Umwelt
10.10.2023 20:00;429;204;225;Sonnig;13;13;0;Stadt Konstanz, Amt fuer Stadtplanung und Umwelt
10.10.2023 21:00;386;147;239;Sonnig;13;13;0;Stadt Konstanz, Amt fuer Stadtplanung und Umwelt
10.10.2023 22:00;235;100;135;Sonnig;12;12;0;Stadt Konstanz, Amt fuer Stadtplanung und Umwelt
10.10.2023 23:00;118;38;80;Sonnig;12;12;0;Stadt Konstanz, Amt fuer Stadtplanung und Umwelt
11.10.2023 00:00;47;26;21;Sonnig;11;11;0;Stadt Konstanz, Amt fuer Stadtplanung und Umwelt
11.10.2023 01:00;20;13;7;Sonnig;10;10;0;Stadt Konstanz, Amt fuer Stadtplanung und Umwelt
11.10.2023 02:00;8;6;2;Sonnig;10;10;0;Stadt Konstanz, Amt fuer Stadtplanung und Umwelt
11.10.2023 03:00;10;5;5;Sonnig;10;10;0;Stadt Konstanz, Amt fuer Stadtplanung und Umwelt
11.10.2023 04:00;14;6;8;Sonnig;10;10;0;Stadt Konstanz, Amt fuer Stadtplanung und Umwelt
11.10.2023 05:00;48;34;14;Sonnig;9;9;0;Stadt Konstanz, Amt fuer Stadtplanung und Umwelt
11.10.2023 06:00;228;134;94;Sonnig;9;9;0;Stadt Konstanz, Amt fuer Stadtplanung und Umwelt
11.10.2023 07:00;1270;850;420;Sonnig;9;9;0;Stadt Konstanz, Amt fuer Stadtplanung und Umwelt
11.10.2023 08:00;842;493;349;Sonnig;11;11;0;Stadt Konstanz, Amt fuer Stadtplanung und Umwelt
11.10.2023 09:00;856;505;351;Sonnig;15;15;0;Stadt Konstanz, Amt fuer Stadtplanung und Umwelt
11.10.2023 10:00;512;259;253;Sonnig;18;18;0;Stadt Konstanz, Amt fuer Stadtplanung und Umwelt
11.10.2023 11:00;699;299;400;Sonnig;20;20;0;Stadt Konstanz, Amt fuer Stadtplanung und Umwelt
11.10.2023 12:00;834;385;449;Sonnig;22;24;0;Stadt Konstanz, Amt fuer Stadtplanung und Umwelt
11.10.2023 13:00;1229;635;594;Sonnig;23;25;0;Stadt Konstanz, Amt fuer Stadtplanung und Umwelt
11.10.2023 14:00;755;373;382;Sonnig;24;25;0;Stadt Konstanz, Amt fuer Stadtplanung und Umwelt
11.10.2023 15:00;1182;557;625;Sonnig;24;25;0;Stadt Konstanz, Amt fuer Stadtplanung und Umwelt
11.10.2023 16:00;1180;583;597;Sonnig;23;25;0;Stadt Konstanz, Amt fuer Stadtplanung und Umwelt
11.10.2023 17:00;1405;652;753;Sonnig;19;19;0;Stadt Konstanz, Amt fuer Stadtplanung und Umwelt
11.10.2023 18:00;1126;444;682;Sonnig;15;15;0;Stadt Konstanz, Amt fuer Stadtplanung und Umwelt
11.10.2023 19:00;778;375;403;Sonnig;14;15;0;Stadt Konstanz, Amt fuer Stadtplanung und Umwelt
11.10.2023 20:00;562;292;270;Sonnig;13;14;0;Stadt Konstanz, Amt fuer Stadtplanung und Umwelt
11.10.2023 21:00;385;180;205;Sonnig;13;13;0;Stadt Konstanz, Amt fuer Stadtplanung und Umwelt
11.10.2023 22:00;265;86;179;Sonnig;12;12;0;Stadt Konstanz, Amt fuer Stadtplanung und Umwelt
11.10.2023 23:00;227;70;157;Sonnig;12;12;0;Stadt Konstanz, Amt fuer Stadtplanung und Umwelt
12.10.2023 00:00;75;14;61;Sonnig;11;11;0;Stadt Konstanz, Amt fuer Stadtplanung und Umwelt
12.10.2023 01:00;65;7;58;Sonnig;11;11;0;Stadt Konstanz, Amt fuer Stadtplanung und Umwelt
12.10.2023 02:00;10;1;9;Sonnig;10;10;0;Stadt Konstanz, Amt fuer Stadtplanung und Umwelt
12.10.2023 03:00;6;1;5;Sonnig;10;11;0;Stadt Konstanz, Amt fuer Stadtplanung und Umwelt
12.10.2023 04:00;12;6;6;Sonnig;10;10;0;Stadt Konstanz, Amt fuer Stadtplanung und Umwelt
12.10.2023 05:00;54;40;14;Sonnig;10;10;0;Stadt Konstanz, Amt fuer Stadtplanung und Umwelt
12.10.2023 06:00;218;126;92;Sonnig;9;10;0;Stadt Konstanz, Amt fuer Stadtplanung und Umwelt
12.10.2023 07:00;1170;737;433;Bewoelkt;9;10;0;Stadt Konstanz, Amt fuer Stadtplanung und Umwelt
12.10.2023 08:00;837;477;360;Leicht bewoelkt;12;13;0;Stadt Konstanz, Amt fuer Stadtplanung und Umwelt
12.10.2023 09:00;778;500;278;Leicht bewoelkt;15;15;0;Stadt Konstanz, Amt fuer Stadtplanung und Umwelt
12.10.2023 10:00;537;299;238;Leicht bewoelkt;18;18;0;Stadt Konstanz, Amt fuer Stadtplanung und Umwelt
12.10.2023 11:00;737;398;339;Leicht bewoelkt;20;20;0;Stadt Konstanz, Amt fuer Stadtplanung und Umwelt
12.10.2023 12:00;751;334;417;Leicht bewoelkt;21;21;0;Stadt Konstanz, Amt fuer Stadtplanung und Umwelt
12.10.2023 13:00;1143;506;637;Sonnig;22;24;0;Stadt Konstanz, Amt fuer Stadtplanung und Umwelt
12.10.2023 14:00;890;417;473;Leicht bewoelkt;23;24;0;Stadt Konstanz, Amt fuer Stadtplanung und Umwelt
12.10.2023 15:00;1270;575;695;Leicht bewoelkt;22;24;0;Stadt Konstanz, Amt fuer Stadtplanung und Umwelt
12.10.2023 16:00;1209;588;621;Leicht bewoelkt;21;21;0;Stadt Konstanz, Amt fuer Stadtplanung und Umwelt
12.10.2023 17:00;1323;589;734;Bewoelkt;19;19;0;Stadt Konstanz, Amt fuer Stadtplanung und Umwelt
12.10.2023 18:00;1014;470;544;Leicht bewoelkt;16;16;0;Stadt Konstanz, Amt fuer Stadtplanung und Umwelt
12.10.2023 19:00;758;370;388;Leicht bewoelkt;15;15;0;Stadt Konstanz, Amt fuer Stadtplanung und Umwelt
12.10.2023 20:00;438;196;242;Leicht bewoelkt;14;14;0;Stadt Konstanz, Amt fuer Stadtplanung und Umwelt
12.10.2023 21:00;337;143;194;Leicht bewoelkt;13;13;0;Stadt Konstanz, Amt fuer Stadtplanung und Umwelt
12.10.2023 22:00;271;72;199;Sonnig;14;14;0;Stadt Konstanz, Amt fuer Stadtplanung und Umwelt
12.10.2023 23:00;167;70;97;Sonnig;12;12;0;Stadt Konstanz, Amt fuer Stadtplanung und Umwelt
13.10.2023 00:00;82;27;55;Leicht bewoelkt;12;12;0;Stadt Konstanz, Amt fuer Stadtplanung und Umwelt
13.10.2023 01:00;74;11;63;Leicht bewoelkt;11;11;0;Stadt Konstanz, Amt fuer Stadtplanung und Umwelt
13.10.2023 02:00;17;2;15;Leicht bewoelkt;11;11;0;Stadt Konstanz, Amt fuer Stadtplanung und Umwelt
13.10.2023 03:00;15;5;10;Leicht bewoelkt;11;11;0;Stadt Konstanz, Amt fuer Stadtplanung und Umwelt
13.10.2023 04:00;9;5;4;Leicht bewoelkt;11;11;0;Stadt Konstanz, Amt fuer Stadtplanung und Umwelt
13.10.2023 05:00;52;40;12;Sonnig;10;10;0;Stadt Konstanz, Amt fuer Stadtplanung und Umwelt
13.10.2023 06:00;184;114;70;Sonnig;10;10;0;Stadt Konstanz, Amt fuer Stadtplanung und Umwelt
13.10.2023 07:00;1082;715;367;Sonnig;10;10;0;Stadt Konstanz, Amt fuer Stadtplanung und Umwelt
13.10.2023 08:00;794;447;347;Sonnig;12;12;0;Stadt Konstanz, Amt fuer Stadtplanung und Umwelt
13.10.2023 09:00;804;461;343;Sonnig;16;16;0;Stadt Konstanz, Amt fuer Stadtplanung und Umwelt
13.10.2023 10:00;619;350;269;Sonnig;19;19;0;Stadt Konstanz, Amt fuer Stadtplanung und Umwelt
13.10.2023 11:00;740;357;383;Sonnig;21;21;0;Stadt Konstanz, Amt fuer Stadtplanung und Umwelt
13.10.2023 12:00;916;415;501;Sonnig;22;22;0;Stadt Konstanz, Amt fuer Stadtplanung und Umwelt
13.10.2023 13:00;1226;510;716;Sonnig;22;24;0;Stadt Konstanz, Amt fuer Stadtplanung und Umwelt
13.10.2023 14:00;969;513;456;Sonnig;23;24;0;Stadt Konstanz, Amt fuer Stadtplanung und Umwelt
13.10.2023 15:00;1008;469;539;Sonnig;23;24;0;Stadt Konstanz, Amt fuer Stadtplanung und Umwelt
13.10.2023 16:00;1005;478;527;Sonnig;22;24;0;Stadt Konstanz, Amt fuer Stadtplanung und Umwelt
13.10.2023 17:00;953;426;527;Sonnig;18;18;0;Stadt Konstanz, Amt fuer Stadtplanung und Umwelt
13.10.2023 18:00;929;379;550;Sonnig;15;15;0;Stadt Konstanz, Amt fuer Stadtplanung und Umwelt
13.10.2023 19:00;712;316;396;Sonnig;14;14;0;Stadt Konstanz, Amt fuer Stadtplanung und Umwelt
13.10.2023 20:00;454;201;253;Sonnig;13;13;0;Stadt Konstanz, Amt fuer Stadtplanung und Umwelt
13.10.2023 21:00;351;150;201;Sonnig;12;12;0;Stadt Konstanz, Amt fuer Stadtplanung und Umwelt
13.10.2023 22:00;298;135;163;Sonnig;11;12;0;Stadt Konstanz, Amt fuer Stadtplanung und Umwelt
13.10.2023 23:00;271;131;140;Sonnig;11;11;0;Stadt Konstanz, Amt fuer Stadtplanung und Umwelt
14.10.2023 00:00;166;73;93;Leicht bewoelkt;12;12;0;Stadt Konstanz, Amt fuer Stadtplanung und Umwelt
14.10.2023 01:00;122;49;73;Leicht bewoelkt;12;11;0;Stadt Konstanz, Amt fuer Stadtplanung und Umwelt
14.10.2023 02:00;81;25;56;Leicht bewoelkt;14;13;0;Stadt Konstanz, Amt fuer Stadtplanung und Umwelt
14.10.2023 03:00;59;16;43;Leicht bewoelkt;16;16;0;Stadt Konstanz, Amt fuer Stadtplanung und Umwelt
14.10.2023 04:00;31;10;21;Leicht bewoelkt;15;15;0;Stadt Konstanz, Amt fuer Stadtplanung und Umwelt
14.10.2023 05:00;42;23;19;Stellenweiser Regenfall;14;13;0.1;Stadt Konstanz, Amt fuer Stadtplanung und Umwelt
14.10.2023 06:00;47;24;23;Stellenweiser Regenfall;15;15;0;Stadt Konstanz, Amt fuer Stadtplanung und Umwelt
14.10.2023 07:00;82;53;29;Stellenweiser Regenfall;15;15;0.1;Stadt Konstanz, Amt fuer Stadtplanung und Umwelt
14.10.2023 08:00;169;84;85;Stellenweiser Regenfall;16;16;0.1;Stadt Konstanz, Amt fuer Stadtplanung und Umwelt
14.10.2023 09:00;365;211;154;Nieselregen;15;14;0.5;Stadt Konstanz, Amt fuer Stadtplanung und Umwelt
14.10.2023 10:00;419;243;176;Stellenweiser Regenfall;16;16;0.1;Stadt Konstanz, Amt fuer Stadtplanung und Umwelt
14.10.2023 11:00;560;308;252;Nieselregen;18;18;0.3;Stadt Konstanz, Amt fuer Stadtplanung und Umwelt
14.10.2023 12:00;521;271;250;Leichter Regenschauer;18;18;0.5;Stadt Konstanz, Amt fuer Stadtplanung und Umwelt
14.10.2023 13:00;456;226;230;Leichter Regenschauer;16;16;0.7;Stadt Konstanz, Amt fuer Stadtplanung und Umwelt
14.10.2023 14:00;541;238;303;Leichter Regenschauer;15;15;0.4;Stadt Konstanz, Amt fuer Stadtplanung und Umwelt
14.10.2023 15:00;524;236;288;Stellenweiser Regenfall;12;12;0.1;Stadt Konstanz, Amt fuer Stadtplanung und Umwelt
14.10.2023 16:00;368;158;210;Stellenweiser Regenfall;12;11;0;Stadt Konstanz, Amt fuer Stadtplanung und Umwelt
14.10.2023 17:00;419;202;217;Stellenweiser Regenfall;11;10;0;Stadt Konstanz, Amt fuer Stadtplanung und Umwelt
14.10.2023 18:00;368;169;199;Stellenweiser Regenfall;9;8;0;Stadt Konstanz, Amt fuer Stadtplanung und Umwelt
14.10.2023 19:00;310;172;138;Bewoelkt;9;9;0;Stadt Konstanz, Amt fuer Stadtplanung und Umwelt
14.10.2023 20:00;235;140;95;Stellenweiser Regenfall;10;10;0.1;Stadt Konstanz, Amt fuer Stadtplanung und Umwelt
14.10.2023 21:00;208;95;113;Stellenweiser Regenfall;10;10;0.1;Stadt Konstanz, Amt fuer Stadtplanung und Umwelt
14.10.2023 22:00;173;69;104;Stellenweiser Regenfall;10;10;0;Stadt Konstanz, Amt fuer Stadtplanung und Umwelt
14.10.2023 23:00;165;69;96;Stellenweiser Regenfall;9;9;0;Stadt Konstanz, Amt fuer Stadtplanung und Umwelt
15.10.2023 00:00;128;34;94;Stellenweiser Regenfall;8;7;0;Stadt Konstanz, Amt fuer Stadtplanung und Umwelt
15.10.2023 01:00;104;30;74;Stellenweiser Regenfall;8;8;0;Stadt Konstanz, Amt fuer Stadtplanung und Umwelt
15.10.2023 02:00;83;29;54;Stellenweiser Regenfall;9;9;0;Stadt Konstanz, Amt fuer Stadtplanung und Umwelt
15.10.2023 03:00;71;29;42;Stellenweiser Regenfall;9;9;0;Stadt Konstanz, Amt fuer Stadtplanung und Umwelt
15.10.2023 04:00;44;23;21;Stellenweiser Regenfall;8;8;0;Stadt Konstanz, Amt fuer Stadtplanung und Umwelt
15.10.2023 05:00;28;11;17;Bewoelkt;8;8;0;Stadt Konstanz, Amt fuer Stadtplanung und Umwelt
15.10.2023 06:00;29;18;11;Bewoelkt;8;8;0;Stadt Konstanz, Amt fuer Stadtplanung und Umwelt
15.10.2023 07:00;29;12;17;Leicht bewoelkt;8;8;0;Stadt Konstanz, Amt fuer Stadtplanung und Umwelt
15.10.2023 08:00;91;49;42;Leicht bewoelkt;9;9;0;Stadt Konstanz, Amt fuer Stadtplanung und Umwelt
15.10.2023 09:00;197;119;78;Stellenweiser Regenfall;10;9;0;Stadt Konstanz, Amt fuer Stadtplanung und Umwelt
15.10.2023 10:00;172;97;75;Leicht bewoelkt;11;10;0;Stadt Konstanz, Amt fuer Stadtplanung und Umwelt
15.10.2023 11:00;273;133;140;Stellenweiser Regenfall;12;11;0;Stadt Konstanz, Amt fuer Stadtplanung und Umwelt
15.10.2023 12:00;309;158;151;Stellenweiser Regenfall;13;12;0;Stadt Konstanz, Amt fuer Stadtplanung und Umwelt
15.10.2023 13:00;337;171;166;Sonnig;13;12;0;Stadt Konstanz, Amt fuer Stadtplanung und Umwelt
15.10.2023 14:00;400;212;188;Leicht bewoelkt;13;11;0;Stadt Konstanz, Amt fuer Stadtplanung und Umwelt
15.10.2023 15:00;443;225;218;Leicht bewoelkt;12;10;0;Stadt Konstanz, Amt fuer Stadtplanung und Umwelt
15.10.2023 16:00;465;234;231;Leicht bewoelkt;11;9;0;Stadt Konstanz, Amt fuer Stadtplanung und Umwelt
15.10.2023 17:00;449;218;231;Sonnig;9;8;0;Stadt Konstanz, Amt fuer Stadtplanung und Umwelt
15.10.2023 18:00;384;188;196;Sonnig;6;4;0;Stadt Konstanz, Amt fuer Stadtplanung und Umwelt
15.10.2023 19:00;277;137;140;Leicht bewoelkt;4;3;0;Stadt Konstanz, Amt fuer Stadtplanung und Umwelt
15.10.2023 20:00;186;95;91;Leicht bewoelkt;4;2;0;Stadt Konstanz, Amt fuer Stadtplanung und Umwelt
15.10.2023 21:00;149;67;82;Sonnig;3;1;0;Stadt Konstanz, Amt fuer Stadtplanung und Umwelt
15.10.2023 22:00;99;42;57;Sonnig;3;1;0;Stadt Konstanz, Amt fuer Stadtplanung und Umwelt
15.10.2023 23:00;63;28;35;Sonnig;2;0;0;Stadt Konstanz, Amt fuer Stadtplanung und Umwelt
16.10.2023 00:00;46;20;26;Sonnig;2;0;0;Stadt Konstanz, Amt fuer Stadtplanung und Umwelt
16.10.2023 01:00;15;4;11;Sonnig;2;-1;0;Stadt Konstanz, Amt fuer Stadtplanung und Umwelt
16.10.2023 02:00;6;3;3;Sonnig;1;-1;0;Stadt Konstanz, Amt fuer Stadtplanung und Umwelt
16.10.2023 03:00;4;2;2;Sonnig;1;-2;0;Stadt Konstanz, Amt fuer Stadtplanung und Umwelt
16.10.2023 04:00;7;4;3;Sonnig;0;-2;0;Stadt Konstanz, Amt fuer Stadtplanung und Umwelt
16.10.2023 05:00;68;36;32;Leicht bewoelkt;0;-2;0;Stadt Konstanz, Amt fuer Stadtplanung und Umwelt
16.10.2023 06:00;200;104;96;Leicht bewoelkt;0;-3;0;Stadt Konstanz, Amt fuer Stadtplanung und Umwelt
16.10.2023 07:00;1169;709;460;Bewoelkt;0;-3;0;Stadt Konstanz, Amt fuer Stadtplanung und Umwelt
16.10.2023 08:00;815;441;374;Bedeckt;3;1;0;Stadt Konstanz, Amt fuer Stadtplanung und Umwelt
16.10.2023 09:00;804;501;303;Leicht bewoelkt;6;3;0;Stadt Konstanz, Amt fuer Stadtplanung und Umwelt
16.10.2023 10:00;452;251;201;Sonnig;8;5;0;Stadt Konstanz, Amt fuer Stadtplanung und Umwelt
16.10.2023 11:00;598;274;324;Sonnig;9;7;0;Stadt Konstanz, Amt fuer Stadtplanung und Umwelt
16.10.2023 12:00;704;330;374;Sonnig;11;9;0;Stadt Konstanz, Amt fuer Stadtplanung und Umwelt
16.10.2023 13:00;1050;470;580;Leicht bewoelkt;11;10;0;Stadt Konstanz, Amt fuer Stadtplanung und Umwelt
16.10.2023 14:00;747;384;363;Bedeckt;12;10;0;Stadt Konstanz, Amt fuer Stadtplanung und Umwelt
16.10.2023 15:00;1166;590;576;Bewoelkt;12;10;0;Stadt Konstanz, Amt fuer Stadtplanung und Umwelt
16.10.2023 16:00;1053;491;562;Leicht bewoelkt;11;9;0;Stadt Konstanz, Amt fuer Stadtplanung und Umwelt
16.10.2023 17:00;1190;491;699;Sonnig;8;7;0;Stadt Konstanz, Amt fuer Stadtplanung und Umwelt
16.10.2023 18:00;913;423;490;Bewoelkt;5;3;0;Stadt Konstanz, Amt fuer Stadtplanung und Umwelt
16.10.2023 19:00;655;324;331;Bedeckt;4;2;0;Stadt Konstanz, Amt fuer Stadtplanung und Umwelt
16.10.2023 20:00;416;182;234;Bedeckt;4;2;0;Stadt Konstanz, Amt fuer Stadtplanung und Umwelt
16.10.2023 21:00;301;128;173;Leicht bewoelkt;3;1;0;Stadt Konstanz, Amt fuer Stadtplanung und Umwelt
16.10.2023 22:00;202;84;118;Leicht bewoelkt;2;0;0;Stadt Konstanz, Amt fuer Stadtplanung und Umwelt
16.10.2023 23:00;123;53;70;Leicht bewoelkt;1;-1;0;Stadt Konstanz, Amt fuer Stadtplanung und Umwelt
17.10.2023 00:00;68;39;29;Sonnig;2;0;0;Stadt Konstanz, Amt fuer Stadtplanung und Umwelt
17.10.2023 01:00;51;28;23;Sonnig;1;0;0;Stadt Konstanz, Amt fuer Stadtplanung und Umwelt
17.10.2023 02:00;30;16;14;Sonnig;1;0;0;Stadt Konstanz, Amt fuer Stadtplanung und Umwelt
17.10.2023 03:00;24;14;10;Sonnig;1;-1;0;Stadt Konstanz, Amt fuer Stadtplanung und Umwelt
17.10.2023 04:00;17;9;8;Sonnig;1;0;0;Stadt Konstanz, Amt fuer Stadtplanung und Umwelt
17.10.2023 05:00;68;39;29;Sonnig;0;-2;0;Stadt Konstanz, Amt fuer Stadtplanung und Umwelt
17.10.2023 06:00;257;131;126;Sonnig;0;-2;0;Stadt Konstanz, Amt fuer Stadtplanung und Umwelt
17.10.2023 07:00;1182;757;425;Sonnig;0;-1;0;Stadt Konstanz, Amt fuer Stadtplanung und Umwelt
17.10.2023 08:00;890;488;402;Sonnig;3;2;0;Stadt Konstanz, Amt fuer Stadtplanung und Umwelt
17.10.2023 09:00;833;508;325;Sonnig;6;5;0;Stadt Konstanz, Amt fuer Stadtplanung und Umwelt
17.10.2023 10:00;544;296;248;Sonnig;8;8;0;Stadt Konstanz, Amt fuer Stadtplanung und Umwelt
17.10.2023 11:00;717;364;353;Sonnig;11;11;0;Stadt Konstanz, Amt fuer Stadtplanung und Umwelt
17.10.2023 12:00;690;283;407;Sonnig;13;13;0;Stadt Konstanz, Amt fuer Stadtplanung und Umwelt
17.10.2023 13:00;942;400;542;Sonnig;14;14;0;Stadt Konstanz, Amt fuer Stadtplanung und Umwelt
17.10.2023 14:00;755;380;375;Sonnig;15;15;0;Stadt Konstanz, Amt fuer Stadtplanung und Umwelt
17.10.2023 15:00;1037;481;556;Sonnig;15;15;0;Stadt Konstanz, Amt fuer Stadtplanung und Umwelt
17.10.2023 16:00;995;447;548;Sonnig;14;13;0;Stadt Konstanz, Amt fuer Stadtplanung und Umwelt
17.10.2023 17:00;1289;578;711;Sonnig;11;10;0;Stadt Konstanz, Amt fuer Stadtplanung und Umwelt
17.10.2023 18:00;1008;460;548;Sonnig;7;5;0;Stadt Konstanz, Amt fuer Stadtplanung und Umwelt
17.10.2023 19:00;712;338;374;Sonnig;5;4;0;Stadt Konstanz, Amt fuer Stadtplanung und Umwelt
17.10.2023 20:00;341;153;188;Sonnig;5;3;0;Stadt Konstanz, Amt fuer Stadtplanung und Umwelt
17.10.2023 21:00;349;153;196;Sonnig;4;3;0;Stadt Konstanz, Amt fuer Stadtplanung und Umwelt
17.10.2023 22:00;219;82;137;Sonnig;4;2;0;Stadt Konstanz, Amt fuer Stadtplanung und Umwelt
17.10.2023 23:00;190;74;116;Sonnig;4;2;0;Stadt Konstanz, Amt fuer Stadtplanung und Umwelt
18.10.2023 00:00;43;21;22;Sonnig;4;2;0;Stadt Konstanz, Amt fuer Stadtplanung und Umwelt
18.10.2023 01:00;52;18;34;Leicht bewoelkt;4;2;0;Stadt Konstanz, Amt fuer Stadtplanung und Umwelt
18.10.2023 02:00;19;9;10;Leicht bewoelkt;3;2;0;Stadt Konstanz, Amt fuer Stadtplanung und Umwelt
18.10.2023 03:00;22;14;8;Leicht bewoelkt;4;2;0;Stadt Konstanz, Amt fuer Stadtplanung und Umwelt
18.10.2023 04:00;10;6;4;Bewoelkt;4;3;0;Stadt Konstanz, Amt fuer Stadtplanung und Umwelt
18.10.2023 05:00;71;48;23;Bewoelkt;4;3;0;Stadt Konstanz, Amt fuer Stadtplanung und Umwelt
18.10.2023 06:00;221;105;116;Leicht bewoelkt;4;4;0;Stadt Konstanz, Amt fuer Stadtplanung und Umwelt
18.10.2023 07:00;1153;750;403;Bewoelkt;5;4;0;Stadt Konstanz, Amt fuer Stadtplanung und Umwelt
18.10.2023 08:00;822;480;342;Bewoelkt;6;5;0;Stadt Konstanz, Amt fuer Stadtplanung und Umwelt
18.10.2023 09:00;821;509;312;Leicht bewoelkt;8;8;0;Stadt Konstanz, Amt fuer Stadtplanung und Umwelt
18.10.2023 10:00;446;223;223;Leicht bewoelkt;10;10;0;Stadt Konstanz, Amt fuer Stadtplanung und Umwelt
18.10.2023 11:00;712;304;408;Leicht bewoelkt;12;12;0;Stadt Konstanz, Amt fuer Stadtplanung und Umwelt
18.10.2023 12:00;761;333;428;Leicht bewoelkt;14;15;0;Stadt Konstanz, Amt fuer Stadtplanung und Umwelt
18.10.2023 13:00;1149;589;560;Stellenweiser Regenfall;14;14;0;Stadt Konstanz, Amt fuer Stadtplanung und Umwelt
18.10.2023 14:00;665;320;345;Stellenweiser Regenfall;14;14;0;Stadt Konstanz, Amt fuer Stadtplanung und Umwelt
18.10.2023 15:00;961;407;554;Stellenweiser Nieselregen;13;13;0.2;Stadt Konstanz, Amt fuer Stadtplanung und Umwelt
18.10.2023 16:00;915;418;497;Stellenweiser Nieselregen;12;13;0.2;Stadt Konstanz, Amt fuer Stadtplanung und Umwelt
18.10.2023 17:00;1078;463;615;Stellenweiser Regenfall;11;10;0;Stadt Konstanz, Amt fuer Stadtplanung und Umwelt
18.10.2023 18:00;926;392;534;Sonnig;10;9;0;Stadt Konstanz, Amt fuer Stadtplanung und Umwelt
18.10.2023 19:00;651;320;331;Sonnig;9;9;0;Stadt Konstanz, Amt fuer Stadtplanung und Umwelt
18.10.2023 20:00;413;208;205;Sonnig;7;7;0;Stadt Konstanz, Amt fuer Stadtplanung und Umwelt
18.10.2023 21:00;259;106;153;Leicht bewoelkt;7;5;0;Stadt Konstanz, Amt fuer Stadtplanung und Umwelt
18.10.2023 22:00;258;114;144;Leicht bewoelkt;6;6;0;Stadt Konstanz, Amt fuer Stadtplanung und Umwelt
18.10.2023 23:00;128;57;71;Leicht bewoelkt;7;7;0;Stadt Konstanz, Amt fuer Stadtplanung und Umwelt
19.10.2023 00:00;91;27;64;Leicht bewoelkt;8;8;0;Stadt Konstanz, Amt fuer Stadtplanung und Umwelt
19.10.2023 01:00;41;7;34;Leicht bewoelkt;9;9;0;Stadt Konstanz, Amt fuer Stadtplanung und Umwelt
19.10.2023 02:00;15;7;8;Leicht bewoelkt;8;8;0;Stadt Konstanz, Amt fuer Stadtplanung und Umwelt
19.10.2023 03:00;5;3;2;Leicht bewoelkt;8;8;0;Stadt Konstanz, Amt fuer Stadtplanung und Umwelt
19.10.2023 04:00;8;5;3;Leicht bewoelkt;8;8;0;Stadt Konstanz, Amt fuer Stadtplanung und Umwelt
19.10.2023 05:00;74;44;30;Leicht bewoelkt;8;8;0;Stadt Konstanz, Amt fuer Stadtplanung und Umwelt
19.10.2023 06:00;236;116;120;Leicht bewoelkt;8;8;0;Stadt Konstanz, Amt fuer Stadtplanung und Umwelt
19.10.2023 07:00;1221;756;465;Leicht bewoelkt;8;8;0;Stadt Konstanz, Amt fuer Stadtplanung und Umwelt
19.10.2023 08:00;812;468;344;Stellenweiser Regenfall;9;9;0;Stadt Konstanz, Amt fuer Stadtplanung und Umwelt
19.10.2023 09:00;773;487;286;Bewoelkt;10;10;0;Stadt Konstanz, Amt fuer Stadtplanung und Umwelt
19.10.2023 10:00;412;213;199;Leicht bewoelkt;11;11;0;Stadt Konstanz, Amt fuer Stadtplanung und Umwelt
19.10.2023 11:00;652;341;311;Leicht bewoelkt;13;13;0;Stadt Konstanz, Amt fuer Stadtplanung und Umwelt
19.10.2023 12:00;688;284;404;Leicht bewoelkt;15;15;0;Stadt Konstanz, Amt fuer Stadtplanung und Umwelt
19.10.2023 13:00;1010;434;576;Leicht bewoelkt;17;17;0;Stadt Konstanz, Amt fuer Stadtplanung und Umwelt
19.10.2023 14:00;729;373;356;Leicht bewoelkt;17;17;0;Stadt Konstanz, Amt fuer Stadtplanung und Umwelt
19.10.2023 15:00;1130;523;607;Leicht bewoelkt;17;17;0;Stadt Konstanz, Amt fuer Stadtplanung und Umwelt
19.10.2023 16:00;1027;493;534;Leicht bewoelkt;17;17;0;Stadt Konstanz, Amt fuer Stadtplanung und Umwelt
19.10.2023 17:00;1317;574;743;Stellenweiser Regenfall;14;14;0;Stadt Konstanz, Amt fuer Stadtplanung und Umwelt
19.10.2023 18:00;1004;470;534;Stellenweiser Regenfall;12;13;0;Stadt Konstanz, Amt fuer Stadtplanung und Umwelt
19.10.2023 19:00;680;350;330;Stellenweiser Nieselregen;12;12;0.3;Stadt Konstanz, Amt fuer Stadtplanung und Umwelt
19.10.2023 20:00;448;184;264;Bewoelkt;11;12;0;Stadt Konstanz, Amt fuer Stadtplanung und Umwelt
19.10.2023 21:00;377;151;226;Leicht bewoelkt;11;11;0;Stadt Konstanz, Amt fuer Stadtplanung und Umwelt
19.10.2023 22:00;258;101;157;Leicht bewoelkt;10;10;0;Stadt Konstanz, Amt fuer Stadtplanung und Umwelt
19.10.2023 23:00;155;57;98;Leichter Nebel;10;10;0;Stadt Konstanz, Amt fuer Stadtplanung und Umwelt
20.10.2023 00:00;116;39;77;Leichter Nebel;10;9;0;Stadt Konstanz, Amt fuer Stadtplanung und Umwelt
20.10.2023 01:00;67;17;50;Leicht bewoelkt;10;10;0;Stadt Konstanz, Amt fuer Stadtplanung und Umwelt
20.10.2023 02:00;15;8;7;Leichter Nebel;9;9;0;Stadt Konstanz, Amt fuer Stadtplanung und Umwelt
20.10.2023 03:00;11;5;6;Leicht bewoelkt;10;10;0;Stadt Konstanz, Amt fuer Stadtplanung und Umwelt
20.10.2023 04:00;24;8;16;Leicht bewoelkt;10;10;0;Stadt Konstanz, Amt fuer Stadtplanung und Umwelt
20.10.2023 05:00;55;34;21;Bedeckt;10;10;0;Stadt Konstanz, Amt fuer Stadtplanung und Umwelt
20.10.2023 06:00;205;99;106;Bewoelkt;10;11;0;Stadt Konstanz, Amt fuer Stadtplanung und Umwelt
20.10.2023 07:00;964;609;355;Stellenweiser Regenfall;10;10;0;Stadt Konstanz, Amt fuer Stadtplanung und Umwelt
20.10.2023 08:00;756;438;318;Bewoelkt;11;11;0;Stadt Konstanz, Amt fuer Stadtplanung und Umwelt
20.10.2023 09:00;689;395;294;Leicht bewoelkt;13;13;0;Stadt Konstanz, Amt fuer Stadtplanung und Umwelt
20.10.2023 10:00;505;260;245;Leicht bewoelkt;14;14;0;Stadt Konstanz, Amt fuer Stadtplanung und Umwelt
20.10.2023 11:00;676;330;346;Leicht bewoelkt;14;14;0;Stadt Konstanz, Amt fuer Stadtplanung und Umwelt
20.10.2023 12:00;786;367;419;Leicht bewoelkt;14;12;0;Stadt Konstanz, Amt fuer Stadtplanung und Umwelt
20.10.2023 13:00;1017;392;625;Stellenweiser Regenfall;14;12;0.1;Stadt Konstanz, Amt fuer Stadtplanung und Umwelt
20.10.2023 14:00;646;331;315;Stellenweiser Regenfall;12;10;0;Stadt Konstanz, Amt fuer Stadtplanung und Umwelt
20.10.2023 15:00;781;344;437;Stellenweiser Regenfall;11;9;0.1;Stadt Konstanz, Amt fuer Stadtplanung und Umwelt
20.10.2023 16:00;585;280;305;Nieselregen;10;9;0.7;Stadt Konstanz, Amt fuer Stadtplanung und Umwelt
20.10.2023 17:00;557;221;336;Nieselregen;10;9;0.5;Stadt Konstanz, Amt fuer Stadtplanung und Umwelt
20.10.2023 18:00;492;219;273;Leichter Nebel;10;10;0.1;Stadt Konstanz, Amt fuer Stadtplanung und Umwelt
20.10.2023 19:00;424;212;212;Nieselregen;9;10;0.2;Stadt Konstanz, Amt fuer Stadtplanung und Umwelt
20.10.2023 20:00;309;172;137;Nebel;9;9;0;Stadt Konstanz, Amt fuer Stadtplanung und Umwelt
20.10.2023 21:00;197;130;67;Nebel;9;9;0;Stadt Konstanz, Amt fuer Stadtplanung und Umwelt
20.10.2023 22:00;184;91;93;Leichter Nebel;8;8;0;Stadt Konstanz, Amt fuer Stadtplanung und Umwelt
20.10.2023 23:00;170;52;118;Leichter Nebel;8;8;0;Stadt Konstanz, Amt fuer Stadtplanung und Umwelt
21.10.2023 00:00;147;46;101;Leichter Nebel;8;8;0;Stadt Konstanz, Amt fuer Stadtplanung und Umwelt
21.10.2023 01:00;96;25;71;Nebel;8;8;0.1;Stadt Konstanz, Amt fuer Stadtplanung und Umwelt
21.10.2023 02:00;84;21;63;Leichter Nebel;9;8;0;Stadt Konstanz, Amt fuer Stadtplanung und Umwelt
21.10.2023 03:00;53;10;43;Leicht bewoelkt;9;8;0;Stadt Konstanz, Amt fuer Stadtplanung und Umwelt
21.10.2023 04:00;31;13;18;Bedeckt;10;8;0;Stadt Konstanz, Amt fuer Stadtplanung und Umwelt
21.10.2023 05:00;39;22;17;Stellenweiser Regenfall;10;8;0.1;Stadt Konstanz, Amt fuer Stadtplanung und Umwelt
21.10.2023 06:00;51;34;17;Stellenweiser Regenfall;11;9;0;Stadt Konstanz, Amt fuer Stadtplanung und Umwelt
21.10.2023 07:00;93;52;41;Stellenweiser Regenfall;9;8;0;Stadt Konstanz, Amt fuer Stadtplanung und Umwelt
21.10.2023 08:00;212;116;96;Stellenweiser Regenfall;10;10;0.1;Stadt Konstanz, Amt fuer Stadtplanung und Umwelt
21.10.2023 09:00;370;213;157;Leichter Regenfall;11;10;0.8;Stadt Konstanz, Amt fuer Stadtplanung und Umwelt
21.10.2023 10:00;460;257;203;Leichter Regenfall;11;11;0.9;Stadt Konstanz, Amt fuer Stadtplanung und Umwelt
21.10.2023 11:00;520;273;247;Leichter Regenfall;11;10;1;Stadt Konstanz, Amt fuer Stadtplanung und Umwelt
21.10.2023 12:00;592;292;300;Stellenweiser Regenfall;11;10;0.2;Stadt Konstanz, Amt fuer Stadtplanung und Umwelt
21.10.2023 13:00;542;254;288;Stellenweiser Regenfall;12;11;0;Stadt Konstanz, Amt fuer Stadtplanung und Umwelt
21.10.2023 14:00;387;191;196;Sonnig;12;12;0;Stadt Konstanz, Amt fuer Stadtplanung und Umwelt
21.10.2023 15:00;363;180;183;Stellenweiser Regenfall;13;12;0;Stadt Konstanz, Amt fuer Stadtplanung und Umwelt
21.10.2023 16:00;288;116;172;Stellenweiser Regenfall;12;11;0.1;Stadt Konstanz, Amt fuer Stadtplanung und Umwelt
21.10.2023 17:00;368;179;189;Stellenweiser Regenfall;11;11;0;Stadt Konstanz, Amt fuer Stadtplanung und Umwelt
21.10.2023 18:00;425;185;240;Stellenweiser Regenfall;9;9;0;Stadt Konstanz, Amt fuer Stadtplanung und Umwelt
21.10.2023 19:00;353;189;164;Stellenweiser Regenfall;9;8;0.1;Stadt Konstanz, Amt fuer Stadtplanung und Umwelt
21.10.2023 20:00;230;126;104;Stellenweiser Regenfall;9;9;0;Stadt Konstanz, Amt fuer Stadtplanung und Umwelt
21.10.2023 21:00;219;117;102;Stellenweiser Regenfall;9;9;0;Stadt Konstanz, Amt fuer Stadtplanung und Umwelt
21.10.2023 22:00;216;91;125;Leichter Nebel;7;7;0;Stadt Konstanz, Amt fuer Stadtplanung und Umwelt
21.10.2023 23:00;194;55;139;Leicht bewoelkt;8;8;0;Stadt Konstanz, Amt fuer Stadtplanung und Umwelt
22.10.2023 00:00;177;64;113;Leichter Nebel;6;6;0;Stadt Konstanz, Amt fuer Stadtplanung und Umwelt
22.10.2023 01:00;140;51;89;Leichter Nebel;6;6;0;Stadt Konstanz, Amt fuer Stadtplanung und Umwelt
22.10.2023 02:00;81;34;47;Leichter Nebel;6;6;0;Stadt Konstanz, Amt fuer Stadtplanung und Umwelt
22.10.2023 03:00;64;24;40;Leichter Nebel;6;6;0;Stadt Konstanz, Amt fuer Stadtplanung und Umwelt
22.10.2023 04:00;18;4;14;Leichter Nebel;6;6;0;Stadt Konstanz, Amt fuer Stadtplanung und Umwelt
22.10.2023 05:00;19;12;7;Leichter Nebel;5;5;0;Stadt Konstanz, Amt fuer Stadtplanung und Umwelt
22.10.2023 06:00;32;17;15;Leichter Nebel;5;5;0;Stadt Konstanz, Amt fuer Stadtplanung und Umwelt
22.10.2023 07:00;34;15;19;Leichter Nebel;5;5;0;Stadt Konstanz, Amt fuer Stadtplanung und Umwelt
22.10.2023 08:00;104;68;36;Leicht bewoelkt;7;7;0;Stadt Konstanz, Amt fuer Stadtplanung und Umwelt
22.10.2023 09:00;233;115;118;Sonnig;9;9;0;Stadt Konstanz, Amt fuer Stadtplanung und Umwelt
22.10.2023 10:00;295;133;162;Sonnig;11;11;0;Stadt Konstanz, Amt fuer Stadtplanung und Umwelt
22.10.2023 11:00;374;191;183;Sonnig;12;12;0;Stadt Konstanz, Amt fuer Stadtplanung und Umwelt
22.10.2023 12:00;417;224;193;Sonnig;13;13;0;Stadt Konstanz, Amt fuer Stadtplanung und Umwelt
22.10.2023 13:00;510;243;267;Sonnig;14;14;0;Stadt Konstanz, Amt fuer Stadtplanung und Umwelt
22.10.2023 14:00;495;271;224;Leicht bewoelkt;15;14;0;Stadt Konstanz, Amt fuer Stadtplanung und Umwelt
22.10.2023 15:00;593;331;262;Sonnig;15;14;0;Stadt Konstanz, Amt fuer Stadtplanung und Umwelt
22.10.2023 16:00;598;276;322;Sonnig;14;14;0;Stadt Konstanz, Amt fuer Stadtplanung und Umwelt
22.10.2023 17:00;585;255;330;Sonnig;10;10;0;Stadt Konstanz, Amt fuer Stadtplanung und Umwelt
22.10.2023 18:00;493;241;252;Sonnig;8;8;0;Stadt Konstanz, Amt fuer Stadtplanung und Umwelt
22.10.2023 19:00;266;130;136;Sonnig;8;8;0;Stadt Konstanz, Amt fuer Stadtplanung und Umwelt
22.10.2023 20:00;232;129;103;Leicht bewoelkt;8;8;0;Stadt Konstanz, Amt fuer Stadtplanung und Umwelt
22.10.2023 21:00;160;92;68;Bewoelkt;8;8;0;Stadt Konstanz, Amt fuer Stadtplanung und Umwelt
22.10.2023 22:00;118;61;57;Bedeckt;7;7;0;Stadt Konstanz, Amt fuer Stadtplanung und Umwelt
22.10.2023 23:00;60;31;29;Leicht bewoelkt;7;7;0;Stadt Konstanz, Amt fuer Stadtplanung und Umwelt
23.10.2023 00:00;40;28;12;Sonnig;6;6;0;Stadt Konstanz, Amt fuer Stadtplanung und Umwelt
23.10.2023 01:00;16;6;10;Sonnig;5;5;0;Stadt Konstanz, Amt fuer Stadtplanung und Umwelt
23.10.2023 02:00;7;2;5;Sonnig;5;4;0;Stadt Konstanz, Amt fuer Stadtplanung und Umwelt
23.10.2023 03:00;1;0;1;Sonnig;5;5;0;Stadt Konstanz, Amt fuer Stadtplanung und Umwelt
23.10.2023 04:00;12;4;8;Sonnig;5;4;0;Stadt Konstanz, Amt fuer Stadtplanung und Umwelt
23.10.2023 05:00;65;43;22;Sonnig;4;4;0;Stadt Konstanz, Amt fuer Stadtplanung und Umwelt
23.10.2023 06:00;233;113;120;Sonnig;4;3;0;Stadt Konstanz, Amt fuer Stadtplanung und Umwelt
23.10.2023 07:00;1087;712;375;Sonnig;4;3;0;Stadt Konstanz, Amt fuer Stadtplanung und Umwelt
23.10.2023 08:00;824;456;368;Sonnig;6;5;0;Stadt Konstanz, Amt fuer Stadtplanung und Umwelt
23.10.2023 09:00;909;567;342;Sonnig;9;9;0;Stadt Konstanz, Amt fuer Stadtplanung und Umwelt
23.10.2023 10:00;468;251;217;Sonnig;11;11;0;Stadt Konstanz, Amt fuer Stadtplanung und Umwelt
23.10.2023 11:00;643;331;312;Sonnig;13;13;0;Stadt Konstanz, Amt fuer Stadtplanung und Umwelt
23.10.2023 12:00;675;334;341;Sonnig;15;14;0;Stadt Konstanz, Amt fuer Stadtplanung und Umwelt
23.10.2023 13:00;992;439;553;Sonnig;16;16;0;Stadt Konstanz, Amt fuer Stadtplanung und Umwelt
23.10.2023 14:00;693;330;363;Leicht bewoelkt;16;16;0;Stadt Konstanz, Amt fuer Stadtplanung und Umwelt
23.10.2023 15:00;1058;506;552;Sonnig;16;16;0;Stadt Konstanz, Amt fuer Stadtplanung und Umwelt
23.10.2023 16:00;1047;533;514;Sonnig;15;15;0;Stadt Konstanz, Amt fuer Stadtplanung und Umwelt
23.10.2023 17:00;1180;492;688;Sonnig;12;12;0;Stadt Konstanz, Amt fuer Stadtplanung und Umwelt
23.10.2023 18:00;1057;431;626;Sonnig;10;10;0;Stadt Konstanz, Amt fuer Stadtplanung und Umwelt
23.10.2023 19:00;664;323;341;Sonnig;9;9;0;Stadt Konstanz, Amt fuer Stadtplanung und Umwelt
23.10.2023 20:00;468;260;208;Sonnig;9;9;0;Stadt Konstanz, Amt fuer Stadtplanung und Umwelt
23.10.2023 21:00;295;144;151;Leicht bewoelkt;8;8;0;Stadt Konstanz, Amt fuer Stadtplanung und Umwelt
23.10.2023 22:00;223;108;115;Leicht bewoelkt;8;8;0;Stadt Konstanz, Amt fuer Stadtplanung und Umwelt
23.10.2023 23:00;111;42;69;Leicht bewoelkt;8;8;0;Stadt Konstanz, Amt fuer Stadtplanung und Umwelt
24.10.2023 00:00;61;18;43;Sonnig;7;7;0;Stadt Konstanz, Amt fuer Stadtplanung und Umwelt
24.10.2023 01:00;52;16;36;Sonnig;7;6;0;Stadt Konstanz, Amt fuer Stadtplanung und Umwelt
24.10.2023 02:00;23;15;8;Sonnig;6;6;0;Stadt Konstanz, Amt fuer Stadtplanung und Umwelt
24.10.2023 03:00;12;4;8;Leichter Nebel;6;6;0;Stadt Konstanz, Amt fuer Stadtplanung und Umwelt
24.10.2023 04:00;20;9;11;Leichter Nebel;6;6;0;Stadt Konstanz, Amt fuer Stadtplanung und Umwelt
24.10.2023 05:00;55;41;14;Bedeckt;6;6;0;Stadt Konstanz, Amt fuer Stadtplanung und Umwelt
24.10.2023 06:00;194;105;89;Bedeckt;7;7;0;Stadt Konstanz, Amt fuer Stadtplanung und Umwelt
24.10.2023 07:00;1076;730;346;Bedeckt;8;8;0;Stadt Konstanz, Amt fuer Stadtplanung und Umwelt
24.10.2023 08:00;844;495;349;Leicht bewoelkt;8;8;0;Stadt Konstanz, Amt fuer Stadtplanung und Umwelt
24.10.2023 09:00;829;510;319;Bewoelkt;10;10;0;Stadt Konstanz, Amt fuer Stadtplanung und Umwelt
24.10.2023 10:00;401;204;197;Bedeckt;12;10;0;Stadt Konstanz, Amt fuer Stadtplanung und Umwelt
24.10.2023 11:00;597;272;325;Nieselregen;12;10;0.3;Stadt Konstanz, Amt fuer Stadtplanung und Umwelt
24.10.2023 12:00;475;178;297;Leichter Regenfall;10;8;2.2;Stadt Konstanz, Amt fuer Stadtplanung und Umwelt
24.10.2023 13:00;720;285;435;Leichter Regenfall;10;8;1.2;Stadt Konstanz, Amt fuer Stadtplanung und Umwelt
24.10.2023 14:00;431;203;228;Stellenweiser Regenfall;10;8;0.1;Stadt Konstanz, Amt fuer Stadtplanung und Umwelt
24.10.2023 15:00;764;339;425;Stellenweiser Regenfall;11;9;0.1;Stadt Konstanz, Amt fuer Stadtplanung und Umwelt
24.10.2023 16:00;603;255;348;Leicht bewoelkt;10;9;0;Stadt Konstanz, Amt fuer Stadtplanung und Umwelt
24.10.2023 17:00;913;374;539;Leichter Nebel;9;8;0;Stadt Konstanz, Amt fuer Stadtplanung und Umwelt
24.10.2023 18:00;740;329;411;Leichter Nebel;7;7;0;Stadt Konstanz, Amt fuer Stadtplanung und Umwelt
24.10.2023 19:00;598;331;267;Leichter Nebel;7;7;0;Stadt Konstanz, Amt fuer Stadtplanung und Umwelt
24.10.2023 20:00;313;150;163;Leichter Nebel;6;6;0;Stadt Konstanz, Amt fuer Stadtplanung und Umwelt
24.10.2023 21:00;248;107;141;Leicht bewoelkt;6;6;0;Stadt Konstanz, Amt fuer Stadtplanung und Umwelt
24.10.2023 22:00;202;81;121;Leichter Nebel;5;5;0;Stadt Konstanz, Amt fuer Stadtplanung und Umwelt
24.10.2023 23:00;125;51;74;Leichter Nebel;5;5;0;Stadt Konstanz, Amt fuer Stadtplanung und Umwelt
25.10.2023 00:00;56;23;33;Nebel;9;9;0;Stadt Konstanz, Amt fuer Stadtplanung und Umwelt
25.10.2023 01:00;32;11;21;Nebel;9;9;0;Stadt Konstanz, Amt fuer Stadtplanung und Umwelt
25.10.2023 02:00;10;3;7;Nebel;9;9;0;Stadt Konstanz, Amt fuer Stadtplanung und Umwelt
25.10.2023 03:00;7;3;4;Nebel;9;9;0;Stadt Konstanz, Amt fuer Stadtplanung und Umwelt
25.10.2023 04:00;13;4;9;Nebel;9;9;0;Stadt Konstanz, Amt fuer Stadtplanung und Umwelt
25.10.2023 05:00;49;39;10;Bedeckt;7;7;0;Stadt Konstanz, Amt fuer Stadtplanung und Umwelt
25.10.2023 06:00;181;104;77;Bedeckt;7;7;0;Stadt Konstanz, Amt fuer Stadtplanung und Umwelt
25.10.2023 07:00;1086;711;375;Nebel;7;7;0;Stadt Konstanz, Amt fuer Stadtplanung und Umwelt
25.10.2023 08:00;782;447;335;Nebel;8;8;0;Stadt Konstanz, Amt fuer Stadtplanung und Umwelt
25.10.2023 09:00;807;484;323;Leicht bewoelkt;10;10;0;Stadt Konstanz, Amt fuer Stadtplanung und Umwelt
25.10.2023 10:00;413;231;182;Leicht bewoelkt;11;11;0;Stadt Konstanz, Amt fuer Stadtplanung und Umwelt
25.10.2023 11:00;661;297;364;Stellenweiser Regenfall;13;13;0;Stadt Konstanz, Amt fuer Stadtplanung und Umwelt
25.10.2023 12:00;730;321;409;Stellenweiser Regenfall;14;14;0;Stadt Konstanz, Amt fuer Stadtplanung und Umwelt
25.10.2023 13:00;1017;494;523;Stellenweiser Regenfall;14;14;0.1;Stadt Konstanz, Amt fuer Stadtplanung und Umwelt
25.10.2023 14:00;668;334;334;Stellenweiser Nieselregen;13;12;0.6;Stadt Konstanz, Amt fuer Stadtplanung und Umwelt
25.10.2023 15:00;889;357;532;Leichter Regenfall;11;11;2.4;Stadt Konstanz, Amt fuer Stadtplanung und Umwelt
25.10.2023 16:00;723;322;401;Maeßiger Regenfall;10;10;4.6;Stadt Konstanz, Amt fuer Stadtplanung und Umwelt
25.10.2023 17:00;977;429;548;Maeßiger Regenfall;10;9;3.1;Stadt Konstanz, Amt fuer Stadtplanung und Umwelt
25.10.2023 18:00;773;360;413;Maeßiger bis starker Regen mit Gewitter;10;9;2.4;Stadt Konstanz, Amt fuer Stadtplanung und Umwelt
25.10.2023 19:00;573;268;305;Leichter Regenfall;10;8;1.2;Stadt Konstanz, Amt fuer Stadtplanung und Umwelt
25.10.2023 20:00;452;202;250;Leichter Nebel;9;8;0.1;Stadt Konstanz, Amt fuer Stadtplanung und Umwelt
25.10.2023 21:00;297;131;166;Leichter Nebel;9;8;0;Stadt Konstanz, Amt fuer Stadtplanung und Umwelt
25.10.2023 22:00;227;104;123;Leichter Nebel;8;7;0;Stadt Konstanz, Amt fuer Stadtplanung und Umwelt
25.10.2023 23:00;148;64;84;Leicht bewoelkt;8;7;0;Stadt Konstanz, Amt fuer Stadtplanung und Umwelt
26.10.2023 00:00;65;17;48;Stellenweiser Regenfall;10;8;0.1;Stadt Konstanz, Amt fuer Stadtplanung und Umwelt
26.10.2023 01:00;57;5;52;Stellenweiser Regenfall;10;8;0.1;Stadt Konstanz, Amt fuer Stadtplanung und Umwelt
26.10.2023 02:00;23;4;19;Nieselregen;9;8;0.3;Stadt Konstanz, Amt fuer Stadtplanung und Umwelt
26.10.2023 03:00;7;4;3;Nieselregen;10;8;0.7;Stadt Konstanz, Amt fuer Stadtplanung und Umwelt
26.10.2023 04:00;12;6;6;Nieselregen;10;8;0.6;Stadt Konstanz, Amt fuer Stadtplanung und Umwelt
26.10.2023 05:00;45;33;12;Leichter Regenfall;9;8;2.1;Stadt Konstanz, Amt fuer Stadtplanung und Umwelt
26.10.2023 06:00;164;96;68;Leichter Regenfall;9;9;1.9;Stadt Konstanz, Amt fuer Stadtplanung und Umwelt
26.10.2023 07:00;944;618;326;Maeßiger Regenfall;9;9;2.8;Stadt Konstanz, Amt fuer Stadtplanung und Umwelt
26.10.2023 08:00;620;346;274;Leichter Regenfall;10;8;2.1;Stadt Konstanz, Amt fuer Stadtplanung und Umwelt
26.10.2023 09:00;525;298;227;Nieselregen;12;9;0.7;Stadt Konstanz, Amt fuer Stadtplanung und Umwelt
26.10.2023 10:00;292;142;150;Nieselregen;12;10;0.2;Stadt Konstanz, Amt fuer Stadtplanung und Umwelt
26.10.2023 11:00;527;276;251;Stellenweiser Regenfall;12;10;0;Stadt Konstanz, Amt fuer Stadtplanung und Umwelt
26.10.2023 12:00;502;215;287;Leicht bewoelkt;14;12;0;Stadt Konstanz, Amt fuer Stadtplanung und Umwelt
26.10.2023 13:00;748;318;430;Leicht bewoelkt;14;12;0;Stadt Konstanz, Amt fuer Stadtplanung und Umwelt
26.10.2023 14:00;573;274;299;Leicht bewoelkt;14;13;0;Stadt Konstanz, Amt fuer Stadtplanung und Umwelt
26.10.2023 15:00;922;394;528;Bedeckt;14;13;0;Stadt Konstanz, Amt fuer Stadtplanung und Umwelt
26.10.2023 16:00;781;399;382;Stellenweiser Regenfall;13;12;0;Stadt Konstanz, Amt fuer Stadtplanung und Umwelt
26.10.2023 17:00;1064;490;574;Nieselregen;12;10;0.3;Stadt Konstanz, Amt fuer Stadtplanung und Umwelt
26.10.2023 18:00;726;334;392;Nieselregen;11;11;0.5;Stadt Konstanz, Amt fuer Stadtplanung und Umwelt
26.10.2023 19:00;517;257;260;Stellenweiser leichter Regenfall;10;10;1.1;Stadt Konstanz, Amt fuer Stadtplanung und Umwelt
26.10.2023 20:00;348;161;187;Leichter Regenfall;10;9;1.9;Stadt Konstanz, Amt fuer Stadtplanung und Umwelt
26.10.2023 21:00;271;117;154;Leichter Regenfall;10;9;1.4;Stadt Konstanz, Amt fuer Stadtplanung und Umwelt
26.10.2023 22:00;243;99;144;Leichter Regenfall;10;9;1.7;Stadt Konstanz, Amt fuer Stadtplanung und Umwelt
26.10.2023 23:00;154;75;79;Leichter Regenfall;10;9;1;Stadt Konstanz, Amt fuer Stadtplanung und Umwelt
27.10.2023 00:00;85;33;52;Leichter Regenfall;9;9;1.6;Stadt Konstanz, Amt fuer Stadtplanung und Umwelt
27.10.2023 01:00;71;27;44;Leichter Regenfall;9;8;1.8;Stadt Konstanz, Amt fuer Stadtplanung und Umwelt
27.10.2023 02:00;16;9;7;Leichter Regenfall;8;8;0.8;Stadt Konstanz, Amt fuer Stadtplanung und Umwelt
27.10.2023 03:00;9;4;5;Nebel;9;8;0.1;Stadt Konstanz, Amt fuer Stadtplanung und Umwelt
27.10.2023 04:00;17;14;3;Nieselregen;9;8;0.3;Stadt Konstanz, Amt fuer Stadtplanung und Umwelt
27.10.2023 05:00;52;37;15;Stellenweiser Regenfall;9;7;0.1;Stadt Konstanz, Amt fuer Stadtplanung und Umwelt
27.10.2023 06:00;146;84;62;Stellenweiser Regenfall;9;7;0.1;Stadt Konstanz, Amt fuer Stadtplanung und Umwelt
27.10.2023 07:00;818;542;276;Stellenweiser Regenfall;10;7;0;Stadt Konstanz, Amt fuer Stadtplanung und Umwelt
27.10.2023 08:00;626;369;257;Bewoelkt;9;6;0;Stadt Konstanz, Amt fuer Stadtplanung und Umwelt
27.10.2023 09:00;669;382;287;Stellenweiser Regenfall;10;7;0;Stadt Konstanz, Amt fuer Stadtplanung und Umwelt
27.10.2023 10:00;496;270;226;Stellenweiser Regenfall;10;8;0;Stadt Konstanz, Amt fuer Stadtplanung und Umwelt
27.10.2023 11:00;648;301;347;Stellenweiser Regenfall;11;9;0;Stadt Konstanz, Amt fuer Stadtplanung und Umwelt
27.10.2023 12:00;765;377;388;Stellenweiser Regenfall;10;8;0;Stadt Konstanz, Amt fuer Stadtplanung und Umwelt
27.10.2023 13:00;977;380;597;Stellenweiser Regenfall;11;8;0;Stadt Konstanz, Amt fuer Stadtplanung und Umwelt
27.10.2023 14:00;721;369;352;Stellenweiser Regenfall;11;9;0.1;Stadt Konstanz, Amt fuer Stadtplanung und Umwelt
27.10.2023 15:00;744;309;435;Stellenweiser Regenfall;11;9;0.1;Stadt Konstanz, Amt fuer Stadtplanung und Umwelt
27.10.2023 16:00;730;346;384;Stellenweiser Regenfall;11;9;0;Stadt Konstanz, Amt fuer Stadtplanung und Umwelt
27.10.2023 17:00;695;311;384;Stellenweiser Regenfall;9;8;0.1;Stadt Konstanz, Amt fuer Stadtplanung und Umwelt
27.10.2023 18:00;687;319;368;Stellenweiser Regenfall;7;6;0;Stadt Konstanz, Amt fuer Stadtplanung und Umwelt
27.10.2023 19:00;546;278;268;Leichter Nebel;7;6;0;Stadt Konstanz, Amt fuer Stadtplanung und Umwelt
27.10.2023 20:00;371;209;162;Stellenweiser Regenfall;8;7;0;Stadt Konstanz, Amt fuer Stadtplanung und Umwelt
27.10.2023 21:00;275;119;156;Stellenweiser Regenfall;8;7;0.1;Stadt Konstanz, Amt fuer Stadtplanung und Umwelt
27.10.2023 22:00;214;83;131;Leichter Regenfall;8;5;1.3;Stadt Konstanz, Amt fuer Stadtplanung und Umwelt
27.10.2023 23:00;242;90;152;Nieselregen;9;5;0.5;Stadt Konstanz, Amt fuer Stadtplanung und Umwelt
28.10.2023 00:00;129;44;85;Leichter Regenfall;7;4;2.1;Stadt Konstanz, Amt fuer Stadtplanung und Umwelt
28.10.2023 01:00;121;38;83;Stellenweiser Regenfall;8;5;0;Stadt Konstanz, Amt fuer Stadtplanung und Umwelt
28.10.2023 02:00;61;17;44;Stellenweiser Regenfall;8;5;0;Stadt Konstanz, Amt fuer Stadtplanung und Umwelt
28.10.2023 03:00;68;20;48;Leicht bewoelkt;7;5;0;Stadt Konstanz, Amt fuer Stadtplanung und Umwelt
28.10.2023 04:00;23;10;13;Leichter Nebel;6;4;0;Stadt Konstanz, Amt fuer Stadtplanung und Umwelt
28.10.2023 05:00;52;30;22;Leichter Nebel;5;5;0;Stadt Konstanz, Amt fuer Stadtplanung und Umwelt
28.10.2023 06:00;46;24;22;Leichter Nebel;5;5;0;Stadt Konstanz, Amt fuer Stadtplanung und Umwelt
28.10.2023 07:00;63;38;25;Leichter Nebel;5;5;0;Stadt Konstanz, Amt fuer Stadtplanung und Umwelt
28.10.2023 08:00;192;112;80;Leichter Nebel;6;5;0;Stadt Konstanz, Amt fuer Stadtplanung und Umwelt
28.10.2023 09:00;332;190;142;Leicht bewoelkt;8;6;0;Stadt Konstanz, Amt fuer Stadtplanung und Umwelt
28.10.2023 10:00;424;228;196;Leicht bewoelkt;10;8;0;Stadt Konstanz, Amt fuer Stadtplanung und Umwelt
28.10.2023 11:00;503;282;221;Sonnig;11;9;0;Stadt Konstanz, Amt fuer Stadtplanung und Umwelt
28.10.2023 12:00;602;313;289;Sonnig;12;11;0;Stadt Konstanz, Amt fuer Stadtplanung und Umwelt
28.10.2023 13:00;634;342;292;Leicht bewoelkt;13;12;0;Stadt Konstanz, Amt fuer Stadtplanung und Umwelt
28.10.2023 14:00;628;317;311;Leicht bewoelkt;14;13;0;Stadt Konstanz, Amt fuer Stadtplanung und Umwelt
28.10.2023 15:00;668;313;355;Stellenweiser Regenfall;14;13;0;Stadt Konstanz, Amt fuer Stadtplanung und Umwelt
28.10.2023 16:00;659;291;368;Stellenweiser Regenfall;13;11;0.1;Stadt Konstanz, Amt fuer Stadtplanung und Umwelt
28.10.2023 17:00;610;264;346;Stellenweiser Nieselregen;10;7;0.2;Stadt Konstanz, Amt fuer Stadtplanung und Umwelt
28.10.2023 18:00;526;245;281;Leicht bewoelkt;9;9;0;Stadt Konstanz, Amt fuer Stadtplanung und Umwelt
28.10.2023 19:00;449;260;189;Sonnig;8;8;0;Stadt Konstanz, Amt fuer Stadtplanung und Umwelt
28.10.2023 20:00;344;178;166;Sonnig;7;7;0;Stadt Konstanz, Amt fuer Stadtplanung und Umwelt
28.10.2023 21:00;304;166;138;Sonnig;6;6;0;Stadt Konstanz, Amt fuer Stadtplanung und Umwelt
28.10.2023 22:00;208;93;115;Sonnig;5;5;0;Stadt Konstanz, Amt fuer Stadtplanung und Umwelt
28.10.2023 23:00;191;50;141;Sonnig;5;5;0;Stadt Konstanz, Amt fuer Stadtplanung und Umwelt
29.10.2023 00:00;176;47;129;Sonnig;5;5;0;Stadt Konstanz, Amt fuer Stadtplanung und Umwelt
29.10.2023 01:00;138;31;107;Sonnig;5;5;0;Stadt Konstanz, Amt fuer Stadtplanung und Umwelt
29.10.2023 02:00;227;51;176;Leicht bewoelkt;5;5;0;Stadt Konstanz, Amt fuer Stadtplanung und Umwelt
29.10.2023 03:00;48;16;32;Leicht bewoelkt;5;5;0;Stadt Konstanz, Amt fuer Stadtplanung und Umwelt
29.10.2023 04:00;16;11;5;Sonnig;5;5;0;Stadt Konstanz, Amt fuer Stadtplanung und Umwelt
29.10.2023 05:00;39;28;11;Sonnig;4;4;0;Stadt Konstanz, Amt fuer Stadtplanung und Umwelt
29.10.2023 06:00;26;18;8;Leicht bewoelkt;4;4;0;Stadt Konstanz, Amt fuer Stadtplanung und Umwelt
29.10.2023 07:00;43;24;19;Leicht bewoelkt;4;3;0;Stadt Konstanz, Amt fuer Stadtplanung und Umwelt
29.10.2023 08:00;115;68;47;Leicht bewoelkt;5;5;0;Stadt Konstanz, Amt fuer Stadtplanung und Umwelt
29.10.2023 09:00;234;128;106;Sonnig;8;7;0;Stadt Konstanz, Amt fuer Stadtplanung und Umwelt
29.10.2023 10:00;291;158;133;Leicht bewoelkt;10;11;0;Stadt Konstanz, Amt fuer Stadtplanung und Umwelt
29.10.2023 11:00;304;159;145;Sonnig;12;12;0;Stadt Konstanz, Amt fuer Stadtplanung und Umwelt
29.10.2023 12:00;372;166;206;Sonnig;14;14;0;Stadt Konstanz, Amt fuer Stadtplanung und Umwelt
29.10.2023 13:00;393;191;202;Leicht bewoelkt;15;15;0;Stadt Konstanz, Amt fuer Stadtplanung und Umwelt
29.10.2023 14:00;453;213;240;Sonnig;15;15;0;Stadt Konstanz, Amt fuer Stadtplanung und Umwelt
29.10.2023 15:00;464;259;205;Sonnig;15;15;0;Stadt Konstanz, Amt fuer Stadtplanung und Umwelt
29.10.2023 16:00;454;213;241;Sonnig;12;12;0;Stadt Konstanz, Amt fuer Stadtplanung und Umwelt
29.10.2023 17:00;523;264;259;Sonnig;9;9;0;Stadt Konstanz, Amt fuer Stadtplanung und Umwelt
29.10.2023 18:00;294;141;153;Sonnig;8;8;0;Stadt Konstanz, Amt fuer Stadtplanung und Umwelt
29.10.2023 19:00;242;131;111;Sonnig;8;8;0;Stadt Konstanz, Amt fuer Stadtplanung und Umwelt
29.10.2023 20:00;176;76;100;Sonnig;8;8;0;Stadt Konstanz, Amt fuer Stadtplanung und Umwelt
29.10.2023 21:00;165;66;99;Sonnig;7;7;0;Stadt Konstanz, Amt fuer Stadtplanung und Umwelt
29.10.2023 22:00;123;43;80;Sonnig;7;7;0;Stadt Konstanz, Amt fuer Stadtplanung und Umwelt
29.10.2023 23:00;88;47;41;Sonnig;7;7;0;Stadt Konstanz, Amt fuer Stadtplanung und Umwelt
30.10.2023 00:00;39;17;22;Sonnig;6;6;0;Stadt Konstanz, Amt fuer Stadtplanung und Umwelt
30.10.2023 01:00;16;6;10;Sonnig;6;6;0;Stadt Konstanz, Amt fuer Stadtplanung und Umwelt
30.10.2023 02:00;8;3;5;Sonnig;6;6;0;Stadt Konstanz, Amt fuer Stadtplanung und Umwelt
30.10.2023 03:00;5;0;5;Leicht bewoelkt;6;6;0;Stadt Konstanz, Amt fuer Stadtplanung und Umwelt
30.10.2023 04:00;24;20;4;Sonnig;6;6;0;Stadt Konstanz, Amt fuer Stadtplanung und Umwelt
30.10.2023 05:00;57;43;14;Sonnig;6;6;0;Stadt Konstanz, Amt fuer Stadtplanung und Umwelt
30.10.2023 06:00;189;107;82;Leicht bewoelkt;5;5;0;Stadt Konstanz, Amt fuer Stadtplanung und Umwelt
30.10.2023 07:00;484;297;187;Leicht bewoelkt;5;5;0;Stadt Konstanz, Amt fuer Stadtplanung und Umwelt
30.10.2023 08:00;622;362;260;Leicht bewoelkt;6;6;0;Stadt Konstanz, Amt fuer Stadtplanung und Umwelt
30.10.2023 09:00;658;404;254;Bewoelkt;9;9;0;Stadt Konstanz, Amt fuer Stadtplanung und Umwelt
30.10.2023 10:00;453;249;204;Bedeckt;11;11;0;Stadt Konstanz, Amt fuer Stadtplanung und Umwelt
30.10.2023 11:00;582;289;293;Leicht bewoelkt;12;12;0;Stadt Konstanz, Amt fuer Stadtplanung und Umwelt
30.10.2023 12:00;600;305;295;Leicht bewoelkt;14;14;0;Stadt Konstanz, Amt fuer Stadtplanung und Umwelt
30.10.2023 13:00;649;314;335;Bedeckt;15;15;0;Stadt Konstanz, Amt fuer Stadtplanung und Umwelt
30.10.2023 14:00;576;294;282;Bedeckt;15;15;0;Stadt Konstanz, Amt fuer Stadtplanung und Umwelt
30.10.2023 15:00;689;324;365;Bewoelkt;15;15;0;Stadt Konstanz, Amt fuer Stadtplanung und Umwelt
30.10.2023 16:00;790;367;423;Leicht bewoelkt;13;14;0;Stadt Konstanz, Amt fuer Stadtplanung und Umwelt
30.10.2023 17:00;887;411;476;Stellenweiser Regenfall;11;11;0.1;Stadt Konstanz, Amt fuer Stadtplanung und Umwelt
30.10.2023 18:00;636;268;368;Leichter Regenfall;10;10;1.5;Stadt Konstanz, Amt fuer Stadtplanung und Umwelt
30.10.2023 19:00;420;184;236;Leichter Regenfall;10;10;2.1;Stadt Konstanz, Amt fuer Stadtplanung und Umwelt
30.10.2023 20:00;263;133;130;Maeßiger Regenfall;10;9;3.3;Stadt Konstanz, Amt fuer Stadtplanung und Umwelt
30.10.2023 21:00;160;74;86;Leichter Regenfall;10;10;1.9;Stadt Konstanz, Amt fuer Stadtplanung und Umwelt
30.10.2023 22:00;124;37;87;Maeßiger Regenfall;10;10;2.9;Stadt Konstanz, Amt fuer Stadtplanung und Umwelt
30.10.2023 23:00;72;37;35;Leichter Regenfall;10;9;0.9;Stadt Konstanz, Amt fuer Stadtplanung und Umwelt
31.10.2023 00:00;34;17;17;Maeßiger Regenfall;10;9;3.1;Stadt Konstanz, Amt fuer Stadtplanung und Umwelt
31.10.2023 01:00;21;10;11;Stellenweiser leichter Regenfall;9;6;0.8;Stadt Konstanz, Amt fuer Stadtplanung und Umwelt
31.10.2023 02:00;12;7;5;Leichter Regenfall;9;6;0.8;Stadt Konstanz, Amt fuer Stadtplanung und Umwelt
31.10.2023 03:00;5;2;3;Nieselregen;8;6;0.2;Stadt Konstanz, Amt fuer Stadtplanung und Umwelt
31.10.2023 04:00;13;6;7;Leichter Regenschauer;8;5;0.2;Stadt Konstanz, Amt fuer Stadtplanung und Umwelt
31.10.2023 05:00;45;34;11;Stellenweiser Regenfall;8;5;0.1;Stadt Konstanz, Amt fuer Stadtplanung und Umwelt
31.10.2023 06:00;172;103;69;Stellenweiser Regenfall;8;5;0;Stadt Konstanz, Amt fuer Stadtplanung und Umwelt
31.10.2023 07:00;505;315;190;Stellenweiser Regenfall;8;5;0;Stadt Konstanz, Amt fuer Stadtplanung und Umwelt
31.10.2023 08:00;640;364;276;Stellenweiser Regenfall;8;5;0;Stadt Konstanz, Amt fuer Stadtplanung und Umwelt
31.10.2023 09:00;650;436;214;Stellenweiser Regenfall;8;5;0.1;Stadt Konstanz, Amt fuer Stadtplanung und Umwelt
31.10.2023 10:00;468;270;198;Stellenweiser Regenfall;8;5;0.1;Stadt Konstanz, Amt fuer Stadtplanung und Umwelt
31.10.2023 11:00;571;279;292;Stellenweiser Regenfall;9;6;0;Stadt Konstanz, Amt fuer Stadtplanung und Umwelt
31.10.2023 12:00;618;267;351;Stellenweiser Regenfall;9;6;0.1;Stadt Konstanz, Amt fuer Stadtplanung und Umwelt
31.10.2023 13:00;605;288;317;Stellenweiser Regenfall;9;7;0;Stadt Konstanz, Amt fuer Stadtplanung und Umwelt
31.10.2023 14:00;521;268;253;Stellenweiser Regenfall;10;8;0.1;Stadt Konstanz, Amt fuer Stadtplanung und Umwelt
31.10.2023 15:00;633;306;327;Stellenweiser Regenfall;10;8;0.1;Stadt Konstanz, Amt fuer Stadtplanung und Umwelt
31.10.2023 16:00;696;318;378;Stellenweiser Regenfall;9;7;0;Stadt Konstanz, Amt fuer Stadtplanung und Umwelt
31.10.2023 17:00;794;359;435;Stellenweiser Regenfall;9;6;0;Stadt Konstanz, Amt fuer Stadtplanung und Umwelt
31.10.2023 18:00;645;296;349;Leichter Regenschauer;9;6;0.3;Stadt Konstanz, Amt fuer Stadtplanung und Umwelt
31.10.2023 19:00;533;263;270;Stellenweiser Regenfall;9;6;0;Stadt Konstanz, Amt fuer Stadtplanung und Umwelt
31.10.2023 20:00;482;255;227;Stellenweiser Regenfall;9;7;0;Stadt Konstanz, Amt fuer Stadtplanung und Umwelt
31.10.2023 21:00;390;209;181;Bewoelkt;8;6;0;Stadt Konstanz, Amt fuer Stadtplanung und Umwelt
31.10.2023 22:00;264;121;143;Sonnig;7;6;0;Stadt Konstanz, Amt fuer Stadtplanung und Umwelt
31.10.2023 23:00;231;93;138;Sonnig;7;6;0;Stadt Konstanz, Amt fuer Stadtplanung und Umwelt
01.11.2023 00:00;198;96;102;Leichter Nebel;6;6;0;Stadt Konstanz, Amt fuer Stadtplanung und Umwelt
01.11.2023 01:00;198;77;121;Leichter Nebel;5;5;0;Stadt Konstanz, Amt fuer Stadtplanung und Umwelt
01.11.2023 02:00;183;86;97;Leichter Nebel;5;5;0;Stadt Konstanz, Amt fuer Stadtplanung und Umwelt
01.11.2023 03:00;131;57;74;Leichter Nebel;4;4;0;Stadt Konstanz, Amt fuer Stadtplanung und Umwelt
01.11.2023 04:00;76;36;40;Leichter Nebel;4;4;0;Stadt Konstanz, Amt fuer Stadtplanung und Umwelt
01.11.2023 05:00;64;39;25;Leichter Nebel;3;3;0;Stadt Konstanz, Amt fuer Stadtplanung und Umwelt
01.11.2023 06:00;63;42;21;Leichter Nebel;3;3;0;Stadt Konstanz, Amt fuer Stadtplanung und Umwelt
01.11.2023 07:00;101;79;22;Leichter Nebel;3;3;0;Stadt Konstanz, Amt fuer Stadtplanung und Umwelt
01.11.2023 08:00;132;75;57;Leichter Nebel;4;4;0;Stadt Konstanz, Amt fuer Stadtplanung und Umwelt
01.11.2023 09:00;212;122;90;Sonnig;6;6;0;Stadt Konstanz, Amt fuer Stadtplanung und Umwelt
01.11.2023 10:00;259;128;131;Sonnig;8;8;0;Stadt Konstanz, Amt fuer Stadtplanung und Umwelt
01.11.2023 11:00;328;175;153;Bewoelkt;9;9;0;Stadt Konstanz, Amt fuer Stadtplanung und Umwelt
01.11.2023 12:00;353;171;182;Bewoelkt;10;10;0;Stadt Konstanz, Amt fuer Stadtplanung und Umwelt
01.11.2023 13:00;355;178;177;Bedeckt;10;11;0;Stadt Konstanz, Amt fuer Stadtplanung und Umwelt
01.11.2023 14:00;383;204;179;Bedeckt;11;11;0;Stadt Konstanz, Amt fuer Stadtplanung und Umwelt
01.11.2023 15:00;430;224;206;Bedeckt;10;10;0;Stadt Konstanz, Amt fuer Stadtplanung und Umwelt
01.11.2023 16:00;451;210;241;Bedeckt;9;9;0;Stadt Konstanz, Amt fuer Stadtplanung und Umwelt
01.11.2023 17:00;398;195;203;Bewoelkt;7;7;0;Stadt Konstanz, Amt fuer Stadtplanung und Umwelt
01.11.2023 18:00;377;182;195;Leicht bewoelkt;6;6;0;Stadt Konstanz, Amt fuer Stadtplanung und Umwelt
01.11.2023 19:00;260;142;118;Leicht bewoelkt;6;6;0;Stadt Konstanz, Amt fuer Stadtplanung und Umwelt
01.11.2023 20:00;223;99;124;Sonnig;6;5;0;Stadt Konstanz, Amt fuer Stadtplanung und Umwelt
01.11.2023 21:00;171;78;93;Sonnig;5;4;0;Stadt Konstanz, Amt fuer Stadtplanung und Umwelt
01.11.2023 22:00;135;38;97;Leicht bewoelkt;4;4;0;Stadt Konstanz, Amt fuer Stadtplanung und Umwelt
01.11.2023 23:00;103;39;64;Leicht bewoelkt;5;5;0;Stadt Konstanz, Amt fuer Stadtplanung und Umwelt
02.11.2023 00:00;46;18;28;Leichter Nebel;5;4;0;Stadt Konstanz, Amt fuer Stadtplanung und Umwelt
02.11.2023 01:00;15;7;8;Leichter Nebel;4;4;0;Stadt Konstanz, Amt fuer Stadtplanung und Umwelt
02.11.2023 02:00;4;2;2;Leichter Nebel;4;4;0;Stadt Konstanz, Amt fuer Stadtplanung und Umwelt
02.11.2023 03:00;5;1;4;Leichter Nebel;3;4;0;Stadt Konstanz, Amt fuer Stadtplanung und Umwelt
02.11.2023 04:00;18;10;8;Leichter Nebel;3;3;0;Stadt Konstanz, Amt fuer Stadtplanung und Umwelt
02.11.2023 05:00;44;35;9;Leichter Nebel;3;2;0;Stadt Konstanz, Amt fuer Stadtplanung und Umwelt
02.11.2023 06:00;175;102;73;Leichter Nebel;3;3;0;Stadt Konstanz, Amt fuer Stadtplanung und Umwelt
02.11.2023 07:00;447;250;197;Stellenweiser Regenfall;5;4;0;Stadt Konstanz, Amt fuer Stadtplanung und Umwelt
02.11.2023 08:00;554;305;249;Stellenweiser leichter Regenfall;6;6;1.7;Stadt Konstanz, Amt fuer Stadtplanung und Umwelt
02.11.2023 09:00;544;315;229;Maeßiger Regenfall;6;6;2.9;Stadt Konstanz, Amt fuer Stadtplanung und Umwelt
02.11.2023 10:00;359;189;170;Leichter Regenfall;6;6;1.4;Stadt Konstanz, Amt fuer Stadtplanung und Umwelt
02.11.2023 11:00;399;209;190;Nieselregen;6;6;0.6;Stadt Konstanz, Amt fuer Stadtplanung und Umwelt
02.11.2023 12:00;350;161;189;Leichter Regenfall;6;6;1.4;Stadt Konstanz, Amt fuer Stadtplanung und Umwelt
02.11.2023 13:00;388;172;216;Leichter Regenfall;7;7;2.3;Stadt Konstanz, Amt fuer Stadtplanung und Umwelt
02.11.2023 14:00;341;152;189;Leichter Regenfall;8;6;2.1;Stadt Konstanz, Amt fuer Stadtplanung und Umwelt
02.11.2023 15:00;366;181;185;Nebel;7;6;0;Stadt Konstanz, Amt fuer Stadtplanung und Umwelt
02.11.2023 16:00;431;189;242;Nieselregen;7;7;0.2;Stadt Konstanz, Amt fuer Stadtplanung und Umwelt
02.11.2023 17:00;661;298;363;Nebel;7;6;0;Stadt Konstanz, Amt fuer Stadtplanung und Umwelt
02.11.2023 18:00;525;235;290;Nebel;7;5;0;Stadt Konstanz, Amt fuer Stadtplanung und Umwelt
02.11.2023 19:00;405;207;198;Nebel;6;5;0;Stadt Konstanz, Amt fuer Stadtplanung und Umwelt
02.11.2023 20:00;252;129;123;Nebel;6;6;0;Stadt Konstanz, Amt fuer Stadtplanung und Umwelt
02.11.2023 21:00;164;71;93;Leichter Nebel;6;6;0;Stadt Konstanz, Amt fuer Stadtplanung und Umwelt
02.11.2023 22:00;202;89;113;Nieselregen;6;6;0.2;Stadt Konstanz, Amt fuer Stadtplanung und Umwelt
02.11.2023 23:00;91;35;56;Leichter Regenfall;6;6;0.8;Stadt Konstanz, Amt fuer Stadtplanung und Umwelt
03.11.2023 00:00;51;14;37;Leichter Nebel;6;6;0.1;Stadt Konstanz, Amt fuer Stadtplanung und Umwelt
03.11.2023 01:00;34;6;28;Leichter Nebel;6;5;0;Stadt Konstanz, Amt fuer Stadtplanung und Umwelt
03.11.2023 02:00;23;10;13;Stellenweiser Regenfall;6;4;0.1;Stadt Konstanz, Amt fuer Stadtplanung und Umwelt
03.11.2023 03:00;8;1;7;Stellenweiser Regenfall;5;3;0;Stadt Konstanz, Amt fuer Stadtplanung und Umwelt
03.11.2023 04:00;18;11;7;Leicht bewoelkt;4;2;0;Stadt Konstanz, Amt fuer Stadtplanung und Umwelt
03.11.2023 05:00;42;31;11;Leichter Nebel;4;2;0;Stadt Konstanz, Amt fuer Stadtplanung und Umwelt
03.11.2023 06:00;123;68;55;Leichter Nebel;4;3;0;Stadt Konstanz, Amt fuer Stadtplanung und Umwelt
03.11.2023 07:00;381;226;155;Leichter Nebel;4;2;0;Stadt Konstanz, Amt fuer Stadtplanung und Umwelt
03.11.2023 08:00;545;310;235;Leicht bewoelkt;5;2;0;Stadt Konstanz, Amt fuer Stadtplanung und Umwelt
03.11.2023 09:00;515;311;204;Leicht bewoelkt;5;2;0;Stadt Konstanz, Amt fuer Stadtplanung und Umwelt
03.11.2023 10:00;466;278;188;Stellenweiser Regenfall;6;3;0;Stadt Konstanz, Amt fuer Stadtplanung und Umwelt
03.11.2023 11:00;556;316;240;Stellenweiser Regenfall;7;4;0;Stadt Konstanz, Amt fuer Stadtplanung und Umwelt
03.11.2023 12:00;540;267;273;Stellenweiser Regenfall;7;5;0;Stadt Konstanz, Amt fuer Stadtplanung und Umwelt
03.11.2023 13:00;696;351;345;Stellenweiser Regenfall;8;6;0;Stadt Konstanz, Amt fuer Stadtplanung und Umwelt
03.11.2023 14:00;749;379;370;Stellenweiser Regenfall;8;6;0;Stadt Konstanz, Amt fuer Stadtplanung und Umwelt
03.11.2023 15:00;690;367;323;Stellenweiser Regenfall;8;6;0;Stadt Konstanz, Amt fuer Stadtplanung und Umwelt
03.11.2023 16:00;680;333;347;Stellenweiser Regenfall;7;6;0;Stadt Konstanz, Amt fuer Stadtplanung und Umwelt
03.11.2023 17:00;730;330;400;Leicht bewoelkt;5;3;0;Stadt Konstanz, Amt fuer Stadtplanung und Umwelt
03.11.2023 18:00;527;227;300;Leicht bewoelkt;3;2;0;Stadt Konstanz, Amt fuer Stadtplanung und Umwelt
03.11.2023 19:00;402;200;202;Bewoelkt;3;1;0;Stadt Konstanz, Amt fuer Stadtplanung und Umwelt
03.11.2023 20:00;348;176;172;Bewoelkt;3;1;0;Stadt Konstanz, Amt fuer Stadtplanung und Umwelt
03.11.2023 21:00;250;109;141;Bewoelkt;4;1;0;Stadt Konstanz, Amt fuer Stadtplanung und Umwelt
03.11.2023 22:00;215;75;140;Stellenweiser Regenfall;4;1;0;Stadt Konstanz, Amt fuer Stadtplanung und Umwelt
03.11.2023 23:00;209;72;137;Leicht bewoelkt;3;0;0;Stadt Konstanz, Amt fuer Stadtplanung und Umwelt
04.11.2023 00:00;143;48;95;Leichter Nebel;1;1;0;Stadt Konstanz, Amt fuer Stadtplanung und Umwelt
04.11.2023 01:00;88;32;56;Leichter Nebel;0;0;0;Stadt Konstanz, Amt fuer Stadtplanung und Umwelt
04.11.2023 02:00;76;34;42;Leichter Nebel;0;-1;0;Stadt Konstanz, Amt fuer Stadtplanung und Umwelt
04.11.2023 03:00;28;12;16;Nebel;1;-1;0;Stadt Konstanz, Amt fuer Stadtplanung und Umwelt
04.11.2023 04:00;31;17;14;Leichter Nebel;2;0;0;Stadt Konstanz, Amt fuer Stadtplanung und Umwelt
04.11.2023 05:00;40;28;12;Leichter Nebel;2;0;0;Stadt Konstanz, Amt fuer Stadtplanung und Umwelt
04.11.2023 06:00;58;31;27;Leichter Nebel;1;0;0;Stadt Konstanz, Amt fuer Stadtplanung und Umwelt
04.11.2023 07:00;105;54;51;Nebel;1;0;0;Stadt Konstanz, Amt fuer Stadtplanung und Umwelt
04.11.2023 08:00;245;139;106;Leichter Nebel;2;0;0;Stadt Konstanz, Amt fuer Stadtplanung und Umwelt
04.11.2023 09:00;412;236;176;Sonnig;4;3;0;Stadt Konstanz, Amt fuer Stadtplanung und Umwelt
04.11.2023 10:00;519;310;209;Sonnig;6;5;0;Stadt Konstanz, Amt fuer Stadtplanung und Umwelt
04.11.2023 11:00;596;313;283;Sonnig;7;6;0;Stadt Konstanz, Amt fuer Stadtplanung und Umwelt
04.11.2023 12:00;551;286;265;Leicht bewoelkt;9;8;0;Stadt Konstanz, Amt fuer Stadtplanung und Umwelt
04.11.2023 13:00;477;233;244;Bedeckt;9;9;0;Stadt Konstanz, Amt fuer Stadtplanung und Umwelt
04.11.2023 14:00;492;227;265;Stellenweiser Regenfall;8;7;0.1;Stadt Konstanz, Amt fuer Stadtplanung und Umwelt
04.11.2023 15:00;303;136;167;Leichter Regenfall;6;4;1;Stadt Konstanz, Amt fuer Stadtplanung und Umwelt
04.11.2023 16:00;304;132;172;Stellenweiser Regenfall;5;3;0.1;Stadt Konstanz, Amt fuer Stadtplanung und Umwelt
04.11.2023 17:00;295;111;184;Bedeckt;4;4;0;Stadt Konstanz, Amt fuer Stadtplanung und Umwelt
04.11.2023 18:00;262;87;175;Leichter Regenfall;4;4;1.1;Stadt Konstanz, Amt fuer Stadtplanung und Umwelt
04.11.2023 19:00;231;94;137;Nieselregen;4;3;0.3;Stadt Konstanz, Amt fuer Stadtplanung und Umwelt
04.11.2023 20:00;160;90;70;Nieselregen;4;4;0.2;Stadt Konstanz, Amt fuer Stadtplanung und Umwelt
04.11.2023 21:00;125;67;58;Leichter Regenfall;4;3;1.5;Stadt Konstanz, Amt fuer Stadtplanung und Umwelt
04.11.2023 22:00;167;97;70;Leichter Regenfall;5;3;2.3;Stadt Konstanz, Amt fuer Stadtplanung und Umwelt
04.11.2023 23:00;108;45;63;Leichter Regenfall;5;3;2;Stadt Konstanz, Amt fuer Stadtplanung und Umwelt
05.11.2023 00:00;115;40;75;Stellenweiser Regenfall;6;3;0.1;Stadt Konstanz, Amt fuer Stadtplanung und Umwelt
05.11.2023 01:00;66;21;45;Stellenweiser Regenfall;6;4;0.1;Stadt Konstanz, Amt fuer Stadtplanung und Umwelt
05.11.2023 02:00;49;14;35;Leichter Nebel;5;4;0;Stadt Konstanz, Amt fuer Stadtplanung und Umwelt
05.11.2023 03:00;34;12;22;Leicht bewoelkt;5;5;0;Stadt Konstanz, Amt fuer Stadtplanung und Umwelt
05.11.2023 04:00;23;8;15;Leichter Nebel;3;2;0;Stadt Konstanz, Amt fuer Stadtplanung und Umwelt
05.11.2023 05:00;11;6;5;Leichter Nebel;2;2;0;Stadt Konstanz, Amt fuer Stadtplanung und Umwelt
05.11.2023 06:00;25;12;13;Stellenweiser Regenfall;3;1;0;Stadt Konstanz, Amt fuer Stadtplanung und Umwelt
05.11.2023 07:00;43;18;25;Stellenweiser Regenfall;6;3;0.1;Stadt Konstanz, Amt fuer Stadtplanung und Umwelt
05.11.2023 08:00;76;41;35;Nieselregen;7;4;0.4;Stadt Konstanz, Amt fuer Stadtplanung und Umwelt
05.11.2023 09:00;100;51;49;Nieselregen;8;4;0.3;Stadt Konstanz, Amt fuer Stadtplanung und Umwelt
05.11.2023 10:00;82;46;36;Leichter Regenfall;8;4;1.8;Stadt Konstanz, Amt fuer Stadtplanung und Umwelt
05.11.2023 11:00;130;50;80;Nieselregen;9;4;0.3;Stadt Konstanz, Amt fuer Stadtplanung und Umwelt
05.11.2023 12:00;168;91;77;Leichter Regenfall;8;4;1.8;Stadt Konstanz, Amt fuer Stadtplanung und Umwelt
05.11.2023 13:00;203;100;103;Stellenweiser Regenfall;8;4;0.1;Stadt Konstanz, Amt fuer Stadtplanung und Umwelt
05.11.2023 14:00;193;106;87;Stellenweiser Regenfall;9;5;0.1;Stadt Konstanz, Amt fuer Stadtplanung und Umwelt
05.11.2023 15:00;225;127;98;Nieselregen;8;5;0.3;Stadt Konstanz, Amt fuer Stadtplanung und Umwelt
05.11.2023 16:00;218;96;122;Leichter Regenfall;8;4;1;Stadt Konstanz, Amt fuer Stadtplanung und Umwelt
05.11.2023 17:00;287;134;153;Leichter Regenfall;8;4;1.3;Stadt Konstanz, Amt fuer Stadtplanung und Umwelt
05.11.2023 18:00;175;96;79;Leichter Regenschauer;8;4;0.2;Stadt Konstanz, Amt fuer Stadtplanung und Umwelt
05.11.2023 19:00;173;87;86;Stellenweiser Regenfall;8;4;0.1;Stadt Konstanz, Amt fuer Stadtplanung und Umwelt
05.11.2023 20:00;119;71;48;Stellenweiser Regenfall;8;4;0;Stadt Konstanz, Amt fuer Stadtplanung und Umwelt
05.11.2023 21:00;87;49;38;Sonnig;7;3;0;Stadt Konstanz, Amt fuer Stadtplanung und Umwelt
05.11.2023 22:00;70;35;35;Leicht bewoelkt;7;3;0;Stadt Konstanz, Amt fuer Stadtplanung und Umwelt
05.11.2023 23:00;72;39;33;Leicht bewoelkt;7;3;0;Stadt Konstanz, Amt fuer Stadtplanung und Umwelt
06.11.2023 00:00;23;5;18;Leicht bewoelkt;7;4;0;Stadt Konstanz, Amt fuer Stadtplanung und Umwelt
06.11.2023 01:00;10;5;5;Sonnig;7;4;0;Stadt Konstanz, Amt fuer Stadtplanung und Umwelt
06.11.2023 02:00;3;2;1;Bedeckt;7;4;0;Stadt Konstanz, Amt fuer Stadtplanung und Umwelt
06.11.2023 03:00;3;1;2;Stellenweiser Regenfall;7;4;0.1;Stadt Konstanz, Amt fuer Stadtplanung und Umwelt
06.11.2023 04:00;10;5;5;Stellenweiser Regenfall;8;4;0;Stadt Konstanz, Amt fuer Stadtplanung und Umwelt
06.11.2023 05:00;55;41;14;Nieselregen;8;5;0.2;Stadt Konstanz, Amt fuer Stadtplanung und Umwelt
06.11.2023 06:00;200;104;96;Stellenweiser Regenfall;7;5;0;Stadt Konstanz, Amt fuer Stadtplanung und Umwelt
06.11.2023 07:00;1239;774;465;Stellenweiser Regenfall;7;5;0;Stadt Konstanz, Amt fuer Stadtplanung und Umwelt
06.11.2023 08:00;996;500;496;Leichter Nebel;6;5;0;Stadt Konstanz, Amt fuer Stadtplanung und Umwelt
06.11.2023 09:00;838;515;323;Leicht bewoelkt;8;6;0;Stadt Konstanz, Amt fuer Stadtplanung und Umwelt
06.11.2023 10:00;468;249;219;Leicht bewoelkt;9;8;0;Stadt Konstanz, Amt fuer Stadtplanung und Umwelt
06.11.2023 11:00;716;350;366;Leicht bewoelkt;10;9;0;Stadt Konstanz, Amt fuer Stadtplanung und Umwelt
06.11.2023 12:00;765;396;369;Bewoelkt;11;9;0;Stadt Konstanz, Amt fuer Stadtplanung und Umwelt
06.11.2023 13:00;1104;502;602;Bewoelkt;11;9;0;Stadt Konstanz, Amt fuer Stadtplanung und Umwelt
06.11.2023 14:00;786;403;383;Stellenweiser Regenfall;11;9;0;Stadt Konstanz, Amt fuer Stadtplanung und Umwelt
06.11.2023 15:00;1121;566;555;Stellenweiser Regenfall;11;9;0;Stadt Konstanz, Amt fuer Stadtplanung und Umwelt
06.11.2023 16:00;1024;523;501;Stellenweiser Regenfall;10;8;0;Stadt Konstanz, Amt fuer Stadtplanung und Umwelt
06.11.2023 17:00;1321;632;689;Stellenweiser Regenfall;9;7;0;Stadt Konstanz, Amt fuer Stadtplanung und Umwelt
06.11.2023 18:00;915;388;527;Nieselregen;8;5;0.7;Stadt Konstanz, Amt fuer Stadtplanung und Umwelt
06.11.2023 19:00;703;317;386;Stellenweiser Nieselregen;9;5;0.2;Stadt Konstanz, Amt fuer Stadtplanung und Umwelt
06.11.2023 20:00;432;217;215;Stellenweiser Regenfall;7;5;0;Stadt Konstanz, Amt fuer Stadtplanung und Umwelt
06.11.2023 21:00;287;137;150;Leicht bewoelkt;6;4;0;Stadt Konstanz, Amt fuer Stadtplanung und Umwelt
06.11.2023 22:00;220;102;118;Leicht bewoelkt;5;4;0;Stadt Konstanz, Amt fuer Stadtplanung und Umwelt
06.11.2023 23:00;99;48;51;Leichter Nebel;5;4;0;Stadt Konstanz, Amt fuer Stadtplanung und Umwelt
07.11.2023 00:00;39;18;21;Leicht bewoelkt;4;3;0;Stadt Konstanz, Amt fuer Stadtplanung und Umwelt
07.11.2023 01:00;15;7;8;Leichter Nebel;4;3;0;Stadt Konstanz, Amt fuer Stadtplanung und Umwelt
07.11.2023 02:00;28;25;3;Leichter Nebel;4;3;0;Stadt Konstanz, Amt fuer Stadtplanung und Umwelt
07.11.2023 03:00;11;7;4;Leichter Nebel;3;3;0;Stadt Konstanz, Amt fuer Stadtplanung und Umwelt
07.11.2023 04:00;13;4;9;Leichter Nebel;3;3;0;Stadt Konstanz, Amt fuer Stadtplanung und Umwelt
07.11.2023 05:00;72;48;24;Leichter Nebel;3;3;0;Stadt Konstanz, Amt fuer Stadtplanung und Umwelt
07.11.2023 06:00;267;150;117;Leichter Nebel;2;2;0;Stadt Konstanz, Amt fuer Stadtplanung und Umwelt
07.11.2023 07:00;1244;770;474;Leichter Nebel;2;2;0;Stadt Konstanz, Amt fuer Stadtplanung und Umwelt
07.11.2023 08:00;1013;538;475;Leichter Nebel;3;3;0;Stadt Konstanz, Amt fuer Stadtplanung und Umwelt
07.11.2023 09:00;914;573;341;Leicht bewoelkt;6;4;0;Stadt Konstanz, Amt fuer Stadtplanung und Umwelt
07.11.2023 10:00;636;368;268;Leicht bewoelkt;8;5;0;Stadt Konstanz, Amt fuer Stadtplanung und Umwelt
07.11.2023 11:00;827;400;427;Stellenweiser Regenfall;9;6;0;Stadt Konstanz, Amt fuer Stadtplanung und Umwelt
07.11.2023 12:00;886;419;467;Stellenweiser Regenfall;9;7;0.1;Stadt Konstanz, Amt fuer Stadtplanung und Umwelt
07.11.2023 13:00;995;466;529;Stellenweiser Regenfall;9;7;0;Stadt Konstanz, Amt fuer Stadtplanung und Umwelt
07.11.2023 14:00;827;434;393;Stellenweiser Regenfall;9;6;0.1;Stadt Konstanz, Amt fuer Stadtplanung und Umwelt
07.11.2023 15:00;1070;504;566;Stellenweiser Regenfall;8;5;0;Stadt Konstanz, Amt fuer Stadtplanung und Umwelt
07.11.2023 16:00;1059;503;556;Stellenweiser Regenfall;7;4;0;Stadt Konstanz, Amt fuer Stadtplanung und Umwelt
07.11.2023 17:00;1393;630;763;Leicht bewoelkt;6;3;0;Stadt Konstanz, Amt fuer Stadtplanung und Umwelt
07.11.2023 18:00;907;406;501;Stellenweiser Regenfall;5;2;0;Stadt Konstanz, Amt fuer Stadtplanung und Umwelt
07.11.2023 19:00;711;388;323;Stellenweiser Regenfall;5;2;0;Stadt Konstanz, Amt fuer Stadtplanung und Umwelt
07.11.2023 20:00;405;220;185;Bedeckt;5;2;0;Stadt Konstanz, Amt fuer Stadtplanung und Umwelt
07.11.2023 21:00;351;174;177;Bewoelkt;5;2;0;Stadt Konstanz, Amt fuer Stadtplanung und Umwelt
07.11.2023 22:00;244;93;151;Leicht bewoelkt;4;2;0;Stadt Konstanz, Amt fuer Stadtplanung und Umwelt
07.11.2023 23:00;118;54;64;Leichter Nebel;3;1;0;Stadt Konstanz, Amt fuer Stadtplanung und Umwelt
08.11.2023 00:00;60;26;34;Sonnig;4;2;0;Stadt Konstanz, Amt fuer Stadtplanung und Umwelt
08.11.2023 01:00;30;15;15;Leichter Nebel;2;1;0;Stadt Konstanz, Amt fuer Stadtplanung und Umwelt
08.11.2023 02:00;7;3;4;Leichter Nebel;2;1;0;Stadt Konstanz, Amt fuer Stadtplanung und Umwelt
08.11.2023 03:00;2;1;1;Bewoelkt;3;2;0;Stadt Konstanz, Amt fuer Stadtplanung und Umwelt
08.11.2023 04:00;9;4;5;Leicht bewoelkt;3;2;0;Stadt Konstanz, Amt fuer Stadtplanung und Umwelt
08.11.2023 05:00;68;46;22;Leichter Nebel;2;0;0;Stadt Konstanz, Amt fuer Stadtplanung und Umwelt
08.11.2023 06:00;237;118;119;Leichter Nebel;1;0;0;Stadt Konstanz, Amt fuer Stadtplanung und Umwelt
08.11.2023 07:00;1305;804;501;Leichter Nebel;1;0;0;Stadt Konstanz, Amt fuer Stadtplanung und Umwelt
08.11.2023 08:00;1066;577;489;Leichter Nebel;1;1;0;Stadt Konstanz, Amt fuer Stadtplanung und Umwelt
08.11.2023 09:00;936;521;415;Leicht bewoelkt;4;3;0;Stadt Konstanz, Amt fuer Stadtplanung und Umwelt
08.11.2023 10:00;531;276;255;Sonnig;6;5;0;Stadt Konstanz, Amt fuer Stadtplanung und Umwelt
08.11.2023 11:00;775;374;401;Sonnig;7;6;0;Stadt Konstanz, Amt fuer Stadtplanung und Umwelt
08.11.2023 12:00;828;394;434;Bewoelkt;9;7;0;Stadt Konstanz, Amt fuer Stadtplanung und Umwelt
08.11.2023 13:00;1228;611;617;Leicht bewoelkt;9;8;0;Stadt Konstanz, Amt fuer Stadtplanung und Umwelt
08.11.2023 14:00;913;466;447;Sonnig;10;8;0;Stadt Konstanz, Amt fuer Stadtplanung und Umwelt
08.11.2023 15:00;1116;532;584;Sonnig;9;8;0;Stadt Konstanz, Amt fuer Stadtplanung und Umwelt
08.11.2023 16:00;1255;627;628;Sonnig;8;7;0;Stadt Konstanz, Amt fuer Stadtplanung und Umwelt
08.11.2023 17:00;1267;569;698;Sonnig;4;3;0;Stadt Konstanz, Amt fuer Stadtplanung und Umwelt
08.11.2023 18:00;981;474;507;Leicht bewoelkt;3;3;0;Stadt Konstanz, Amt fuer Stadtplanung und Umwelt
08.11.2023 19:00;599;289;310;Leicht bewoelkt;3;2;0;Stadt Konstanz, Amt fuer Stadtplanung und Umwelt
08.11.2023 20:00;512;262;250;Sonnig;2;1;0;Stadt Konstanz, Amt fuer Stadtplanung und Umwelt
08.11.2023 21:00;331;161;170;Leicht bewoelkt;2;1;0;Stadt Konstanz, Amt fuer Stadtplanung und Umwelt
08.11.2023 22:00;274;108;166;Sonnig;1;1;0;Stadt Konstanz, Amt fuer Stadtplanung und Umwelt
08.11.2023 23:00;175;90;85;Sonnig;1;1;0;Stadt Konstanz, Amt fuer Stadtplanung und Umwelt
09.11.2023 00:00;76;37;39;Sonnig;1;1;0;Stadt Konstanz, Amt fuer Stadtplanung und Umwelt
09.11.2023 01:00;42;5;37;Sonnig;0;0;0;Stadt Konstanz, Amt fuer Stadtplanung und Umwelt
09.11.2023 02:00;22;5;17;Sonnig;0;0;0;Stadt Konstanz, Amt fuer Stadtplanung und Umwelt
09.11.2023 03:00;9;2;7;Sonnig;0;0;0;Stadt Konstanz, Amt fuer Stadtplanung und Umwelt
09.11.2023 04:00;15;8;7;Sonnig;0;0;0;Stadt Konstanz, Amt fuer Stadtplanung und Umwelt
09.11.2023 05:00;73;52;21;Sonnig;0;0;0;Stadt Konstanz, Amt fuer Stadtplanung und Umwelt
09.11.2023 06:00;224;120;104;Sonnig;-1;-1;0;Stadt Konstanz, Amt fuer Stadtplanung und Umwelt
09.11.2023 07:00;1187;715;472;Leicht bewoelkt;-1;-1;0;Stadt Konstanz, Amt fuer Stadtplanung und Umwelt
09.11.2023 08:00;980;513;467;Leicht bewoelkt;0;0;0;Stadt Konstanz, Amt fuer Stadtplanung und Umwelt
09.11.2023 09:00;862;505;357;Leicht bewoelkt;2;1;0;Stadt Konstanz, Amt fuer Stadtplanung und Umwelt
09.11.2023 10:00;501;272;229;Bedeckt;4;4;0;Stadt Konstanz, Amt fuer Stadtplanung und Umwelt
09.11.2023 11:00;692;344;348;Bedeckt;6;5;0;Stadt Konstanz, Amt fuer Stadtplanung und Umwelt
09.11.2023 12:00;748;334;414;Bedeckt;7;5;0;Stadt Konstanz, Amt fuer Stadtplanung und Umwelt
09.11.2023 13:00;1033;430;603;Leicht bewoelkt;8;6;0;Stadt Konstanz, Amt fuer Stadtplanung und Umwelt
09.11.2023 14:00;761;390;371;Bewoelkt;9;6;0;Stadt Konstanz, Amt fuer Stadtplanung und Umwelt
09.11.2023 15:00;1117;559;558;Bedeckt;8;6;0;Stadt Konstanz, Amt fuer Stadtplanung und Umwelt
09.11.2023 16:00;924;475;449;Bewoelkt;7;5;0;Stadt Konstanz, Amt fuer Stadtplanung und Umwelt
09.11.2023 17:00;1104;490;614;Stellenweiser Regenfall;6;4;0.1;Stadt Konstanz, Amt fuer Stadtplanung und Umwelt
09.11.2023 18:00;814;368;446;Leichter Regenfall;6;3;1.4;Stadt Konstanz, Amt fuer Stadtplanung und Umwelt
09.11.2023 19:00;542;271;271;Nieselregen;6;3;0.4;Stadt Konstanz, Amt fuer Stadtplanung und Umwelt
09.11.2023 20:00;389;223;166;Bedeckt;6;3;0;Stadt Konstanz, Amt fuer Stadtplanung und Umwelt
09.11.2023 21:00;279;134;145;Bewoelkt;6;3;0;Stadt Konstanz, Amt fuer Stadtplanung und Umwelt
09.11.2023 22:00;245;99;146;Leichter Nebel;4;3;0;Stadt Konstanz, Amt fuer Stadtplanung und Umwelt
09.11.2023 23:00;148;63;85;Leicht bewoelkt;3;3;0;Stadt Konstanz, Amt fuer Stadtplanung und Umwelt
10.11.2023 00:00;75;32;43;Leichter Nebel;5;3;0.1;Stadt Konstanz, Amt fuer Stadtplanung und Umwelt
10.11.2023 01:00;40;11;29;Stellenweiser Regenfall;6;4;0.1;Stadt Konstanz, Amt fuer Stadtplanung und Umwelt
10.11.2023 02:00;26;14;12;Bedeckt;6;4;0;Stadt Konstanz, Amt fuer Stadtplanung und Umwelt
10.11.2023 03:00;12;10;2;Bewoelkt;6;4;0;Stadt Konstanz, Amt fuer Stadtplanung und Umwelt
10.11.2023 04:00;6;2;4;Stellenweiser Regenfall;6;3;0;Stadt Konstanz, Amt fuer Stadtplanung und Umwelt
10.11.2023 05:00;48;31;17;Leichter Regenfall;6;3;1.4;Stadt Konstanz, Amt fuer Stadtplanung und Umwelt
10.11.2023 06:00;130;70;60;Leichter Regenfall;6;3;1.4;Stadt Konstanz, Amt fuer Stadtplanung und Umwelt
10.11.2023 07:00;809;499;310;Leichter Regenfall;6;4;1.7;Stadt Konstanz, Amt fuer Stadtplanung und Umwelt
10.11.2023 08:00;771;442;329;Maeßiger Regenfall;6;3;3;Stadt Konstanz, Amt fuer Stadtplanung und Umwelt
10.11.2023 09:00;705;416;289;Leichter Regenfall;6;2;1.3;Stadt Konstanz, Amt fuer Stadtplanung und Umwelt
10.11.2023 10:00;542;303;239;Stellenweiser Regenfall;5;2;0;Stadt Konstanz, Amt fuer Stadtplanung und Umwelt
10.11.2023 11:00;714;365;349;Stellenweiser Regenfall;6;3;0.1;Stadt Konstanz, Amt fuer Stadtplanung und Umwelt
10.11.2023 12:00;802;375;427;Stellenweiser Regenfall;6;3;0;Stadt Konstanz, Amt fuer Stadtplanung und Umwelt
10.11.2023 13:00;929;416;513;Stellenweiser Regenfall;7;4;0;Stadt Konstanz, Amt fuer Stadtplanung und Umwelt
10.11.2023 14:00;785;428;357;Stellenweiser Regenfall;8;5;0.1;Stadt Konstanz, Amt fuer Stadtplanung und Umwelt
10.11.2023 15:00;929;451;478;Stellenweiser Regenfall;7;5;0;Stadt Konstanz, Amt fuer Stadtplanung und Umwelt
10.11.2023 16:00;773;366;407;Sonnig;6;4;0;Stadt Konstanz, Amt fuer Stadtplanung und Umwelt
10.11.2023 17:00;788;398;390;Stellenweiser Regenfall;3;2;0;Stadt Konstanz, Amt fuer Stadtplanung und Umwelt
10.11.2023 18:00;690;322;368;Leicht bewoelkt;2;1;0;Stadt Konstanz, Amt fuer Stadtplanung und Umwelt
10.11.2023 19:00;493;293;200;Leicht bewoelkt;2;1;0;Stadt Konstanz, Amt fuer Stadtplanung und Umwelt
10.11.2023 20:00;335;193;142;Leichter Nebel;2;1;0;Stadt Konstanz, Amt fuer Stadtplanung und Umwelt
10.11.2023 21:00;321;165;156;Leicht bewoelkt;3;0;0;Stadt Konstanz, Amt fuer Stadtplanung und Umwelt
10.11.2023 22:00;234;89;145;Bedeckt;4;1;0;Stadt Konstanz, Amt fuer Stadtplanung und Umwelt
10.11.2023 23:00;214;59;155;Stellenweiser Regenfall;5;1;0.1;Stadt Konstanz, Amt fuer Stadtplanung und Umwelt
11.11.2023 00:00;173;48;125;Stellenweiser Regenfall;5;0;0.1;Stadt Konstanz, Amt fuer Stadtplanung und Umwelt
11.11.2023 01:00;106;24;82;Nieselregen;4;0;0.2;Stadt Konstanz, Amt fuer Stadtplanung und Umwelt
11.11.2023 02:00;73;30;43;Nieselregen;5;0;0.6;Stadt Konstanz, Amt fuer Stadtplanung und Umwelt
11.11.2023 03:00;44;21;23;Leichter Regenschauer;6;1;0.3;Stadt Konstanz, Amt fuer Stadtplanung und Umwelt
11.11.2023 04:00;42;11;31;Stellenweiser Regenfall;5;1;0.1;Stadt Konstanz, Amt fuer Stadtplanung und Umwelt
11.11.2023 05:00;32;24;8;Stellenweiser Regenfall;5;1;0;Stadt Konstanz, Amt fuer Stadtplanung und Umwelt
11.11.2023 06:00;50;27;23;Stellenweiser Regenfall;5;1;0;Stadt Konstanz, Amt fuer Stadtplanung und Umwelt
11.11.2023 07:00;91;54;37;Leicht bewoelkt;4;0;0;Stadt Konstanz, Amt fuer Stadtplanung und Umwelt
11.11.2023 08:00;256;136;120;Stellenweise Gewitter und Niederschlaege;4;0;0.1;Stadt Konstanz, Amt fuer Stadtplanung und Umwelt
11.11.2023 09:00;454;287;167;Nieselregen;4;1;0.4;Stadt Konstanz, Amt fuer Stadtplanung und Umwelt
11.11.2023 10:00;462;244;218;Stellenweiser Regenfall;4;1;0.1;Stadt Konstanz, Amt fuer Stadtplanung und Umwelt
11.11.2023 11:00;520;263;257;Nieselregen;5;2;0.5;Stadt Konstanz, Amt fuer Stadtplanung und Umwelt
11.11.2023 12:00;571;324;247;Stellenweiser Regenfall;5;1;0.1;Stadt Konstanz, Amt fuer Stadtplanung und Umwelt
11.11.2023 13:00;576;294;282;Stellenweiser Regenfall;6;3;0.1;Stadt Konstanz, Amt fuer Stadtplanung und Umwelt
11.11.2023 14:00;634;318;316;Leichter Regenschauer;6;3;0.4;Stadt Konstanz, Amt fuer Stadtplanung und Umwelt
11.11.2023 15:00;416;219;197;Stellenweiser Regenfall;5;2;0.1;Stadt Konstanz, Amt fuer Stadtplanung und Umwelt
11.11.2023 16:00;499;238;261;Stellenweiser Regenfall;5;2;0;Stadt Konstanz, Amt fuer Stadtplanung und Umwelt
11.11.2023 17:00;503;257;246;Stellenweiser Regenfall;5;1;0;Stadt Konstanz, Amt fuer Stadtplanung und Umwelt
11.11.2023 18:00;425;201;224;Sonnig;4;1;0;Stadt Konstanz, Amt fuer Stadtplanung und Umwelt
11.11.2023 19:00;427;274;153;Leichter Nebel;2;1;0;Stadt Konstanz, Amt fuer Stadtplanung und Umwelt
11.11.2023 20:00;265;132;133;Leichter Nebel;2;1;0;Stadt Konstanz, Amt fuer Stadtplanung und Umwelt
11.11.2023 21:00;234;98;136;Leichter Nebel;2;1;0;Stadt Konstanz, Amt fuer Stadtplanung und Umwelt
11.11.2023 22:00;250;97;153;Leichter Nebel;1;1;0;Stadt Konstanz, Amt fuer Stadtplanung und Umwelt
11.11.2023 23:00;164;70;94;Leichter Nebel;1;1;0;Stadt Konstanz, Amt fuer Stadtplanung und Umwelt
12.11.2023 00:00;157;40;117;Leichter Nebel;1;1;0;Stadt Konstanz, Amt fuer Stadtplanung und Umwelt
12.11.2023 01:00;122;41;81;Leichter Nebel;1;1;0;Stadt Konstanz, Amt fuer Stadtplanung und Umwelt
12.11.2023 02:00;84;31;53;Bewoelkt;1;1;0;Stadt Konstanz, Amt fuer Stadtplanung und Umwelt
12.11.2023 03:00;47;15;32;Bewoelkt;1;1;0;Stadt Konstanz, Amt fuer Stadtplanung und Umwelt
12.11.2023 04:00;24;10;14;Leichter Nebel;1;1;0;Stadt Konstanz, Amt fuer Stadtplanung und Umwelt
12.11.2023 05:00;36;20;16;Leichter Nebel;2;2;0;Stadt Konstanz, Amt fuer Stadtplanung und Umwelt
12.11.2023 06:00;35;18;17;Leichter Nebel;2;2;0;Stadt Konstanz, Amt fuer Stadtplanung und Umwelt
12.11.2023 07:00;40;21;19;Leichter Nebel;1;1;0;Stadt Konstanz, Amt fuer Stadtplanung und Umwelt
12.11.2023 08:00;66;35;31;Nieselregen;2;2;0.4;Stadt Konstanz, Amt fuer Stadtplanung und Umwelt
12.11.2023 09:00;136;72;64;Leichter Regenfall;3;3;0.8;Stadt Konstanz, Amt fuer Stadtplanung und Umwelt
12.11.2023 10:00;182;99;83;Leichter Regenfall;4;3;1.2;Stadt Konstanz, Amt fuer Stadtplanung und Umwelt
12.11.2023 11:00;204;100;104;Leichter Eisregen;3;2;1.5;Stadt Konstanz, Amt fuer Stadtplanung und Umwelt
12.11.2023 12:00;201;94;107;Leichter Eisregen;3;1;2.2;Stadt Konstanz, Amt fuer Stadtplanung und Umwelt
12.11.2023 13:00;142;83;59;Starker Schneefall;2;1;2.7;Stadt Konstanz, Amt fuer Stadtplanung und Umwelt
12.11.2023 14:00;160;70;90;Leichter Eisregen;2;2;0.8;Stadt Konstanz, Amt fuer Stadtplanung und Umwelt
12.11.2023 15:00;128;68;60;Nieselregen;2;2;0.7;Stadt Konstanz, Amt fuer Stadtplanung und Umwelt
12.11.2023 16:00;158;78;80;Nieselregen;2;2;0.2;Stadt Konstanz, Amt fuer Stadtplanung und Umwelt
12.11.2023 17:00;165;79;86;Nebel;3;2;0;Stadt Konstanz, Amt fuer Stadtplanung und Umwelt
12.11.2023 18:00;149;64;85;Nebel;4;3;0;Stadt Konstanz, Amt fuer Stadtplanung und Umwelt
12.11.2023 19:00;114;58;56;Nieselregen;6;4;0.3;Stadt Konstanz, Amt fuer Stadtplanung und Umwelt
12.11.2023 20:00;121;66;55;Leichter Regenfall;8;5;1.7;Stadt Konstanz, Amt fuer Stadtplanung und Umwelt
12.11.2023 21:00;86;55;31;Leichter Regenfall;8;4;0.8;Stadt Konstanz, Amt fuer Stadtplanung und Umwelt
12.11.2023 22:00;94;52;42;Maeßiger Regenfall;9;5;3.8;Stadt Konstanz, Amt fuer Stadtplanung und Umwelt
12.11.2023 23:00;30;18;12;Stellenweiser Regenfall;10;6;0.1;Stadt Konstanz, Amt fuer Stadtplanung und Umwelt
13.11.2023 00:00;17;6;11;Leichter Regenfall;8;5;1.1;Stadt Konstanz, Amt fuer Stadtplanung und Umwelt
13.11.2023 01:00;28;10;18;Stellenweiser Regenfall;8;5;0.1;Stadt Konstanz, Amt fuer Stadtplanung und Umwelt
13.11.2023 02:00;3;2;1;Stellenweiser Regenfall;8;5;0.1;Stadt Konstanz, Amt fuer Stadtplanung und Umwelt
13.11.2023 03:00;3;2;1;Nieselregen;8;5;0.2;Stadt Konstanz, Amt fuer Stadtplanung und Umwelt
13.11.2023 04:00;7;2;5;Nieselregen;8;5;0.2;Stadt Konstanz, Amt fuer Stadtplanung und Umwelt
13.11.2023 05:00;61;43;18;Nieselregen;8;5;0.6;Stadt Konstanz, Amt fuer Stadtplanung und Umwelt
13.11.2023 06:00;172;85;87;Nieselregen;9;6;0.3;Stadt Konstanz, Amt fuer Stadtplanung und Umwelt
13.11.2023 07:00;860;510;350;Nieselregen;9;6;0.5;Stadt Konstanz, Amt fuer Stadtplanung und Umwelt
13.11.2023 08:00;659;385;274;Leichter Regenfall;10;7;1.2;Stadt Konstanz, Amt fuer Stadtplanung und Umwelt
13.11.2023 09:00;663;424;239;Leichter Regenfall;10;7;1.3;Stadt Konstanz, Amt fuer Stadtplanung und Umwelt
13.11.2023 10:00;358;178;180;Bedeckt;11;8;0;Stadt Konstanz, Amt fuer Stadtplanung und Umwelt
13.11.2023 11:00;534;250;284;Stellenweiser Regenfall;12;9;0;Stadt Konstanz, Amt fuer Stadtplanung und Umwelt
13.11.2023 12:00;494;223;271;Bedeckt;12;10;0;Stadt Konstanz, Amt fuer Stadtplanung und Umwelt
13.11.2023 13:00;803;351;452;Stellenweiser Regenfall;13;11;0.1;Stadt Konstanz, Amt fuer Stadtplanung und Umwelt
13.11.2023 14:00;487;244;243;Leicht bewoelkt;12;10;0;Stadt Konstanz, Amt fuer Stadtplanung und Umwelt
13.11.2023 15:00;798;369;429;Bewoelkt;13;11;0;Stadt Konstanz, Amt fuer Stadtplanung und Umwelt
13.11.2023 16:00;708;357;351;Leicht bewoelkt;13;11;0;Stadt Konstanz, Amt fuer Stadtplanung und Umwelt
13.11.2023 17:00;899;423;476;Stellenweiser Regenfall;13;11;0.1;Stadt Konstanz, Amt fuer Stadtplanung und Umwelt
13.11.2023 18:00;711;321;390;Leichter Regenfall;12;10;0.8;Stadt Konstanz, Amt fuer Stadtplanung und Umwelt
13.11.2023 19:00;566;275;291;Stellenweiser Nieselregen;13;10;0.2;Stadt Konstanz, Amt fuer Stadtplanung und Umwelt
13.11.2023 20:00;371;173;198;Nieselregen;13;10;0.6;Stadt Konstanz, Amt fuer Stadtplanung und Umwelt
13.11.2023 21:00;254;127;127;Stellenweiser Regenfall;13;10;0;Stadt Konstanz, Amt fuer Stadtplanung und Umwelt
13.11.2023 22:00;189;88;101;Stellenweiser Regenfall;13;11;0;Stadt Konstanz, Amt fuer Stadtplanung und Umwelt
13.11.2023 23:00;72;33;39;Stellenweiser Regenfall;13;11;0.1;Stadt Konstanz, Amt fuer Stadtplanung und Umwelt
14.11.2023 00:00;31;10;21;Leichter Regenfall;13;10;1.7;Stadt Konstanz, Amt fuer Stadtplanung und Umwelt
14.11.2023 01:00;35;5;30;Nieselregen;13;11;0.4;Stadt Konstanz, Amt fuer Stadtplanung und Umwelt
14.11.2023 02:00;5;3;2;Nieselregen;13;11;0.3;Stadt Konstanz, Amt fuer Stadtplanung und Umwelt
14.11.2023 03:00;3;1;2;Leichter Regenfall;13;11;1;Stadt Konstanz, Amt fuer Stadtplanung und Umwelt
14.11.2023 04:00;8;3;5;Nieselregen;13;11;0.5;Stadt Konstanz, Amt fuer Stadtplanung und Umwelt
14.11.2023 05:00;40;24;16;Nieselregen;13;11;0.7;Stadt Konstanz, Amt fuer Stadtplanung und Umwelt
14.11.2023 06:00;144;58;86;Leichter Regenfall;13;11;1.6;Stadt Konstanz, Amt fuer Stadtplanung und Umwelt
14.11.2023 07:00;941;593;348;Nieselregen;12;11;0.6;Stadt Konstanz, Amt fuer Stadtplanung und Umwelt
14.11.2023 08:00;766;414;352;Leichter Regenfall;13;10;1;Stadt Konstanz, Amt fuer Stadtplanung und Umwelt
14.11.2023 09:00;743;460;283;Nieselregen;13;11;0.2;Stadt Konstanz, Amt fuer Stadtplanung und Umwelt
14.11.2023 10:00;420;247;173;Nieselregen;14;12;0.4;Stadt Konstanz, Amt fuer Stadtplanung und Umwelt
14.11.2023 11:00;574;279;295;Leichter Regenfall;13;11;1.3;Stadt Konstanz, Amt fuer Stadtplanung und Umwelt
14.11.2023 12:00;619;268;351;Leichter Regenschauer;14;12;0.2;Stadt Konstanz, Amt fuer Stadtplanung und Umwelt
14.11.2023 13:00;715;321;394;Maeßiger Regenfall;14;12;3.4;Stadt Konstanz, Amt fuer Stadtplanung und Umwelt
14.11.2023 14:00;439;212;227;Maeßiger Regenfall;12;10;4;Stadt Konstanz, Amt fuer Stadtplanung und Umwelt
14.11.2023 15:00;693;328;365;Maeßiger Regenfall;11;10;2.6;Stadt Konstanz, Amt fuer Stadtplanung und Umwelt
14.11.2023 16:00;660;286;374;Maeßiger Regenfall;11;9;4.4;Stadt Konstanz, Amt fuer Stadtplanung und Umwelt
14.11.2023 17:00;848;396;452;Leichter Regenfall;11;9;1.8;Stadt Konstanz, Amt fuer Stadtplanung und Umwelt
14.11.2023 18:00;619;268;351;Nieselregen;11;9;0.5;Stadt Konstanz, Amt fuer Stadtplanung und Umwelt
14.11.2023 19:00;467;233;234;Nieselregen;11;9;0.4;Stadt Konstanz, Amt fuer Stadtplanung und Umwelt
14.11.2023 20:00;264;141;123;Nieselregen;12;9;0.5;Stadt Konstanz, Amt fuer Stadtplanung und Umwelt
14.11.2023 21:00;214;101;113;Leichter Regenfall;11;9;0.9;Stadt Konstanz, Amt fuer Stadtplanung und Umwelt
14.11.2023 22:00;164;65;99;Stellenweiser Regenfall;11;8;0.1;Stadt Konstanz, Amt fuer Stadtplanung und Umwelt
14.11.2023 23:00;89;36;53;Stellenweiser Regenfall;11;7;0;Stadt Konstanz, Amt fuer Stadtplanung und Umwelt
15.11.2023 00:00;35;16;19;Stellenweiser Regenfall;9;5;0;Stadt Konstanz, Amt fuer Stadtplanung und Umwelt
15.11.2023 01:00;24;15;9;Stellenweiser Regenfall;9;5;0;Stadt Konstanz, Amt fuer Stadtplanung und Umwelt
15.11.2023 02:00;16;11;5;Stellenweiser Regenfall;8;5;0;Stadt Konstanz, Amt fuer Stadtplanung und Umwelt
15.11.2023 03:00;7;4;3;Stellenweiser Regenfall;8;5;0.1;Stadt Konstanz, Amt fuer Stadtplanung und Umwelt
15.11.2023 04:00;10;2;8;Stellenweiser Regenfall;8;5;0.1;Stadt Konstanz, Amt fuer Stadtplanung und Umwelt
15.11.2023 05:00;49;35;14;Nieselregen;8;5;0.2;Stadt Konstanz, Amt fuer Stadtplanung und Umwelt
15.11.2023 06:00;161;86;75;Stellenweiser Regenfall;8;5;0.1;Stadt Konstanz, Amt fuer Stadtplanung und Umwelt
15.11.2023 07:00;1069;669;400;Nieselregen;8;5;0.3;Stadt Konstanz, Amt fuer Stadtplanung und Umwelt
15.11.2023 08:00;838;478;360;Stellenweiser Regenfall;8;5;0.1;Stadt Konstanz, Amt fuer Stadtplanung und Umwelt
15.11.2023 09:00;778;474;304;Stellenweiser Regenfall;8;5;0;Stadt Konstanz, Amt fuer Stadtplanung und Umwelt
15.11.2023 10:00;505;264;241;Stellenweiser Regenfall;9;6;0;Stadt Konstanz, Amt fuer Stadtplanung und Umwelt
15.11.2023 11:00;680;320;360;Stellenweiser Regenfall;9;7;0.1;Stadt Konstanz, Amt fuer Stadtplanung und Umwelt
15.11.2023 12:00;773;373;400;Stellenweiser Regenfall;10;7;0.1;Stadt Konstanz, Amt fuer Stadtplanung und Umwelt
15.11.2023 13:00;1037;526;511;Stellenweiser Nieselregen;10;7;0.2;Stadt Konstanz, Amt fuer Stadtplanung und Umwelt
15.11.2023 14:00;697;368;329;Stellenweiser Regenfall;10;7;0.1;Stadt Konstanz, Amt fuer Stadtplanung und Umwelt
15.11.2023 15:00;912;384;528;Stellenweiser Regenfall;9;7;0.1;Stadt Konstanz, Amt fuer Stadtplanung und Umwelt
15.11.2023 16:00;975;475;500;Leicht bewoelkt;8;6;0;Stadt Konstanz, Amt fuer Stadtplanung und Umwelt
15.11.2023 17:00;1164;596;568;Leicht bewoelkt;7;4;0;Stadt Konstanz, Amt fuer Stadtplanung und Umwelt
15.11.2023 18:00;882;409;473;Leicht bewoelkt;7;4;0;Stadt Konstanz, Amt fuer Stadtplanung und Umwelt
15.11.2023 19:00;604;296;308;Leicht bewoelkt;7;4;0;Stadt Konstanz, Amt fuer Stadtplanung und Umwelt
15.11.2023 20:00;414;208;206;Stellenweiser Regenfall;7;4;0;Stadt Konstanz, Amt fuer Stadtplanung und Umwelt
15.11.2023 21:00;330;164;166;Leicht bewoelkt;7;4;0;Stadt Konstanz, Amt fuer Stadtplanung und Umwelt
15.11.2023 22:00;249;114;135;Leicht bewoelkt;6;3;0;Stadt Konstanz, Amt fuer Stadtplanung und Umwelt
15.11.2023 23:00;213;96;117;Leicht bewoelkt;6;3;0;Stadt Konstanz, Amt fuer Stadtplanung und Umwelt
16.11.2023 00:00;75;24;51;Leichter Nebel;4;4;0;Stadt Konstanz, Amt fuer Stadtplanung und Umwelt
16.11.2023 01:00;42;13;29;Leichter Nebel;4;4;0;Stadt Konstanz, Amt fuer Stadtplanung und Umwelt
16.11.2023 02:00;25;4;21;Leichter Nebel;4;4;0;Stadt Konstanz, Amt fuer Stadtplanung und Umwelt
16.11.2023 03:00;22;18;4;Leichter Nebel;4;3;0;Stadt Konstanz, Amt fuer Stadtplanung und Umwelt
16.11.2023 04:00;11;4;7;Leichter Nebel;4;3;0;Stadt Konstanz, Amt fuer Stadtplanung und Umwelt
16.11.2023 05:00;62;40;22;Leichter Nebel;3;3;0;Stadt Konstanz, Amt fuer Stadtplanung und Umwelt
16.11.2023 06:00;199;112;87;Leichter Nebel;3;3;0;Stadt Konstanz, Amt fuer Stadtplanung und Umwelt
16.11.2023 07:00;1054;622;432;Leichter Nebel;3;3;0;Stadt Konstanz, Amt fuer Stadtplanung und Umwelt
16.11.2023 08:00;830;452;378;Leichter Nebel;2;2;0;Stadt Konstanz, Amt fuer Stadtplanung und Umwelt
16.11.2023 09:00;784;472;312;Leicht bewoelkt;5;5;0;Stadt Konstanz, Amt fuer Stadtplanung und Umwelt
16.11.2023 10:00;489;256;233;Bedeckt;6;6;0;Stadt Konstanz, Amt fuer Stadtplanung und Umwelt
16.11.2023 11:00;679;368;311;Bedeckt;7;6;0;Stadt Konstanz, Amt fuer Stadtplanung und Umwelt
16.11.2023 12:00;670;307;363;Bedeckt;8;7;0;Stadt Konstanz, Amt fuer Stadtplanung und Umwelt
16.11.2023 13:00;855;397;458;Stellenweiser Regenfall;7;7;0.1;Stadt Konstanz, Amt fuer Stadtplanung und Umwelt
16.11.2023 14:00;568;264;304;Nieselregen;7;6;0.4;Stadt Konstanz, Amt fuer Stadtplanung und Umwelt
16.11.2023 15:00;932;464;468;Nieselregen;6;5;0.2;Stadt Konstanz, Amt fuer Stadtplanung und Umwelt
16.11.2023 16:00;849;422;427;Stellenweiser Regenfall;7;4;0;Stadt Konstanz, Amt fuer Stadtplanung und Umwelt
16.11.2023 17:00;911;397;514;Stellenweiser Regenfall;8;6;0;Stadt Konstanz, Amt fuer Stadtplanung und Umwelt
16.11.2023 18:00;654;309;345;Stellenweiser Regenfall;10;7;0;Stadt Konstanz, Amt fuer Stadtplanung und Umwelt
16.11.2023 19:00;499;248;251;Sonnig;11;7;0;Stadt Konstanz, Amt fuer Stadtplanung und Umwelt
16.11.2023 20:00;319;163;156;Leicht bewoelkt;11;8;0;Stadt Konstanz, Amt fuer Stadtplanung und Umwelt
16.11.2023 21:00;247;115;132;Sonnig;11;8;0;Stadt Konstanz, Amt fuer Stadtplanung und Umwelt
16.11.2023 22:00;200;73;127;Stellenweiser Regenfall;11;8;0;Stadt Konstanz, Amt fuer Stadtplanung und Umwelt
16.11.2023 23:00;94;41;53;Stellenweiser Regenfall;11;8;0;Stadt Konstanz, Amt fuer Stadtplanung und Umwelt
17.11.2023 00:00;71;12;59;Leichter Regenfall;8;2;1.7;Stadt Konstanz, Amt fuer Stadtplanung und Umwelt
17.11.2023 01:00;29;15;14;Nieselregen;6;0;0.7;Stadt Konstanz, Amt fuer Stadtplanung und Umwelt
17.11.2023 02:00;25;11;14;Leichter Regenfall;5;0;0.9;Stadt Konstanz, Amt fuer Stadtplanung und Umwelt
17.11.2023 03:00;11;6;5;Nieselregen;5;0;0.3;Stadt Konstanz, Amt fuer Stadtplanung und Umwelt
17.11.2023 04:00;24;18;6;Nieselregen;5;0;0.6;Stadt Konstanz, Amt fuer Stadtplanung und Umwelt
17.11.2023 05:00;56;38;18;Nieselregen;5;1;0.5;Stadt Konstanz, Amt fuer Stadtplanung und Umwelt
17.11.2023 06:00;132;71;61;Leichter Regenschauer;5;2;0.2;Stadt Konstanz, Amt fuer Stadtplanung und Umwelt
17.11.2023 07:00;888;556;332;Nieselregen;4;2;0.2;Stadt Konstanz, Amt fuer Stadtplanung und Umwelt
17.11.2023 08:00;666;378;288;Leichter Nebel;4;2;0;Stadt Konstanz, Amt fuer Stadtplanung und Umwelt
17.11.2023 09:00;626;382;244;Nieselregen;5;2;0.2;Stadt Konstanz, Amt fuer Stadtplanung und Umwelt
17.11.2023 10:00;398;208;190;Stellenweiser Regenfall;4;1;0.1;Stadt Konstanz, Amt fuer Stadtplanung und Umwelt
17.11.2023 11:00;523;261;262;Stellenweiser Regenfall;5;2;0;Stadt Konstanz, Amt fuer Stadtplanung und Umwelt
17.11.2023 12:00;632;299;333;Stellenweiser Regenfall;6;3;0.1;Stadt Konstanz, Amt fuer Stadtplanung und Umwelt
17.11.2023 13:00;850;371;479;Stellenweiser Regenfall;6;3;0.1;Stadt Konstanz, Amt fuer Stadtplanung und Umwelt
17.11.2023 14:00;585;296;289;Stellenweiser Regenfall;6;3;0;Stadt Konstanz, Amt fuer Stadtplanung und Umwelt
17.11.2023 15:00;658;307;351;Stellenweiser Regenfall;6;3;0;Stadt Konstanz, Amt fuer Stadtplanung und Umwelt
17.11.2023 16:00;553;250;303;Stellenweiser Regenfall;5;2;0;Stadt Konstanz, Amt fuer Stadtplanung und Umwelt
17.11.2023 17:00;544;242;302;Nieselregen;4;2;0.2;Stadt Konstanz, Amt fuer Stadtplanung und Umwelt
17.11.2023 18:00;432;193;239;Leichter Nebel;4;2;0;Stadt Konstanz, Amt fuer Stadtplanung und Umwelt
17.11.2023 19:00;380;202;178;Leichter Regenfall;4;2;1;Stadt Konstanz, Amt fuer Stadtplanung und Umwelt
17.11.2023 20:00;293;168;125;Leichter Nebel;5;2;0.1;Stadt Konstanz, Amt fuer Stadtplanung und Umwelt
17.11.2023 21:00;205;109;96;Stellenweiser Regenfall;5;2;0;Stadt Konstanz, Amt fuer Stadtplanung und Umwelt
17.11.2023 22:00;190;80;110;Leicht bewoelkt;4;1;0;Stadt Konstanz, Amt fuer Stadtplanung und Umwelt
17.11.2023 23:00;176;58;118;Leichter Nebel;3;1;0;Stadt Konstanz, Amt fuer Stadtplanung und Umwelt
18.11.2023 00:00;103;42;61;Leichter Nebel;4;4;0;Stadt Konstanz, Amt fuer Stadtplanung und Umwelt
18.11.2023 01:00;92;17;75;Leichter Nebel;3;3;0;Stadt Konstanz, Amt fuer Stadtplanung und Umwelt
18.11.2023 02:00;67;31;36;Leichter Nebel;2;2;0;Stadt Konstanz, Amt fuer Stadtplanung und Umwelt
18.11.2023 03:00;52;23;29;Leichter Nebel;2;2;0;Stadt Konstanz, Amt fuer Stadtplanung und Umwelt
18.11.2023 04:00;34;20;14;Leichter Nebel;1;1;0;Stadt Konstanz, Amt fuer Stadtplanung und Umwelt
18.11.2023 05:00;40;27;13;Leichter Nebel;0;0;0;Stadt Konstanz, Amt fuer Stadtplanung und Umwelt
18.11.2023 06:00;44;16;28;Leichter Nebel;1;1;0;Stadt Konstanz, Amt fuer Stadtplanung und Umwelt
18.11.2023 07:00;112;69;43;Leichter Nebel;0;0;0;Stadt Konstanz, Amt fuer Stadtplanung und Umwelt
18.11.2023 08:00;206;111;95;Leichter Nebel;0;0;0;Stadt Konstanz, Amt fuer Stadtplanung und Umwelt
18.11.2023 09:00;358;208;150;Leichter Nebel;2;2;0;Stadt Konstanz, Amt fuer Stadtplanung und Umwelt
18.11.2023 10:00;437;259;178;Leicht bewoelkt;4;4;0;Stadt Konstanz, Amt fuer Stadtplanung und Umwelt
18.11.2023 11:00;531;288;243;Leicht bewoelkt;5;4;0;Stadt Konstanz, Amt fuer Stadtplanung und Umwelt
18.11.2023 12:00;508;282;226;Bewoelkt;6;5;0;Stadt Konstanz, Amt fuer Stadtplanung und Umwelt
18.11.2023 13:00;488;256;232;Leicht bewoelkt;6;5;0;Stadt Konstanz, Amt fuer Stadtplanung und Umwelt
18.11.2023 14:00;516;244;272;Bedeckt;6;5;0;Stadt Konstanz, Amt fuer Stadtplanung und Umwelt
18.11.2023 15:00;487;236;251;Bewoelkt;6;6;0;Stadt Konstanz, Amt fuer Stadtplanung und Umwelt
18.11.2023 16:00;514;238;276;Bedeckt;6;6;0;Stadt Konstanz, Amt fuer Stadtplanung und Umwelt
18.11.2023 17:00;434;208;226;Stellenweiser Regenfall;4;3;0;Stadt Konstanz, Amt fuer Stadtplanung und Umwelt
18.11.2023 18:00;376;162;214;Nieselregen;4;4;0.3;Stadt Konstanz, Amt fuer Stadtplanung und Umwelt
18.11.2023 19:00;356;228;128;Nieselregen;4;3;0.6;Stadt Konstanz, Amt fuer Stadtplanung und Umwelt
18.11.2023 20:00;282;159;123;Nieselregen;4;3;0.5;Stadt Konstanz, Amt fuer Stadtplanung und Umwelt
18.11.2023 21:00;237;113;124;Nieselregen;5;4;0.6;Stadt Konstanz, Amt fuer Stadtplanung und Umwelt
18.11.2023 22:00;212;86;126;Nieselregen;5;4;0.4;Stadt Konstanz, Amt fuer Stadtplanung und Umwelt
18.11.2023 23:00;157;66;91;Nieselregen;5;4;0.6;Stadt Konstanz, Amt fuer Stadtplanung und Umwelt
19.11.2023 00:00;137;37;100;Nieselregen;6;4;0.3;Stadt Konstanz, Amt fuer Stadtplanung und Umwelt
19.11.2023 01:00;141;28;113;Nieselregen;6;4;0.4;Stadt Konstanz, Amt fuer Stadtplanung und Umwelt
19.11.2023 02:00;84;30;54;Leichter Nebel;7;5;0;Stadt Konstanz, Amt fuer Stadtplanung und Umwelt
19.11.2023 03:00;77;25;52;Stellenweiser Regenfall;7;6;0.1;Stadt Konstanz, Amt fuer Stadtplanung und Umwelt
19.11.2023 04:00;32;19;13;Leichter Nebel;7;6;0.1;Stadt Konstanz, Amt fuer Stadtplanung und Umwelt
19.11.2023 05:00;33;16;17;Nieselregen;8;6;0.5;Stadt Konstanz, Amt fuer Stadtplanung und Umwelt
19.11.2023 06:00;26;11;15;Leichter Regenfall;8;7;1.9;Stadt Konstanz, Amt fuer Stadtplanung und Umwelt
19.11.2023 07:00;21;10;11;Nieselregen;8;7;0.4;Stadt Konstanz, Amt fuer Stadtplanung und Umwelt
19.11.2023 08:00;69;28;41;Nieselregen;9;7;0.2;Stadt Konstanz, Amt fuer Stadtplanung und Umwelt
19.11.2023 09:00;170;91;79;Maeßiger Regenfall;9;7;3.4;Stadt Konstanz, Amt fuer Stadtplanung und Umwelt
19.11.2023 10:00;169;73;96;Leichter Regenfall;9;8;0.8;Stadt Konstanz, Amt fuer Stadtplanung und Umwelt
19.11.2023 11:00;210;102;108;Nebel;9;8;0;Stadt Konstanz, Amt fuer Stadtplanung und Umwelt
19.11.2023 12:00;245;123;122;Nebel;10;8;0;Stadt Konstanz, Amt fuer Stadtplanung und Umwelt
19.11.2023 13:00;330;171;159;Leichter Nebel;10;9;0.1;Stadt Konstanz, Amt fuer Stadtplanung und Umwelt
19.11.2023 14:00;291;163;128;Leichter Regenschauer;10;9;0.2;Stadt Konstanz, Amt fuer Stadtplanung und Umwelt
19.11.2023 15:00;339;188;151;Nieselregen;11;9;0.2;Stadt Konstanz, Amt fuer Stadtplanung und Umwelt
19.11.2023 16:00;368;171;197;Stellenweiser Regenfall;11;9;0;Stadt Konstanz, Amt fuer Stadtplanung und Umwelt
19.11.2023 17:00;353;133;220;Stellenweiser Regenfall;11;8;0;Stadt Konstanz, Amt fuer Stadtplanung und Umwelt
19.11.2023 18:00;300;147;153;Stellenweiser Regenfall;10;8;0;Stadt Konstanz, Amt fuer Stadtplanung und Umwelt
19.11.2023 19:00;243;126;117;Leicht bewoelkt;10;7;0;Stadt Konstanz, Amt fuer Stadtplanung und Umwelt
19.11.2023 20:00;181;103;78;Sonnig;9;7;0;Stadt Konstanz, Amt fuer Stadtplanung und Umwelt
19.11.2023 21:00;143;74;69;Sonnig;9;7;0;Stadt Konstanz, Amt fuer Stadtplanung und Umwelt
19.11.2023 22:00;104;53;51;Sonnig;9;6;0;Stadt Konstanz, Amt fuer Stadtplanung und Umwelt
19.11.2023 23:00;69;40;29;Sonnig;9;6;0;Stadt Konstanz, Amt fuer Stadtplanung und Umwelt
20.11.2023 00:00;32;17;15;Sonnig;9;6;0;Stadt Konstanz, Amt fuer Stadtplanung und Umwelt
20.11.2023 01:00;17;7;10;Sonnig;9;6;0;Stadt Konstanz, Amt fuer Stadtplanung und Umwelt
20.11.2023 02:00;6;3;3;Leicht bewoelkt;9;6;0;Stadt Konstanz, Amt fuer Stadtplanung und Umwelt
20.11.2023 03:00;3;1;2;Leicht bewoelkt;9;6;0;Stadt Konstanz, Amt fuer Stadtplanung und Umwelt
20.11.2023 04:00;19;8;11;Leicht bewoelkt;8;5;0;Stadt Konstanz, Amt fuer Stadtplanung und Umwelt
20.11.2023 05:00;67;49;18;Leicht bewoelkt;8;5;0;Stadt Konstanz, Amt fuer Stadtplanung und Umwelt
20.11.2023 06:00;211;106;105;Leicht bewoelkt;7;5;0;Stadt Konstanz, Amt fuer Stadtplanung und Umwelt
20.11.2023 07:00;1036;636;400;Leicht bewoelkt;7;5;0;Stadt Konstanz, Amt fuer Stadtplanung und Umwelt
20.11.2023 08:00;842;481;361;Leicht bewoelkt;7;5;0;Stadt Konstanz, Amt fuer Stadtplanung und Umwelt
20.11.2023 09:00;871;575;296;Leicht bewoelkt;8;5;0;Stadt Konstanz, Amt fuer Stadtplanung und Umwelt
20.11.2023 10:00;456;256;200;Bedeckt;9;6;0;Stadt Konstanz, Amt fuer Stadtplanung und Umwelt
20.11.2023 11:00;618;280;338;Bedeckt;9;7;0;Stadt Konstanz, Amt fuer Stadtplanung und Umwelt
20.11.2023 12:00;701;307;394;Stellenweiser Regenfall;9;7;0;Stadt Konstanz, Amt fuer Stadtplanung und Umwelt
20.11.2023 13:00;971;438;533;Stellenweiser Regenfall;10;7;0;Stadt Konstanz, Amt fuer Stadtplanung und Umwelt
20.11.2023 14:00;738;384;354;Stellenweiser Regenfall;10;7;0;Stadt Konstanz, Amt fuer Stadtplanung und Umwelt
20.11.2023 15:00;1038;512;526;Stellenweiser Regenfall;9;7;0;Stadt Konstanz, Amt fuer Stadtplanung und Umwelt
20.11.2023 16:00;963;439;524;Stellenweiser Regenfall;9;6;0;Stadt Konstanz, Amt fuer Stadtplanung und Umwelt
20.11.2023 17:00;1086;518;568;Stellenweiser Regenfall;7;5;0;Stadt Konstanz, Amt fuer Stadtplanung und Umwelt
20.11.2023 18:00;776;391;385;Stellenweiser Regenfall;6;4;0;Stadt Konstanz, Amt fuer Stadtplanung und Umwelt
20.11.2023 19:00;658;326;332;Leicht bewoelkt;5;4;0;Stadt Konstanz, Amt fuer Stadtplanung und Umwelt
20.11.2023 20:00;398;192;206;Stellenweiser Regenfall;5;4;0;Stadt Konstanz, Amt fuer Stadtplanung und Umwelt
20.11.2023 21:00;261;108;153;Leichter Nebel;5;4;0;Stadt Konstanz, Amt fuer Stadtplanung und Umwelt
20.11.2023 22:00;227;92;135;Leichter Nebel;4;4;0;Stadt Konstanz, Amt fuer Stadtplanung und Umwelt
20.11.2023 23:00;98;47;51;Leichter Nebel;4;4;0;Stadt Konstanz, Amt fuer Stadtplanung und Umwelt
21.11.2023 00:00;47;19;28;Leichter Nebel;4;4;0;Stadt Konstanz, Amt fuer Stadtplanung und Umwelt
21.11.2023 01:00;21;11;10;Leichter Nebel;5;4;0;Stadt Konstanz, Amt fuer Stadtplanung und Umwelt
21.11.2023 02:00;6;4;2;Nieselregen;5;4;0.2;Stadt Konstanz, Amt fuer Stadtplanung und Umwelt
21.11.2023 03:00;0;0;0;Stellenweiser Regenfall;6;4;0.1;Stadt Konstanz, Amt fuer Stadtplanung und Umwelt
21.11.2023 04:00;10;5;5;Stellenweiser Regenfall;6;4;0;Stadt Konstanz, Amt fuer Stadtplanung und Umwelt
21.11.2023 05:00;59;46;13;Nieselregen;5;4;0.7;Stadt Konstanz, Amt fuer Stadtplanung und Umwelt
21.11.2023 06:00;198;105;93;Nieselregen;5;3;0.4;Stadt Konstanz, Amt fuer Stadtplanung und Umwelt
21.11.2023 07:00;1112;715;397;Leichter Nebel;5;3;0.1;Stadt Konstanz, Amt fuer Stadtplanung und Umwelt
21.11.2023 08:00;867;452;415;Leichter Nebel;6;4;0;Stadt Konstanz, Amt fuer Stadtplanung und Umwelt
21.11.2023 09:00;828;505;323;Leichter Nebel;6;4;0.1;Stadt Konstanz, Amt fuer Stadtplanung und Umwelt
21.11.2023 10:00;512;294;218;Nieselregen;6;5;0.3;Stadt Konstanz, Amt fuer Stadtplanung und Umwelt
21.11.2023 11:00;667;337;330;Nieselregen;6;5;0.2;Stadt Konstanz, Amt fuer Stadtplanung und Umwelt
21.11.2023 12:00;650;284;366;Leichter Nebel;6;5;0.1;Stadt Konstanz, Amt fuer Stadtplanung und Umwelt
21.11.2023 13:00;856;388;468;Stellenweiser Regenfall;6;5;0;Stadt Konstanz, Amt fuer Stadtplanung und Umwelt
21.11.2023 14:00;671;359;312;Stellenweiser Regenfall;7;6;0.1;Stadt Konstanz, Amt fuer Stadtplanung und Umwelt
21.11.2023 15:00;944;446;498;Nieselregen;7;6;0.4;Stadt Konstanz, Amt fuer Stadtplanung und Umwelt
21.11.2023 16:00;911;399;512;Leichter Regenschauer;6;6;0.2;Stadt Konstanz, Amt fuer Stadtplanung und Umwelt
21.11.2023 17:00;1022;443;579;Nieselregen;6;6;0.7;Stadt Konstanz, Amt fuer Stadtplanung und Umwelt
21.11.2023 18:00;770;361;409;Leichter Regenschauer;6;6;0.6;Stadt Konstanz, Amt fuer Stadtplanung und Umwelt
21.11.2023 19:00;617;313;304;Stellenweiser Regenfall;6;6;0;Stadt Konstanz, Amt fuer Stadtplanung und Umwelt
21.11.2023 20:00;342;168;174;Stellenweiser Regenfall;6;5;0.1;Stadt Konstanz, Amt fuer Stadtplanung und Umwelt
21.11.2023 21:00;297;133;164;Stellenweiser Regenfall;5;3;0;Stadt Konstanz, Amt fuer Stadtplanung und Umwelt
21.11.2023 22:00;238;82;156;Stellenweiser Regenfall;5;2;0.1;Stadt Konstanz, Amt fuer Stadtplanung und Umwelt
21.11.2023 23:00;98;40;58;Stellenweiser Regenfall;5;3;0;Stadt Konstanz, Amt fuer Stadtplanung und Umwelt
22.11.2023 00:00;52;20;32;Leichter Nebel;4;2;0;Stadt Konstanz, Amt fuer Stadtplanung und Umwelt
22.11.2023 01:00;40;24;16;Bewoelkt;4;3;0;Stadt Konstanz, Amt fuer Stadtplanung und Umwelt
22.11.2023 02:00;7;2;5;Stellenweiser Regenfall;4;2;0;Stadt Konstanz, Amt fuer Stadtplanung und Umwelt
22.11.2023 03:00;6;2;4;Stellenweiser Regenfall;4;2;0;Stadt Konstanz, Amt fuer Stadtplanung und Umwelt
22.11.2023 04:00;24;16;8;Stellenweiser Regenfall;4;2;0;Stadt Konstanz, Amt fuer Stadtplanung und Umwelt
22.11.2023 05:00;67;51;16;Stellenweiser Regenfall;5;3;0;Stadt Konstanz, Amt fuer Stadtplanung und Umwelt
22.11.2023 06:00;159;76;83;Stellenweiser Regenfall;5;3;0;Stadt Konstanz, Amt fuer Stadtplanung und Umwelt
22.11.2023 07:00;1021;637;384;Leichter Nebel;5;2;0;Stadt Konstanz, Amt fuer Stadtplanung und Umwelt
22.11.2023 08:00;869;475;394;Stellenweiser Regenfall;4;2;0;Stadt Konstanz, Amt fuer Stadtplanung und Umwelt
22.11.2023 09:00;806;473;333;Stellenweiser Regenfall;4;1;0;Stadt Konstanz, Amt fuer Stadtplanung und Umwelt
22.11.2023 10:00;389;211;178;Stellenweiser Regenfall;4;1;0;Stadt Konstanz, Amt fuer Stadtplanung und Umwelt
22.11.2023 11:00;597;291;306;Stellenweiser Regenfall;4;2;0;Stadt Konstanz, Amt fuer Stadtplanung und Umwelt
22.11.2023 12:00;635;316;319;Stellenweiser Regenfall;5;2;0;Stadt Konstanz, Amt fuer Stadtplanung und Umwelt
22.11.2023 13:00;952;476;476;Stellenweiser Regenfall;5;2;0;Stadt Konstanz, Amt fuer Stadtplanung und Umwelt
22.11.2023 14:00;673;344;329;Bedeckt;4;1;0;Stadt Konstanz, Amt fuer Stadtplanung und Umwelt
22.11.2023 15:00;922;467;455;Bedeckt;3;0;0;Stadt Konstanz, Amt fuer Stadtplanung und Umwelt
22.11.2023 16:00;881;449;432;Bedeckt;3;0;0;Stadt Konstanz, Amt fuer Stadtplanung und Umwelt
22.11.2023 17:00;1051;450;601;Bedeckt;3;1;0;Stadt Konstanz, Amt fuer Stadtplanung und Umwelt
22.11.2023 18:00;820;358;462;Bedeckt;3;1;0;Stadt Konstanz, Amt fuer Stadtplanung und Umwelt
22.11.2023 19:00;554;262;292;Bedeckt;3;1;0;Stadt Konstanz, Amt fuer Stadtplanung und Umwelt
22.11.2023 20:00;438;231;207;Bedeckt;3;2;0;Stadt Konstanz, Amt fuer Stadtplanung und Umwelt
22.11.2023 21:00;320;164;156;Leicht bewoelkt;3;2;0;Stadt Konstanz, Amt fuer Stadtplanung und Umwelt
22.11.2023 22:00;219;88;131;Leicht bewoelkt;1;0;0;Stadt Konstanz, Amt fuer Stadtplanung und Umwelt
22.11.2023 23:00;137;45;92;Sonnig;1;-1;0;Stadt Konstanz, Amt fuer Stadtplanung und Umwelt
23.11.2023 00:00;73;28;45;Sonnig;1;-1;0;Stadt Konstanz, Amt fuer Stadtplanung und Umwelt
23.11.2023 01:00;38;13;25;Sonnig;1;0;0;Stadt Konstanz, Amt fuer Stadtplanung und Umwelt
23.11.2023 02:00;21;5;16;Leicht bewoelkt;0;0;0;Stadt Konstanz, Amt fuer Stadtplanung und Umwelt
23.11.2023 03:00;10;3;7;Leicht bewoelkt;0;0;0;Stadt Konstanz, Amt fuer Stadtplanung und Umwelt
23.11.2023 04:00;16;8;8;Leicht bewoelkt;1;1;0;Stadt Konstanz, Amt fuer Stadtplanung und Umwelt
23.11.2023 05:00;62;41;21;Leicht bewoelkt;0;0;0;Stadt Konstanz, Amt fuer Stadtplanung und Umwelt
23.11.2023 06:00;202;117;85;Sonnig;-1;-1;0;Stadt Konstanz, Amt fuer Stadtplanung und Umwelt
23.11.2023 07:00;1061;665;396;Sonnig;-1;-1;0;Stadt Konstanz, Amt fuer Stadtplanung und Umwelt
23.11.2023 08:00;802;425;377;Sonnig;-1;-1;0;Stadt Konstanz, Amt fuer Stadtplanung und Umwelt
23.11.2023 09:00;725;408;317;Sonnig;1;1;0;Stadt Konstanz, Amt fuer Stadtplanung und Umwelt
23.11.2023 10:00;465;266;199;Sonnig;3;3;0;Stadt Konstanz, Amt fuer Stadtplanung und Umwelt
23.11.2023 11:00;581;280;301;Sonnig;5;4;0;Stadt Konstanz, Amt fuer Stadtplanung und Umwelt
23.11.2023 12:00;634;299;335;Sonnig;6;5;0;Stadt Konstanz, Amt fuer Stadtplanung und Umwelt
23.11.2023 13:00;865;372;493;Sonnig;6;6;0;Stadt Konstanz, Amt fuer Stadtplanung und Umwelt
23.11.2023 14:00;650;316;334;Sonnig;7;6;0;Stadt Konstanz, Amt fuer Stadtplanung und Umwelt
23.11.2023 15:00;1048;568;480;Sonnig;6;5;0;Stadt Konstanz, Amt fuer Stadtplanung und Umwelt
23.11.2023 16:00;937;475;462;Sonnig;4;3;0;Stadt Konstanz, Amt fuer Stadtplanung und Umwelt
23.11.2023 17:00;1095;471;624;Sonnig;2;1;0;Stadt Konstanz, Amt fuer Stadtplanung und Umwelt
23.11.2023 18:00;884;412;472;Sonnig;2;1;0;Stadt Konstanz, Amt fuer Stadtplanung und Umwelt
23.11.2023 19:00;638;322;316;Sonnig;1;0;0;Stadt Konstanz, Amt fuer Stadtplanung und Umwelt
23.11.2023 20:00;494;265;229;Sonnig;1;0;0;Stadt Konstanz, Amt fuer Stadtplanung und Umwelt
23.11.2023 21:00;340;164;176;Sonnig;1;-1;0;Stadt Konstanz, Amt fuer Stadtplanung und Umwelt
23.11.2023 22:00;294;115;179;Leichter Nebel;1;-1;0;Stadt Konstanz, Amt fuer Stadtplanung und Umwelt
23.11.2023 23:00;152;56;96;Leichter Nebel;0;-1;0;Stadt Konstanz, Amt fuer Stadtplanung und Umwelt
24.11.2023 00:00;92;17;75;Sonnig;0;-2;0;Stadt Konstanz, Amt fuer Stadtplanung und Umwelt
24.11.2023 01:00;75;14;61;Sonnig;0;-2;0;Stadt Konstanz, Amt fuer Stadtplanung und Umwelt
24.11.2023 02:00;58;10;48;Leicht bewoelkt;0;-2;0;Stadt Konstanz, Amt fuer Stadtplanung und Umwelt
24.11.2023 03:00;31;10;21;Bewoelkt;1;-1;0;Stadt Konstanz, Amt fuer Stadtplanung und Umwelt
24.11.2023 04:00;33;22;11;Leichter Nebel;1;-1;0;Stadt Konstanz, Amt fuer Stadtplanung und Umwelt
24.11.2023 05:00;66;46;20;Leichter Nebel;2;-1;0;Stadt Konstanz, Amt fuer Stadtplanung und Umwelt
24.11.2023 06:00;177;94;83;Stellenweiser Regenfall;4;1;0;Stadt Konstanz, Amt fuer Stadtplanung und Umwelt
24.11.2023 07:00;917;568;349;Stellenweiser Regenfall;5;1;0;Stadt Konstanz, Amt fuer Stadtplanung und Umwelt
24.11.2023 08:00;700;396;304;Stellenweiser Regenfall;6;2;0.1;Stadt Konstanz, Amt fuer Stadtplanung und Umwelt
24.11.2023 09:00;684;395;289;Stellenweiser Regenfall;6;2;0;Stadt Konstanz, Amt fuer Stadtplanung und Umwelt
24.11.2023 10:00;479;260;219;Nieselregen;6;2;0.2;Stadt Konstanz, Amt fuer Stadtplanung und Umwelt
24.11.2023 11:00;615;331;284;Stellenweiser Regenfall;6;2;0;Stadt Konstanz, Amt fuer Stadtplanung und Umwelt
24.11.2023 12:00;646;313;333;Stellenweiser Regenfall;6;2;0.1;Stadt Konstanz, Amt fuer Stadtplanung und Umwelt
24.11.2023 13:00;880;384;496;Stellenweiser Regenfall;6;2;0.1;Stadt Konstanz, Amt fuer Stadtplanung und Umwelt
24.11.2023 14:00;569;284;285;Nieselregen;6;2;0.5;Stadt Konstanz, Amt fuer Stadtplanung und Umwelt
24.11.2023 15:00;701;328;373;Nieselregen;5;2;0.6;Stadt Konstanz, Amt fuer Stadtplanung und Umwelt
24.11.2023 16:00;594;287;307;Stellenweiser Regenfall;4;0;0;Stadt Konstanz, Amt fuer Stadtplanung und Umwelt
24.11.2023 17:00;697;333;364;Sonnig;4;-1;0;Stadt Konstanz, Amt fuer Stadtplanung und Umwelt
24.11.2023 18:00;625;290;335;Stellenweiser Eisregen;2;-2;0.3;Stadt Konstanz, Amt fuer Stadtplanung und Umwelt
24.11.2023 19:00;451;244;207;Stellenweise leichter Schneefall;1;-3;0.1;Stadt Konstanz, Amt fuer Stadtplanung und Umwelt
24.11.2023 20:00;258;129;129;Bewoelkt;1;-2;0;Stadt Konstanz, Amt fuer Stadtplanung und Umwelt
24.11.2023 21:00;220;98;122;Sonnig;1;-3;0;Stadt Konstanz, Amt fuer Stadtplanung und Umwelt
24.11.2023 22:00;233;82;151;Leichter Eisregen;0;-4;0;Stadt Konstanz, Amt fuer Stadtplanung und Umwelt
24.11.2023 23:00;175;59;116;Stellenweise maeßiger Schneefall;0;-4;0.1;Stadt Konstanz, Amt fuer Stadtplanung und Umwelt
25.11.2023 00:00;135;59;76;Maeßige bis starke Schneefaelle;-1;-4;0.1;Stadt Konstanz, Amt fuer Stadtplanung und Umwelt
25.11.2023 01:00;108;32;76;Stellenweise maeßiger Schneefall;-1;-4;0.1;Stadt Konstanz, Amt fuer Stadtplanung und Umwelt
25.11.2023 02:00;73;33;40;Maeßige bis starke Schneefaelle;0;-4;0.2;Stadt Konstanz, Amt fuer Stadtplanung und Umwelt
25.11.2023 03:00;45;17;28;Stellenweise maeßiger Schneefall;0;-4;0.1;Stadt Konstanz, Amt fuer Stadtplanung und Umwelt
25.11.2023 04:00;26;10;16;Maeßige bis starke Schneefaelle;0;-4;0.2;Stadt Konstanz, Amt fuer Stadtplanung und Umwelt
25.11.2023 05:00;32;17;15;Maeßige bis starke Schneefaelle;0;-3;0.2;Stadt Konstanz, Amt fuer Stadtplanung und Umwelt
25.11.2023 06:00;38;15;23;Maeßige bis starke Schneefaelle;-2;-4;0.1;Stadt Konstanz, Amt fuer Stadtplanung und Umwelt
25.11.2023 07:00;78;45;33;Leichte Schneeschauer;-2;-3;0;Stadt Konstanz, Amt fuer Stadtplanung und Umwelt
25.11.2023 08:00;209;113;96;Leichter Schneefall;-2;-3;0.1;Stadt Konstanz, Amt fuer Stadtplanung und Umwelt
25.11.2023 09:00;349;210;139;Leichte Schneeschauer;0;-2;0;Stadt Konstanz, Amt fuer Stadtplanung und Umwelt
25.11.2023 10:00;389;240;149;Bewoelkt;1;-2;0;Stadt Konstanz, Amt fuer Stadtplanung und Umwelt
25.11.2023 11:00;471;268;203;Leichte Schneeschauer;2;-1;0;Stadt Konstanz, Amt fuer Stadtplanung und Umwelt
25.11.2023 12:00;472;242;230;Maeßige bis starke Schneefaelle;2;-1;0.2;Stadt Konstanz, Amt fuer Stadtplanung und Umwelt
25.11.2023 13:00;419;215;204;Maeßige bis starke Schneefaelle;3;-1;0.2;Stadt Konstanz, Amt fuer Stadtplanung und Umwelt
25.11.2023 14:00;525;261;264;Leichte Schneeschauer;3;-1;0.1;Stadt Konstanz, Amt fuer Stadtplanung und Umwelt
25.11.2023 15:00;449;236;213;Stellenweise leichter Schneefall;2;-2;0;Stadt Konstanz, Amt fuer Stadtplanung und Umwelt
25.11.2023 16:00;445;196;249;Stellenweiser Regenfall;1;-3;0;Stadt Konstanz, Amt fuer Stadtplanung und Umwelt
25.11.2023 17:00;458;212;246;Leichter Eisregen;1;-4;0;Stadt Konstanz, Amt fuer Stadtplanung und Umwelt
25.11.2023 18:00;374;149;225;Leichter Eisregen;1;-4;0;Stadt Konstanz, Amt fuer Stadtplanung und Umwelt
25.11.2023 19:00;322;168;154;Leichter Schneefall;1;-4;0;Stadt Konstanz, Amt fuer Stadtplanung und Umwelt
25.11.2023 20:00;234;124;110;Leichter Nebel;1;-3;0;Stadt Konstanz, Amt fuer Stadtplanung und Umwelt
25.11.2023 21:00;188;96;92;Leichter Schneefall;0;-4;0;Stadt Konstanz, Amt fuer Stadtplanung und Umwelt
25.11.2023 22:00;183;63;120;Leichter Schneefall;1;-3;0;Stadt Konstanz, Amt fuer Stadtplanung und Umwelt
25.11.2023 23:00;156;59;97;Maeßiger Schneefall;1;-4;0.1;Stadt Konstanz, Amt fuer Stadtplanung und Umwelt
26.11.2023 00:00;137;42;95;Maeßige bis starke Schneefaelle;1;-3;0.1;Stadt Konstanz, Amt fuer Stadtplanung und Umwelt
26.11.2023 01:00;93;34;59;Leichter Schneefall;0;-4;0.1;Stadt Konstanz, Amt fuer Stadtplanung und Umwelt
26.11.2023 02:00;69;25;44;Leichter Schneefall;1;-3;0.1;Stadt Konstanz, Amt fuer Stadtplanung und Umwelt
26.11.2023 03:00;53;21;32;Leichter Schneefall;1;-3;0;Stadt Konstanz, Amt fuer Stadtplanung und Umwelt
26.11.2023 04:00;34;16;18;Maeßiger Schneefall;1;-3;0.1;Stadt Konstanz, Amt fuer Stadtplanung und Umwelt
26.11.2023 05:00;32;19;13;Leichter Schneefall;1;-3;0;Stadt Konstanz, Amt fuer Stadtplanung und Umwelt
26.11.2023 06:00;26;15;11;Leichter Schneefall;1;-3;0;Stadt Konstanz, Amt fuer Stadtplanung und Umwelt
26.11.2023 07:00;41;15;26;Maeßiger Schneefall;1;-3;0.1;Stadt Konstanz, Amt fuer Stadtplanung und Umwelt
26.11.2023 08:00;83;42;41;Leichter Schneefall;1;-3;0;Stadt Konstanz, Amt fuer Stadtplanung und Umwelt
26.11.2023 09:00;196;113;83;Bedeckt;1;-2;0;Stadt Konstanz, Amt fuer Stadtplanung und Umwelt
26.11.2023 10:00;200;92;108;Bedeckt;2;-1;0;Stadt Konstanz, Amt fuer Stadtplanung und Umwelt
26.11.2023 11:00;218;111;107;Bedeckt;2;-1;0;Stadt Konstanz, Amt fuer Stadtplanung und Umwelt
26.11.2023 12:00;287;160;127;Stellenweiser Regenfall;3;0;0;Stadt Konstanz, Amt fuer Stadtplanung und Umwelt
26.11.2023 13:00;287;143;144;Stellenweiser Regenfall;3;1;0;Stadt Konstanz, Amt fuer Stadtplanung und Umwelt
26.11.2023 14:00;340;197;143;Stellenweiser Regenfall;3;1;0;Stadt Konstanz, Amt fuer Stadtplanung und Umwelt
26.11.2023 15:00;338;168;170;Stellenweiser Regenfall;3;1;0;Stadt Konstanz, Amt fuer Stadtplanung und Umwelt
26.11.2023 16:00;342;171;171;Bewoelkt;2;1;0;Stadt Konstanz, Amt fuer Stadtplanung und Umwelt
26.11.2023 17:00;325;147;178;Bewoelkt;1;0;0;Stadt Konstanz, Amt fuer Stadtplanung und Umwelt
26.11.2023 18:00;232;101;131;Bedeckt;1;0;0;Stadt Konstanz, Amt fuer Stadtplanung und Umwelt
26.11.2023 19:00;201;93;108;Bedeckt;1;0;0;Stadt Konstanz, Amt fuer Stadtplanung und Umwelt
26.11.2023 20:00;172;78;94;Bedeckt;0;0;0;Stadt Konstanz, Amt fuer Stadtplanung und Umwelt
26.11.2023 21:00;103;37;66;Bedeckt;1;1;0;Stadt Konstanz, Amt fuer Stadtplanung und Umwelt
26.11.2023 22:00;114;42;72;Bedeckt;1;1;0;Stadt Konstanz, Amt fuer Stadtplanung und Umwelt
26.11.2023 23:00;64;28;36;Bedeckt;0;0;0;Stadt Konstanz, Amt fuer Stadtplanung und Umwelt
27.11.2023 00:00;26;11;15;Bedeckt;0;0;0;Stadt Konstanz, Amt fuer Stadtplanung und Umwelt
27.11.2023 01:00;18;10;8;Leicht bewoelkt;-1;-1;0;Stadt Konstanz, Amt fuer Stadtplanung und Umwelt
27.11.2023 02:00;3;1;2;Leichter Nebel;-1;-1;0;Stadt Konstanz, Amt fuer Stadtplanung und Umwelt
27.11.2023 03:00;2;1;1;Bedeckt;-1;-1;0;Stadt Konstanz, Amt fuer Stadtplanung und Umwelt
27.11.2023 04:00;12;2;10;Leichter Nebel;-1;-2;0;Stadt Konstanz, Amt fuer Stadtplanung und Umwelt
27.11.2023 05:00;58;36;22;Bedeckt;-1;-1;0;Stadt Konstanz, Amt fuer Stadtplanung und Umwelt
27.11.2023 06:00;211;104;107;Leichter Eisregen;-1;-1;0;Stadt Konstanz, Amt fuer Stadtplanung und Umwelt
27.11.2023 07:00;956;588;368;Leichter Schneefall;-1;-2;0;Stadt Konstanz, Amt fuer Stadtplanung und Umwelt
27.11.2023 08:00;755;390;365;Bewoelkt;-1;-2;0;Stadt Konstanz, Amt fuer Stadtplanung und Umwelt
27.11.2023 09:00;727;433;294;Bedeckt;1;-1;0;Stadt Konstanz, Amt fuer Stadtplanung und Umwelt
27.11.2023 10:00;404;212;192;Bedeckt;2;0;0;Stadt Konstanz, Amt fuer Stadtplanung und Umwelt
27.11.2023 11:00;602;302;300;Bedeckt;2;-1;0;Stadt Konstanz, Amt fuer Stadtplanung und Umwelt
27.11.2023 12:00;577;275;302;Leichter Schneefall;3;0;0;Stadt Konstanz, Amt fuer Stadtplanung und Umwelt
27.11.2023 13:00;828;365;463;Bedeckt;3;0;0;Stadt Konstanz, Amt fuer Stadtplanung und Umwelt
27.11.2023 14:00;556;277;279;Stellenweiser Regenfall;3;1;0;Stadt Konstanz, Amt fuer Stadtplanung und Umwelt
27.11.2023 15:00;893;444;449;Leichter Eisregen;4;0;0.2;Stadt Konstanz, Amt fuer Stadtplanung und Umwelt
27.11.2023 16:00;793;368;425;Stellenweiser Regenfall;4;0;0.1;Stadt Konstanz, Amt fuer Stadtplanung und Umwelt
27.11.2023 17:00;956;430;526;Leichter Eisregen;3;-1;0.3;Stadt Konstanz, Amt fuer Stadtplanung und Umwelt
27.11.2023 18:00;714;329;385;Leichter Eisregen;3;-1;0.6;Stadt Konstanz, Amt fuer Stadtplanung und Umwelt
27.11.2023 19:00;546;255;291;Starker Schneefall;2;-2;1.1;Stadt Konstanz, Amt fuer Stadtplanung und Umwelt
27.11.2023 20:00;307;145;162;Starker Schneefall;2;-2;1.3;Stadt Konstanz, Amt fuer Stadtplanung und Umwelt
27.11.2023 21:00;196;88;108;Starker Schneefall;2;-2;1.2;Stadt Konstanz, Amt fuer Stadtplanung und Umwelt
27.11.2023 22:00;179;75;104;Starker Schneefall;2;-2;0.8;Stadt Konstanz, Amt fuer Stadtplanung und Umwelt
27.11.2023 23:00;65;32;33;Leichter Eisregen;3;-2;0.9;Stadt Konstanz, Amt fuer Stadtplanung und Umwelt
28.11.2023 00:00;37;13;24;Leichter Eisregen;3;-1;0.8;Stadt Konstanz, Amt fuer Stadtplanung und Umwelt
28.11.2023 01:00;8;3;5;Leichter Eisregen;3;-1;0.7;Stadt Konstanz, Amt fuer Stadtplanung und Umwelt
28.11.2023 02:00;4;2;2;Leichter Eisregen;3;-1;0.2;Stadt Konstanz, Amt fuer Stadtplanung und Umwelt
28.11.2023 03:00;4;1;3;Leichter Eisregen;3;-1;0.5;Stadt Konstanz, Amt fuer Stadtplanung und Umwelt
28.11.2023 04:00;8;1;7;Nieselregen;4;-1;0.3;Stadt Konstanz, Amt fuer Stadtplanung und Umwelt
28.11.2023 05:00;57;42;15;Leichter Regenfall;4;0;1.3;Stadt Konstanz, Amt fuer Stadtplanung und Umwelt
28.11.2023 06:00;186;97;89;Nieselregen;4;0;0.6;Stadt Konstanz, Amt fuer Stadtplanung und Umwelt
28.11.2023 07:00;965;608;357;Nieselregen;4;0;0.2;Stadt Konstanz, Amt fuer Stadtplanung und Umwelt
28.11.2023 08:00;701;370;331;Leichter Eisregen;3;-1;0.2;Stadt Konstanz, Amt fuer Stadtplanung und Umwelt
28.11.2023 09:00;663;422;241;Starker Schneefall;3;-2;0.5;Stadt Konstanz, Amt fuer Stadtplanung und Umwelt
28.11.2023 10:00;332;188;144;Maeßiger Schneefall;3;-2;0.2;Stadt Konstanz, Amt fuer Stadtplanung und Umwelt
28.11.2023 11:00;450;206;244;Leichte Schneeschauer;3;-1;0.1;Stadt Konstanz, Amt fuer Stadtplanung und Umwelt
28.11.2023 12:00;526;245;281;Maeßige bis starke Schneefaelle;3;-1;0.1;Stadt Konstanz, Amt fuer Stadtplanung und Umwelt
28.11.2023 13:00;747;351;396;Maeßige bis starke Schneefaelle;3;-1;0.1;Stadt Konstanz, Amt fuer Stadtplanung und Umwelt
28.11.2023 14:00;517;264;253;Maeßige bis starke Schneefaelle;3;-1;0.1;Stadt Konstanz, Amt fuer Stadtplanung und Umwelt
28.11.2023 15:00;805;403;402;Maeßige bis starke Schneefaelle;2;-1;0.1;Stadt Konstanz, Amt fuer Stadtplanung und Umwelt
28.11.2023 16:00;768;356;412;Maeßige bis starke Schneefaelle;2;-2;0.1;Stadt Konstanz, Amt fuer Stadtplanung und Umwelt
28.11.2023 17:00;904;440;464;Leichte Schneeschauer;0;-2;0.1;Stadt Konstanz, Amt fuer Stadtplanung und Umwelt
28.11.2023 18:00;708;309;399;Leichte Schneeschauer;0;-2;0;Stadt Konstanz, Amt fuer Stadtplanung und Umwelt
28.11.2023 19:00;586;273;313;Leichte Schneeschauer;-1;-2;0;Stadt Konstanz, Amt fuer Stadtplanung und Umwelt
28.11.2023 20:00;373;190;183;Leichter Schneefall;-1;-1;0.1;Stadt Konstanz, Amt fuer Stadtplanung und Umwelt
28.11.2023 21:00;277;131;146;Leichter Schneefall;-1;-1;0.1;Stadt Konstanz, Amt fuer Stadtplanung und Umwelt
28.11.2023 22:00;196;81;115;Leichter Schneefall;-1;-2;0;Stadt Konstanz, Amt fuer Stadtplanung und Umwelt
28.11.2023 23:00;155;70;85;Leichter Schneefall;-1;-1;0;Stadt Konstanz, Amt fuer Stadtplanung und Umwelt
29.11.2023 00:00;65;24;41;Leichte Schneeschauer;-2;-2;0;Stadt Konstanz, Amt fuer Stadtplanung und Umwelt
29.11.2023 01:00;27;13;14;Eisnebel;-3;-3;0;Stadt Konstanz, Amt fuer Stadtplanung und Umwelt
29.11.2023 02:00;8;4;4;Leichter Nebel;-2;-4;0;Stadt Konstanz, Amt fuer Stadtplanung und Umwelt
29.11.2023 03:00;5;2;3;Leichter Eisregen;-2;-5;0;Stadt Konstanz, Amt fuer Stadtplanung und Umwelt
29.11.2023 04:00;9;4;5;Leichter Eisregen;-2;-5;0;Stadt Konstanz, Amt fuer Stadtplanung und Umwelt
29.11.2023 05:00;57;40;17;Leichter Eisregen;-2;-6;0;Stadt Konstanz, Amt fuer Stadtplanung und Umwelt
29.11.2023 06:00;175;92;83;Leichter Eisregen;-2;-6;0;Stadt Konstanz, Amt fuer Stadtplanung und Umwelt
29.11.2023 07:00;990;605;385;Leichter Eisregen;-2;-6;0;Stadt Konstanz, Amt fuer Stadtplanung und Umwelt
29.11.2023 08:00;837;459;378;Leicht bewoelkt;-2;-6;0;Stadt Konstanz, Amt fuer Stadtplanung und Umwelt
29.11.2023 09:00;700;400;300;Leicht bewoelkt;-1;-5;0;Stadt Konstanz, Amt fuer Stadtplanung und Umwelt
29.11.2023 10:00;401;213;188;Sonnig;0;-3;0;Stadt Konstanz, Amt fuer Stadtplanung und Umwelt
29.11.2023 11:00;633;309;324;Sonnig;1;-3;0;Stadt Konstanz, Amt fuer Stadtplanung und Umwelt
29.11.2023 12:00;709;311;398;Sonnig;1;-2;0;Stadt Konstanz, Amt fuer Stadtplanung und Umwelt
29.11.2023 13:00;896;466;430;Sonnig;2;-1;0;Stadt Konstanz, Amt fuer Stadtplanung und Umwelt
29.11.2023 14:00;674;341;333;Sonnig;2;-1;0;Stadt Konstanz, Amt fuer Stadtplanung und Umwelt
29.11.2023 15:00;904;419;485;Sonnig;2;0;0;Stadt Konstanz, Amt fuer Stadtplanung und Umwelt
29.11.2023 16:00;863;424;439;Sonnig;-1;-2;0;Stadt Konstanz, Amt fuer Stadtplanung und Umwelt
29.11.2023 17:00;1039;473;566;Bedeckt;-2;-3;0;Stadt Konstanz, Amt fuer Stadtplanung und Umwelt
29.11.2023 18:00;827;355;472;Bedeckt;-3;-3;0;Stadt Konstanz, Amt fuer Stadtplanung und Umwelt
29.11.2023 19:00;563;279;284;Sonnig;-3;-3;0;Stadt Konstanz, Amt fuer Stadtplanung und Umwelt
29.11.2023 20:00;413;204;209;Sonnig;-3;-3;0;Stadt Konstanz, Amt fuer Stadtplanung und Umwelt
29.11.2023 21:00;257;107;150;Sonnig;-3;-3;0;Stadt Konstanz, Amt fuer Stadtplanung und Umwelt
29.11.2023 22:00;277;130;147;Leicht bewoelkt;-3;-4;0;Stadt Konstanz, Amt fuer Stadtplanung und Umwelt
29.11.2023 23:00;147;45;102;Bedeckt;-3;-3;0;Stadt Konstanz, Amt fuer Stadtplanung und Umwelt
30.11.2023 00:00;58;17;41;Bedeckt;0;-1;0;Stadt Konstanz, Amt fuer Stadtplanung und Umwelt
30.11.2023 01:00;45;12;33;Bedeckt;0;-1;0;Stadt Konstanz, Amt fuer Stadtplanung und Umwelt
30.11.2023 02:00;25;8;17;Leichter Eisregen;-1;-1;0;Stadt Konstanz, Amt fuer Stadtplanung und Umwelt
30.11.2023 03:00;4;0;4;Starker Schneefall;-1;-1;0.4;Stadt Konstanz, Amt fuer Stadtplanung und Umwelt
30.11.2023 04:00;19;5;14;Starker Schneefall;-1;-2;0.3;Stadt Konstanz, Amt fuer Stadtplanung und Umwelt
30.11.2023 05:00;66;43;23;Starker Schneefall;-1;-2;0.6;Stadt Konstanz, Amt fuer Stadtplanung und Umwelt
30.11.2023 06:00;170;90;80;Starker Schneefall;-1;-2;1;Stadt Konstanz, Amt fuer Stadtplanung und Umwelt
30.11.2023 07:00;875;508;367;Starker Schneefall;-1;-3;1.1;Stadt Konstanz, Amt fuer Stadtplanung und Umwelt
30.11.2023 08:00;611;337;274;Starker Schneefall;-1;-3;2.5;Stadt Konstanz, Amt fuer Stadtplanung und Umwelt
30.11.2023 09:00;562;328;234;Starker Schneefall;-1;-1;2.1;Stadt Konstanz, Amt fuer Stadtplanung und Umwelt
30.11.2023 10:00;292;162;130;Starker Schneefall;-1;-3;2.3;Stadt Konstanz, Amt fuer Stadtplanung und Umwelt
30.11.2023 11:00;347;190;157;Starker Schneefall;-1;-1;2.5;Stadt Konstanz, Amt fuer Stadtplanung und Umwelt
30.11.2023 12:00;368;152;216;Starker Schneefall;-1;-1;1.5;Stadt Konstanz, Amt fuer Stadtplanung und Umwelt
30.11.2023 13:00;555;220;335;Maeßiger bis starker gefrierender Regen;-1;-1;0.3;Stadt Konstanz, Amt fuer Stadtplanung und Umwelt
30.11.2023 14:00;387;187;200;Maeßiger bis starker gefrierender Regen;-1;-1;0.5;Stadt Konstanz, Amt fuer Stadtplanung und Umwelt
30.11.2023 15:00;577;257;320;Maeßiger bis starker gefrierender Regen;0;0;1.1;Stadt Konstanz, Amt fuer Stadtplanung und Umwelt
30.11.2023 16:00;537;280;257;Maeßiger bis starker gefrierender Regen;0;0;0.8;Stadt Konstanz, Amt fuer Stadtplanung und Umwelt
30.11.2023 17:00;691;349;342;Leichter Eisregen;0;0;1.3;Stadt Konstanz, Amt fuer Stadtplanung und Umwelt
30.11.2023 18:00;456;212;244;Leichter Eisregen;1;1;0.4;Stadt Konstanz, Amt fuer Stadtplanung und Umwelt
30.11.2023 19:00;357;173;184;Leichter Eisregen;1;1;0.3;Stadt Konstanz, Amt fuer Stadtplanung und Umwelt
30.11.2023 20:00;242;111;131;Nieselregen;1;1;0.5;Stadt Konstanz, Amt fuer Stadtplanung und Umwelt
30.11.2023 21:00;208;81;127;Leichter Regenfall;1;1;0.9;Stadt Konstanz, Amt fuer Stadtplanung und Umwelt
30.11.2023 22:00;166;63;103;Nieselregen;1;1;0.6;Stadt Konstanz, Amt fuer Stadtplanung und Umwelt
30.11.2023 23:00;109;31;78;Nieselregen;1;1;0.2;Stadt Konstanz, Amt fuer Stadtplanung und Umwelt
01.12.2023 00:00;56;11;45;Nieselregen;1;1;0.6;Stadt Konstanz, Amt fuer Stadtplanung und Umwelt
01.12.2023 01:00;43;15;28;Nieselregen;1;1;0.4;Stadt Konstanz, Amt fuer Stadtplanung und Umwelt
01.12.2023 02:00;19;12;7;Leichter Regenfall;1;1;1.3;Stadt Konstanz, Amt fuer Stadtplanung und Umwelt
01.12.2023 03:00;24;18;6;Nieselregen;1;1;0.6;Stadt Konstanz, Amt fuer Stadtplanung und Umwelt
01.12.2023 04:00;18;9;9;Nieselregen;1;1;0.3;Stadt Konstanz, Amt fuer Stadtplanung und Umwelt
01.12.2023 05:00;37;22;15;Nieselregen;2;2;0.3;Stadt Konstanz, Amt fuer Stadtplanung und Umwelt
01.12.2023 06:00;123;60;63;Nieselregen;2;1;0.4;Stadt Konstanz, Amt fuer Stadtplanung und Umwelt
01.12.2023 07:00;679;416;263;Nieselregen;2;2;0.6;Stadt Konstanz, Amt fuer Stadtplanung und Umwelt
01.12.2023 08:00;515;272;243;Leichter Eisregen;2;2;0.6;Stadt Konstanz, Amt fuer Stadtplanung und Umwelt
01.12.2023 09:00;467;274;193;Leichter Eisregen;2;2;1.2;Stadt Konstanz, Amt fuer Stadtplanung und Umwelt
01.12.2023 10:00;265;140;125;Leichter Eisregen;2;2;1.2;Stadt Konstanz, Amt fuer Stadtplanung und Umwelt
01.12.2023 11:00;422;212;210;Leichter Eisregen;2;2;1.4;Stadt Konstanz, Amt fuer Stadtplanung und Umwelt
01.12.2023 12:00;526;262;264;Leichter Eisregen;3;3;1.2;Stadt Konstanz, Amt fuer Stadtplanung und Umwelt
01.12.2023 13:00;611;223;388;Leichter Eisregen;3;3;1.1;Stadt Konstanz, Amt fuer Stadtplanung und Umwelt
01.12.2023 14:00;441;201;240;Leichter Eisregen;2;2;0.9;Stadt Konstanz, Amt fuer Stadtplanung und Umwelt
01.12.2023 15:00;435;196;239;Starker Schneefall;2;1;1.1;Stadt Konstanz, Amt fuer Stadtplanung und Umwelt
01.12.2023 16:00;339;147;192;Starker Schneefall;1;0;1.7;Stadt Konstanz, Amt fuer Stadtplanung und Umwelt
01.12.2023 17:00;399;191;208;Starker Schneefall;1;1;1.9;Stadt Konstanz, Amt fuer Stadtplanung und Umwelt
01.12.2023 18:00;319;163;156;Starker Schneefall;0;-1;1.6;Stadt Konstanz, Amt fuer Stadtplanung und Umwelt
01.12.2023 19:00;215;127;88;Starker Schneefall;0;0;1.6;Stadt Konstanz, Amt fuer Stadtplanung und Umwelt
01.12.2023 20:00;136;72;64;Starker Schneefall;0;0;1.2;Stadt Konstanz, Amt fuer Stadtplanung und Umwelt
01.12.2023 21:00;129;61;68;Starker Schneefall;0;-1;1.2;Stadt Konstanz, Amt fuer Stadtplanung und Umwelt
01.12.2023 22:00;128;46;82;Starker Schneefall;0;0;1.1;Stadt Konstanz, Amt fuer Stadtplanung und Umwelt
01.12.2023 23:00;73;22;51;Starker Schneefall;0;-1;2;Stadt Konstanz, Amt fuer Stadtplanung und Umwelt
02.12.2023 00:00;62;21;41;Starker Schneefall;0;-1;1.5;Stadt Konstanz, Amt fuer Stadtplanung und Umwelt
02.12.2023 01:00;37;11;26;Starker Schneefall;0;0;0.8;Stadt Konstanz, Amt fuer Stadtplanung und Umwelt
02.12.2023 02:00;38;15;23;Starker Schneefall;0;0;0.9;Stadt Konstanz, Amt fuer Stadtplanung und Umwelt
02.12.2023 03:00;12;4;8;Starker Schneefall;0;0;0.9;Stadt Konstanz, Amt fuer Stadtplanung und Umwelt
02.12.2023 04:00;8;4;4;Starker Schneefall;0;-2;1.2;Stadt Konstanz, Amt fuer Stadtplanung und Umwelt
02.12.2023 05:00;23;13;10;Starker Schneefall;0;-3;1.2;Stadt Konstanz, Amt fuer Stadtplanung und Umwelt
02.12.2023 06:00;28;10;18;Starker Schneefall;-1;-3;1;Stadt Konstanz, Amt fuer Stadtplanung und Umwelt
02.12.2023 07:00;44;21;23;Starker Schneefall;-1;-3;0.9;Stadt Konstanz, Amt fuer Stadtplanung und Umwelt
02.12.2023 08:00;72;37;35;Starker Schneefall;-2;-3;0.8;Stadt Konstanz, Amt fuer Stadtplanung und Umwelt
02.12.2023 09:00;140;85;55;Starker Schneefall;-2;-5;0.6;Stadt Konstanz, Amt fuer Stadtplanung und Umwelt
02.12.2023 10:00;106;60;46;Starker Schneefall;-2;-4;0.5;Stadt Konstanz, Amt fuer Stadtplanung und Umwelt
02.12.2023 11:00;138;86;52;Starker Schneefall;-2;-4;0.7;Stadt Konstanz, Amt fuer Stadtplanung und Umwelt
02.12.2023 12:00;141;65;76;Maeßiger Schneefall;-2;-4;0.2;Stadt Konstanz, Amt fuer Stadtplanung und Umwelt
02.12.2023 13:00;127;58;69;Maeßiger Schneefall;-1;-4;0.2;Stadt Konstanz, Amt fuer Stadtplanung und Umwelt
02.12.2023 14:00;181;98;83;Maeßiger Schneefall;-1;-3;0.2;Stadt Konstanz, Amt fuer Stadtplanung und Umwelt
02.12.2023 15:00;128;80;48;Stellenweise maeßiger Schneefall;-1;-3;0.2;Stadt Konstanz, Amt fuer Stadtplanung und Umwelt
02.12.2023 16:00;129;69;60;Leichter Schneefall;-2;-2;0.1;Stadt Konstanz, Amt fuer Stadtplanung und Umwelt
02.12.2023 17:00;149;68;81;Maeßiger Schneefall;-5;-7;0.1;Stadt Konstanz, Amt fuer Stadtplanung und Umwelt
02.12.2023 18:00;124;60;64;Maeßige bis starke Schneefaelle;-6;-9;0.1;Stadt Konstanz, Amt fuer Stadtplanung und Umwelt
02.12.2023 19:00;107;55;52;Stellenweise leichter Schneefall;-9;-12;0;Stadt Konstanz, Amt fuer Stadtplanung und Umwelt
02.12.2023 20:00;88;38;50;Stellenweise leichter Schneefall;-12;-15;0;Stadt Konstanz, Amt fuer Stadtplanung und Umwelt
02.12.2023 21:00;82;37;45;Stellenweise leichter Schneefall;-14;-17;0;Stadt Konstanz, Amt fuer Stadtplanung und Umwelt
02.12.2023 22:00;70;25;45;Stellenweise leichter Schneefall;-15;-19;0;Stadt Konstanz, Amt fuer Stadtplanung und Umwelt
02.12.2023 23:00;61;26;35;Stellenweise leichter Schneefall;-16;-20;0;Stadt Konstanz, Amt fuer Stadtplanung und Umwelt
03.12.2023 00:00;39;18;21;Eisnebel;-15;-19;0;Stadt Konstanz, Amt fuer Stadtplanung und Umwelt
03.12.2023 01:00;31;14;17;Eisnebel;-16;-20;0;Stadt Konstanz, Amt fuer Stadtplanung und Umwelt
03.12.2023 02:00;26;7;19;Eisnebel;-16;-20;0;Stadt Konstanz, Amt fuer Stadtplanung und Umwelt
03.12.2023 03:00;10;2;8;Eisnebel;-17;-20;0;Stadt Konstanz, Amt fuer Stadtplanung und Umwelt
03.12.2023 04:00;10;6;4;Eisnebel;-17;-20;0;Stadt Konstanz, Amt fuer Stadtplanung und Umwelt
03.12.2023 05:00;19;5;14;Eisnebel;-18;-20;0;Stadt Konstanz, Amt fuer Stadtplanung und Umwelt
03.12.2023 06:00;19;11;8;Eisnebel;-17;-19;0;Stadt Konstanz, Amt fuer Stadtplanung und Umwelt
03.12.2023 07:00;27;16;11;Eisnebel;-16;-16;0;Stadt Konstanz, Amt fuer Stadtplanung und Umwelt
03.12.2023 08:00;30;12;18;Leichter Schneefall;-14;-14;0;Stadt Konstanz, Amt fuer Stadtplanung und Umwelt
03.12.2023 09:00;46;27;19;Leichter Schneefall;-11;-11;0;Stadt Konstanz, Amt fuer Stadtplanung und Umwelt
03.12.2023 10:00;71;37;34;Leichter Schneefall;-9;-9;0;Stadt Konstanz, Amt fuer Stadtplanung und Umwelt
03.12.2023 11:00;75;46;29;Leichter Nebel;-6;-6;0;Stadt Konstanz, Amt fuer Stadtplanung und Umwelt
03.12.2023 12:00;100;49;51;Leichter Eisregen;-5;-5;0;Stadt Konstanz, Amt fuer Stadtplanung und Umwelt
03.12.2023 13:00;81;33;48;Leichter Eisregen;-5;-5;0;Stadt Konstanz, Amt fuer Stadtplanung und Umwelt
03.12.2023 14:00;104;48;56;Bewoelkt;-4;-4;0;Stadt Konstanz, Amt fuer Stadtplanung und Umwelt
03.12.2023 15:00;134;69;65;Leicht bewoelkt;-4;-4;0;Stadt Konstanz, Amt fuer Stadtplanung und Umwelt
03.12.2023 16:00;106;50;56;Eisnebel;-9;-9;0;Stadt Konstanz, Amt fuer Stadtplanung und Umwelt
03.12.2023 17:00;120;65;55;Eisnebel;-12;-14;0;Stadt Konstanz, Amt fuer Stadtplanung und Umwelt
03.12.2023 18:00;109;60;49;Eisnebel;-13;-17;0;Stadt Konstanz, Amt fuer Stadtplanung und Umwelt
03.12.2023 19:00;76;40;36;Eisnebel;-14;-18;0;Stadt Konstanz, Amt fuer Stadtplanung und Umwelt
03.12.2023 20:00;74;44;30;Eisnebel;-16;-19;0;Stadt Konstanz, Amt fuer Stadtplanung und Umwelt
03.12.2023 21:00;47;21;26;Eisnebel;-17;-20;0;Stadt Konstanz, Amt fuer Stadtplanung und Umwelt
03.12.2023 22:00;45;17;28;Eisnebel;-17;-20;0;Stadt Konstanz, Amt fuer Stadtplanung und Umwelt
03.12.2023 23:00;23;7;16;Eisnebel;-16;-19;0;Stadt Konstanz, Amt fuer Stadtplanung und Umwelt
04.12.2023 00:00;12;7;5;Eisnebel;-12;-15;0;Stadt Konstanz, Amt fuer Stadtplanung und Umwelt
04.12.2023 01:00;6;2;4;Eisnebel;-12;-12;0;Stadt Konstanz, Amt fuer Stadtplanung und Umwelt
04.12.2023 02:00;1;0;1;Eisnebel;-12;-12;0;Stadt Konstanz, Amt fuer Stadtplanung und Umwelt
04.12.2023 03:00;1;0;1;Eisnebel;-12;-13;0;Stadt Konstanz, Amt fuer Stadtplanung und Umwelt
04.12.2023 04:00;6;3;3;Bedeckt;-12;-12;0;Stadt Konstanz, Amt fuer Stadtplanung und Umwelt
04.12.2023 05:00;37;22;15;Eisnebel;-12;-12;0;Stadt Konstanz, Amt fuer Stadtplanung und Umwelt
04.12.2023 06:00;100;51;49;Leichter Nebel;-10;-10;0;Stadt Konstanz, Amt fuer Stadtplanung und Umwelt
04.12.2023 07:00;433;260;173;Bedeckt;-10;-10;0;Stadt Konstanz, Amt fuer Stadtplanung und Umwelt
04.12.2023 08:00;401;243;158;Leichter Schneefall;-10;-10;0;Stadt Konstanz, Amt fuer Stadtplanung und Umwelt
04.12.2023 09:00;382;262;120;Leichter Schneefall;-9;-9;0;Stadt Konstanz, Amt fuer Stadtplanung und Umwelt
04.12.2023 10:00;179;106;73;Leichter Schneefall;-7;-7;0;Stadt Konstanz, Amt fuer Stadtplanung und Umwelt
04.12.2023 11:00;215;99;116;Bedeckt;-6;-6;0;Stadt Konstanz, Amt fuer Stadtplanung und Umwelt
04.12.2023 12:00;278;134;144;Bedeckt;-4;-4;0;Stadt Konstanz, Amt fuer Stadtplanung und Umwelt
04.12.2023 13:00;420;198;222;Bewoelkt;-3;-3;0;Stadt Konstanz, Amt fuer Stadtplanung und Umwelt
04.12.2023 14:00;126;68;58;Bedeckt;-2;-2;0;Stadt Konstanz, Amt fuer Stadtplanung und Umwelt
04.12.2023 15:00;40;27;13;Leichter Schneefall;-3;-3;0;Stadt Konstanz, Amt fuer Stadtplanung und Umwelt
04.12.2023 16:00;237;123;114;Maeßiger Schneefall;-3;-3;0.1;Stadt Konstanz, Amt fuer Stadtplanung und Umwelt
04.12.2023 17:00;450;209;241;Maeßiger Schneefall;-4;-4;0.1;Stadt Konstanz, Amt fuer Stadtplanung und Umwelt
04.12.2023 18:00;343;143;200;Leichter Schneefall;-4;-4;0;Stadt Konstanz, Amt fuer Stadtplanung und Umwelt
04.12.2023 19:00;288;127;161;Leichter Schneefall;-5;-5;0;Stadt Konstanz, Amt fuer Stadtplanung und Umwelt
04.12.2023 20:00;222;100;122;Leichter Schneefall;-5;-5;0.1;Stadt Konstanz, Amt fuer Stadtplanung und Umwelt
04.12.2023 21:00;123;43;80;Eisnebel;-5;-5;0;Stadt Konstanz, Amt fuer Stadtplanung und Umwelt
04.12.2023 22:00;110;49;61;Eisnebel;-6;-8;0;Stadt Konstanz, Amt fuer Stadtplanung und Umwelt
04.12.2023 23:00;36;24;12;Eisnebel;-6;-8;0;Stadt Konstanz, Amt fuer Stadtplanung und Umwelt
05.12.2023 00:00;7;2;5;Leichter Nebel;-7;-10;0;Stadt Konstanz, Amt fuer Stadtplanung und Umwelt
05.12.2023 01:00;7;3;4;Maeßiger Schneefall;-5;-8;0.1;Stadt Konstanz, Amt fuer Stadtplanung und Umwelt
05.12.2023 02:00;0;0;0;Stellenweise starker Schneefall;-4;-6;0.3;Stadt Konstanz, Amt fuer Stadtplanung und Umwelt
05.12.2023 03:00;2;1;1;Stellenweise starker Schneefall;-3;-5;0.5;Stadt Konstanz, Amt fuer Stadtplanung und Umwelt
05.12.2023 04:00;7;2;5;Maeßiger bis starker gefrierender Regen;-2;-5;0.4;Stadt Konstanz, Amt fuer Stadtplanung und Umwelt
05.12.2023 05:00;42;29;13;Maeßiger Schneefall;-1;-4;0.1;Stadt Konstanz, Amt fuer Stadtplanung und Umwelt
05.12.2023 06:00;130;70;60;Starker Nieselregen;-1;-3;0.1;Stadt Konstanz, Amt fuer Stadtplanung und Umwelt
05.12.2023 07:00;572;342;230;Leichter Schneefall;0;-1;0;Stadt Konstanz, Amt fuer Stadtplanung und Umwelt
05.12.2023 08:00;492;286;206;Leichter Schneefall;0;-2;0;Stadt Konstanz, Amt fuer Stadtplanung und Umwelt
05.12.2023 09:00;5;4;1;Maeßiger Schneefall;1;-2;0.2;Stadt Konstanz, Amt fuer Stadtplanung und Umwelt
05.12.2023 10:00;0;0;0;Leichter Schneefall;1;-1;0;Stadt Konstanz, Amt fuer Stadtplanung und Umwelt
05.12.2023 11:00;0;0;0;Leichter Nebel;2;-1;0;Stadt Konstanz, Amt fuer Stadtplanung und Umwelt
05.12.2023 12:00;0;0;0;Bedeckt;2;-1;0;Stadt Konstanz, Amt fuer Stadtplanung und Umwelt
05.12.2023 13:00;47;39;8;Bedeckt;2;-1;0;Stadt Konstanz, Amt fuer Stadtplanung und Umwelt
05.12.2023 14:00;14;10;4;Bedeckt;2;-1;0;Stadt Konstanz, Amt fuer Stadtplanung und Umwelt
05.12.2023 15:00;213;104;109;Bedeckt;2;-1;0;Stadt Konstanz, Amt fuer Stadtplanung und Umwelt
05.12.2023 16:00;589;253;336;Bedeckt;2;-2;0;Stadt Konstanz, Amt fuer Stadtplanung und Umwelt
05.12.2023 17:00;701;319;382;Sonnig;2;-2;0;Stadt Konstanz, Amt fuer Stadtplanung und Umwelt
05.12.2023 18:00;542;224;318;Bewoelkt;1;-3;0;Stadt Konstanz, Amt fuer Stadtplanung und Umwelt
05.12.2023 19:00;447;214;233;Leicht bewoelkt;1;-3;0;Stadt Konstanz, Amt fuer Stadtplanung und Umwelt
05.12.2023 20:00;272;120;152;Leicht bewoelkt;1;-3;0;Stadt Konstanz, Amt fuer Stadtplanung und Umwelt
05.12.2023 21:00;225;80;145;Bewoelkt;1;-3;0;Stadt Konstanz, Amt fuer Stadtplanung und Umwelt
05.12.2023 22:00;160;51;109;Bewoelkt;1;-3;0;Stadt Konstanz, Amt fuer Stadtplanung und Umwelt
05.12.2023 23:00;76;33;43;Bedeckt;1;-3;0;Stadt Konstanz, Amt fuer Stadtplanung und Umwelt
06.12.2023 00:00;19;8;11;Bedeckt;1;-2;0;Stadt Konstanz, Amt fuer Stadtplanung und Umwelt
06.12.2023 01:00;18;11;7;Bewoelkt;1;-2;0;Stadt Konstanz, Amt fuer Stadtplanung und Umwelt
06.12.2023 02:00;3;1;2;Bewoelkt;1;-2;0;Stadt Konstanz, Amt fuer Stadtplanung und Umwelt
06.12.2023 03:00;4;0;4;Bedeckt;2;-2;0;Stadt Konstanz, Amt fuer Stadtplanung und Umwelt
06.12.2023 04:00;7;2;5;Stellenweiser Regenfall;1;-3;0;Stadt Konstanz, Amt fuer Stadtplanung und Umwelt
06.12.2023 05:00;42;29;13;Maeßiger Schneefall;1;-3;0.1;Stadt Konstanz, Amt fuer Stadtplanung und Umwelt
06.12.2023 06:00;150;79;71;Maeßiger Schneefall;1;-3;0.2;Stadt Konstanz, Amt fuer Stadtplanung und Umwelt
06.12.2023 07:00;812;484;328;Maeßiger Schneefall;1;-3;0.2;Stadt Konstanz, Amt fuer Stadtplanung und Umwelt
06.12.2023 08:00;681;394;287;Maeßiger Schneefall;1;-3;0.1;Stadt Konstanz, Amt fuer Stadtplanung und Umwelt
06.12.2023 09:00;599;347;252;Maeßiger Schneefall;1;-2;0.1;Stadt Konstanz, Amt fuer Stadtplanung und Umwelt
06.12.2023 10:00;365;201;164;Maeßiger Schneefall;1;-2;0.1;Stadt Konstanz, Amt fuer Stadtplanung und Umwelt
06.12.2023 11:00;458;223;235;Maeßiger Schneefall;2;-2;0.1;Stadt Konstanz, Amt fuer Stadtplanung und Umwelt
06.12.2023 12:00;506;219;287;Maeßiger Schneefall;2;-1;0.1;Stadt Konstanz, Amt fuer Stadtplanung und Umwelt
06.12.2023 13:00;800;417;383;Leichter Schneefall;2;-1;0.1;Stadt Konstanz, Amt fuer Stadtplanung und Umwelt
06.12.2023 14:00;488;229;259;Maeßiger Schneefall;2;-1;0.1;Stadt Konstanz, Amt fuer Stadtplanung und Umwelt
06.12.2023 15:00;695;285;410;Maeßiger Schneefall;2;-1;0.1;Stadt Konstanz, Amt fuer Stadtplanung und Umwelt
06.12.2023 16:00;707;384;323;Maeßiger Schneefall;2;0;0.1;Stadt Konstanz, Amt fuer Stadtplanung und Umwelt
06.12.2023 17:00;862;437;425;Maeßiger Schneefall;2;1;0.1;Stadt Konstanz, Amt fuer Stadtplanung und Umwelt
06.12.2023 18:00;629;297;332;Maeßige bis starke Schneefaelle;1;1;0.2;Stadt Konstanz, Amt fuer Stadtplanung und Umwelt
06.12.2023 19:00;487;246;241;Maeßiger Schneefall;1;1;0.1;Stadt Konstanz, Amt fuer Stadtplanung und Umwelt
06.12.2023 20:00;401;186;215;Maeßiger Schneefall;1;1;0.2;Stadt Konstanz, Amt fuer Stadtplanung und Umwelt
06.12.2023 21:00;279;107;172;Maeßiger Schneefall;1;1;0.2;Stadt Konstanz, Amt fuer Stadtplanung und Umwelt
06.12.2023 22:00;251;83;168;Maeßiger Schneefall;0;0;0.1;Stadt Konstanz, Amt fuer Stadtplanung und Umwelt
06.12.2023 23:00;119;43;76;Leichter Schneefall;0;0;0;Stadt Konstanz, Amt fuer Stadtplanung und Umwelt
07.12.2023 00:00;80;24;56;Maeßige bis starke Schneefaelle;0;0;0.1;Stadt Konstanz, Amt fuer Stadtplanung und Umwelt
07.12.2023 01:00;30;5;25;Maeßige bis starke Schneefaelle;-1;-1;0.1;Stadt Konstanz, Amt fuer Stadtplanung und Umwelt
07.12.2023 02:00;26;7;19;Maeßiger Schneefall;-1;-1;0.1;Stadt Konstanz, Amt fuer Stadtplanung und Umwelt
07.12.2023 03:00;17;8;9;Maeßiger Schneefall;-1;-1;0.1;Stadt Konstanz, Amt fuer Stadtplanung und Umwelt
07.12.2023 04:00;10;5;5;Leichter Schneefall;-1;-2;0;Stadt Konstanz, Amt fuer Stadtplanung und Umwelt
07.12.2023 05:00;41;29;12;Leichter Nebel;-1;-2;0;Stadt Konstanz, Amt fuer Stadtplanung und Umwelt
07.12.2023 06:00;164;85;79;Bewoelkt;-2;-3;0;Stadt Konstanz, Amt fuer Stadtplanung und Umwelt
07.12.2023 07:00;845;486;359;Bewoelkt;-2;-4;0;Stadt Konstanz, Amt fuer Stadtplanung und Umwelt
07.12.2023 08:00;641;328;313;Leicht bewoelkt;-2;-5;0;Stadt Konstanz, Amt fuer Stadtplanung und Umwelt
07.12.2023 09:00;577;325;252;Leicht bewoelkt;-2;-4;0;Stadt Konstanz, Amt fuer Stadtplanung und Umwelt
07.12.2023 10:00;356;189;167;Sonnig;-1;-3;0;Stadt Konstanz, Amt fuer Stadtplanung und Umwelt
07.12.2023 11:00;484;246;238;Sonnig;0;-2;0;Stadt Konstanz, Amt fuer Stadtplanung und Umwelt
07.12.2023 12:00;525;214;311;Sonnig;1;-1;0;Stadt Konstanz, Amt fuer Stadtplanung und Umwelt
07.12.2023 13:00;734;319;415;Sonnig;1;0;0;Stadt Konstanz, Amt fuer Stadtplanung und Umwelt
07.12.2023 14:00;598;312;286;Bewoelkt;1;1;0;Stadt Konstanz, Amt fuer Stadtplanung und Umwelt
07.12.2023 15:00;831;424;407;Sonnig;0;-1;0;Stadt Konstanz, Amt fuer Stadtplanung und Umwelt
07.12.2023 16:00;772;395;377;Sonnig;-3;-3;0;Stadt Konstanz, Amt fuer Stadtplanung und Umwelt
07.12.2023 17:00;906;447;459;Leichter Nebel;-5;-6;0;Stadt Konstanz, Amt fuer Stadtplanung und Umwelt
07.12.2023 18:00;753;378;375;Leichter Nebel;-6;-6;0;Stadt Konstanz, Amt fuer Stadtplanung und Umwelt
07.12.2023 19:00;559;246;313;Leichter Nebel;-6;-6;0;Stadt Konstanz, Amt fuer Stadtplanung und Umwelt
07.12.2023 20:00;361;157;204;Leichter Nebel;-6;-6;0;Stadt Konstanz, Amt fuer Stadtplanung und Umwelt
07.12.2023 21:00;278;71;207;Leichter Nebel;-6;-6;0;Stadt Konstanz, Amt fuer Stadtplanung und Umwelt
07.12.2023 22:00;273;94;179;Sonnig;-6;-6;0;Stadt Konstanz, Amt fuer Stadtplanung und Umwelt
07.12.2023 23:00;148;46;102;Leichter Nebel;-6;-6;0;Stadt Konstanz, Amt fuer Stadtplanung und Umwelt
08.12.2023 00:00;73;14;59;Leicht bewoelkt;-6;-6;0;Stadt Konstanz, Amt fuer Stadtplanung und Umwelt
08.12.2023 01:00;50;14;36;Leicht bewoelkt;-5;-5;0;Stadt Konstanz, Amt fuer Stadtplanung und Umwelt
08.12.2023 02:00;12;5;7;Bewoelkt;-4;-4;0;Stadt Konstanz, Amt fuer Stadtplanung und Umwelt
08.12.2023 03:00;10;5;5;Bedeckt;-3;-3;0;Stadt Konstanz, Amt fuer Stadtplanung und Umwelt
08.12.2023 04:00;19;5;14;Bewoelkt;-3;-3;0;Stadt Konstanz, Amt fuer Stadtplanung und Umwelt
08.12.2023 05:00;33;16;17;Bedeckt;-2;-2;0;Stadt Konstanz, Amt fuer Stadtplanung und Umwelt
08.12.2023 06:00;146;74;72;Bedeckt;-2;-2;0;Stadt Konstanz, Amt fuer Stadtplanung und Umwelt
08.12.2023 07:00;797;477;320;Bewoelkt;-1;-1;0;Stadt Konstanz, Amt fuer Stadtplanung und Umwelt
08.12.2023 08:00;611;317;294;Bewoelkt;-1;-1;0;Stadt Konstanz, Amt fuer Stadtplanung und Umwelt
08.12.2023 09:00;600;361;239;Bewoelkt;0;-1;0;Stadt Konstanz, Amt fuer Stadtplanung und Umwelt
08.12.2023 10:00;372;204;168;Bedeckt;1;0;0;Stadt Konstanz, Amt fuer Stadtplanung und Umwelt
08.12.2023 11:00;474;237;237;Stellenweiser Regenfall;1;1;0;Stadt Konstanz, Amt fuer Stadtplanung und Umwelt
08.12.2023 12:00;579;288;291;Stellenweiser Regenfall;2;2;0.1;Stadt Konstanz, Amt fuer Stadtplanung und Umwelt
08.12.2023 13:00;790;303;487;Leichter Nebel;2;2;0;Stadt Konstanz, Amt fuer Stadtplanung und Umwelt
08.12.2023 14:00;545;326;219;Nieselregen;2;1;0.4;Stadt Konstanz, Amt fuer Stadtplanung und Umwelt
08.12.2023 15:00;636;314;322;Leichter Regenfall;2;1;0.8;Stadt Konstanz, Amt fuer Stadtplanung und Umwelt
08.12.2023 16:00;529;243;286;Leichter Regenfall;2;1;0.8;Stadt Konstanz, Amt fuer Stadtplanung und Umwelt
08.12.2023 17:00;619;243;376;Leichter Regenfall;2;1;0.9;Stadt Konstanz, Amt fuer Stadtplanung und Umwelt
08.12.2023 18:00;551;308;243;Leichter Regenfall;2;0;0.8;Stadt Konstanz, Amt fuer Stadtplanung und Umwelt
08.12.2023 19:00;369;169;200;Nieselregen;2;0;0.5;Stadt Konstanz, Amt fuer Stadtplanung und Umwelt
08.12.2023 20:00;358;171;187;Nebel;2;0;0.1;Stadt Konstanz, Amt fuer Stadtplanung und Umwelt
08.12.2023 21:00;287;111;176;Nebel;2;1;0.1;Stadt Konstanz, Amt fuer Stadtplanung und Umwelt
08.12.2023 22:00;239;75;164;Nieselregen;2;1;0.5;Stadt Konstanz, Amt fuer Stadtplanung und Umwelt
08.12.2023 23:00;183;47;136;Nieselregen;2;1;0.3;Stadt Konstanz, Amt fuer Stadtplanung und Umwelt
09.12.2023 00:00;181;58;123;Nieselregen;2;1;0.5;Stadt Konstanz, Amt fuer Stadtplanung und Umwelt
09.12.2023 01:00;98;27;71;Nieselregen;2;1;0.2;Stadt Konstanz, Amt fuer Stadtplanung und Umwelt
09.12.2023 02:00;80;32;48;Nieselregen;3;1;0.6;Stadt Konstanz, Amt fuer Stadtplanung und Umwelt
09.12.2023 03:00;63;19;44;Nebel;3;1;0.1;Stadt Konstanz, Amt fuer Stadtplanung und Umwelt
09.12.2023 04:00;29;9;20;Nebel;3;1;0;Stadt Konstanz, Amt fuer Stadtplanung und Umwelt
09.12.2023 05:00;41;23;18;Nebel;3;1;0;Stadt Konstanz, Amt fuer Stadtplanung und Umwelt
09.12.2023 06:00;42;20;22;Nebel;2;1;0;Stadt Konstanz, Amt fuer Stadtplanung und Umwelt
09.12.2023 07:00;69;43;26;Nebel;2;1;0;Stadt Konstanz, Amt fuer Stadtplanung und Umwelt
09.12.2023 08:00;171;80;91;Nebel;3;2;0;Stadt Konstanz, Amt fuer Stadtplanung und Umwelt
09.12.2023 09:00;281;188;93;Nebel;3;2;0;Stadt Konstanz, Amt fuer Stadtplanung und Umwelt
09.12.2023 10:00;371;213;158;Nebel;4;3;0;Stadt Konstanz, Amt fuer Stadtplanung und Umwelt
09.12.2023 11:00;495;261;234;Nebel;5;3;0;Stadt Konstanz, Amt fuer Stadtplanung und Umwelt
09.12.2023 12:00;445;230;215;Leichter Nebel;5;4;0;Stadt Konstanz, Amt fuer Stadtplanung und Umwelt
09.12.2023 13:00;496;239;257;Leichter Nebel;5;4;0;Stadt Konstanz, Amt fuer Stadtplanung und Umwelt
09.12.2023 14:00;476;251;225;Leichter Nebel;5;4;0;Stadt Konstanz, Amt fuer Stadtplanung und Umwelt
09.12.2023 15:00;498;231;267;Nebel;5;4;0.1;Stadt Konstanz, Amt fuer Stadtplanung und Umwelt
09.12.2023 16:00;372;170;202;Nebel;4;3;0.1;Stadt Konstanz, Amt fuer Stadtplanung und Umwelt
09.12.2023 17:00;336;144;192;Nieselregen;4;3;0.3;Stadt Konstanz, Amt fuer Stadtplanung und Umwelt
09.12.2023 18:00;328;120;208;Nieselregen;4;3;0.3;Stadt Konstanz, Amt fuer Stadtplanung und Umwelt
09.12.2023 19:00;270;146;124;Leichter Regenfall;4;3;0.8;Stadt Konstanz, Amt fuer Stadtplanung und Umwelt
09.12.2023 20:00;171;84;87;Nieselregen;4;2;0.6;Stadt Konstanz, Amt fuer Stadtplanung und Umwelt
09.12.2023 21:00;145;51;94;Leichter Regenfall;4;2;1.5;Stadt Konstanz, Amt fuer Stadtplanung und Umwelt
09.12.2023 22:00;129;46;83;Maeßiger Regenfall;5;2;3.6;Stadt Konstanz, Amt fuer Stadtplanung und Umwelt
09.12.2023 23:00;126;56;70;Leichter Regenfall;7;3;2;Stadt Konstanz, Amt fuer Stadtplanung und Umwelt
10.12.2023 00:00;89;29;60;Maeßiger Regenfall;8;4;3.9;Stadt Konstanz, Amt fuer Stadtplanung und Umwelt
10.12.2023 01:00;98;34;64;Stellenweiser Regenfall;8;4;0.1;Stadt Konstanz, Amt fuer Stadtplanung und Umwelt
10.12.2023 02:00;54;17;37;Stellenweise Gewitter und Niederschlaege;7;3;0.1;Stadt Konstanz, Amt fuer Stadtplanung und Umwelt
10.12.2023 03:00;40;17;23;Nieselregen;7;3;0.3;Stadt Konstanz, Amt fuer Stadtplanung und Umwelt
10.12.2023 04:00;13;4;9;Leichter Regenschauer;7;2;0.2;Stadt Konstanz, Amt fuer Stadtplanung und Umwelt
10.12.2023 05:00;18;14;4;Stellenweise Gewitter und Niederschlaege;6;2;0.1;Stadt Konstanz, Amt fuer Stadtplanung und Umwelt
10.12.2023 06:00;32;21;11;Leichter Regenschauer;6;2;0.6;Stadt Konstanz, Amt fuer Stadtplanung und Umwelt
10.12.2023 07:00;36;17;19;Leichter Regenschauer;6;2;0.5;Stadt Konstanz, Amt fuer Stadtplanung und Umwelt
10.12.2023 08:00;77;28;49;Leichter Regenschauer;6;2;0.2;Stadt Konstanz, Amt fuer Stadtplanung und Umwelt
10.12.2023 09:00;193;97;96;Leichter Regenschauer;6;2;0.2;Stadt Konstanz, Amt fuer Stadtplanung und Umwelt
10.12.2023 10:00;172;104;68;Leichter Regenschauer;7;3;0.2;Stadt Konstanz, Amt fuer Stadtplanung und Umwelt
10.12.2023 11:00;261;119;142;Stellenweiser Regenfall;7;3;0.1;Stadt Konstanz, Amt fuer Stadtplanung und Umwelt
10.12.2023 12:00;228;126;102;Stellenweiser Regenfall;8;4;0.1;Stadt Konstanz, Amt fuer Stadtplanung und Umwelt
10.12.2023 13:00;244;135;109;Stellenweiser Regenfall;8;4;0.1;Stadt Konstanz, Amt fuer Stadtplanung und Umwelt
10.12.2023 14:00;336;181;155;Leicht bewoelkt;7;4;0;Stadt Konstanz, Amt fuer Stadtplanung und Umwelt
10.12.2023 15:00;349;171;178;Bedeckt;7;4;0;Stadt Konstanz, Amt fuer Stadtplanung und Umwelt
10.12.2023 16:00;365;216;149;Bedeckt;6;3;0;Stadt Konstanz, Amt fuer Stadtplanung und Umwelt
10.12.2023 17:00;320;187;133;Bedeckt;6;3;0;Stadt Konstanz, Amt fuer Stadtplanung und Umwelt
10.12.2023 18:00;273;107;166;Stellenweiser Regenfall;5;3;0;Stadt Konstanz, Amt fuer Stadtplanung und Umwelt
10.12.2023 19:00;255;99;156;Bewoelkt;5;3;0;Stadt Konstanz, Amt fuer Stadtplanung und Umwelt
10.12.2023 20:00;198;66;132;Sonnig;4;2;0;Stadt Konstanz, Amt fuer Stadtplanung und Umwelt
10.12.2023 21:00;173;63;110;Leicht bewoelkt;4;2;0;Stadt Konstanz, Amt fuer Stadtplanung und Umwelt
10.12.2023 22:00;128;67;61;Stellenweiser Regenfall;4;2;0;Stadt Konstanz, Amt fuer Stadtplanung und Umwelt
10.12.2023 23:00;76;29;47;Stellenweiser Regenfall;5;3;0.1;Stadt Konstanz, Amt fuer Stadtplanung und Umwelt
11.12.2023 00:00;29;14;15;Bewoelkt;6;4;0;Stadt Konstanz, Amt fuer Stadtplanung und Umwelt
11.12.2023 01:00;10;3;7;Stellenweiser Regenfall;6;4;0.1;Stadt Konstanz, Amt fuer Stadtplanung und Umwelt
11.12.2023 02:00;6;3;3;Stellenweiser Regenfall;6;5;0.1;Stadt Konstanz, Amt fuer Stadtplanung und Umwelt
11.12.2023 03:00;6;0;6;Leichter Regenfall;6;5;2.4;Stadt Konstanz, Amt fuer Stadtplanung und Umwelt
11.12.2023 04:00;13;4;9;Leichter Regenfall;6;4;1.2;Stadt Konstanz, Amt fuer Stadtplanung und Umwelt
11.12.2023 05:00;43;24;19;Leichter Regenfall;5;4;0.9;Stadt Konstanz, Amt fuer Stadtplanung und Umwelt
11.12.2023 06:00;157;67;90;Maeßiger Regenfall;5;3;3.9;Stadt Konstanz, Amt fuer Stadtplanung und Umwelt
11.12.2023 07:00;830;515;315;Maeßiger Regenfall;5;3;3.5;Stadt Konstanz, Amt fuer Stadtplanung und Umwelt
11.12.2023 08:00;600;307;293;Maeßiger Regenfall;6;3;3.7;Stadt Konstanz, Amt fuer Stadtplanung und Umwelt
11.12.2023 09:00;591;345;246;Maeßiger Regenfall;6;3;3.4;Stadt Konstanz, Amt fuer Stadtplanung und Umwelt
11.12.2023 10:00;154;92;62;Maeßiger Regenfall;6;4;4.2;Stadt Konstanz, Amt fuer Stadtplanung und Umwelt
11.12.2023 11:00;325;148;177;Maeßiger Regenfall;7;4;2.5;Stadt Konstanz, Amt fuer Stadtplanung und Umwelt
11.12.2023 12:00;433;194;239;Maeßiger Regenfall;7;5;4.9;Stadt Konstanz, Amt fuer Stadtplanung und Umwelt
11.12.2023 13:00;636;283;353;Leichter Regenschauer;8;6;0.4;Stadt Konstanz, Amt fuer Stadtplanung und Umwelt
11.12.2023 14:00;454;223;231;Nieselregen;8;7;0.2;Stadt Konstanz, Amt fuer Stadtplanung und Umwelt
11.12.2023 15:00;770;415;355;Leichter Regenfall;9;7;1.6;Stadt Konstanz, Amt fuer Stadtplanung und Umwelt
11.12.2023 16:00;723;358;365;Leichter Regenschauer;9;7;0.5;Stadt Konstanz, Amt fuer Stadtplanung und Umwelt
11.12.2023 17:00;827;410;417;Maeßiger bis starker Regen mit Gewitter;9;7;1.4;Stadt Konstanz, Amt fuer Stadtplanung und Umwelt
11.12.2023 18:00;717;365;352;Maeßiger bis starker Regen mit Gewitter;9;8;3;Stadt Konstanz, Amt fuer Stadtplanung und Umwelt
11.12.2023 19:00;535;248;287;Leichter Regenschauer;9;8;1.7;Stadt Konstanz, Amt fuer Stadtplanung und Umwelt
11.12.2023 20:00;406;173;233;Leichter Regenfall;9;8;1.4;Stadt Konstanz, Amt fuer Stadtplanung und Umwelt
11.12.2023 21:00;254;92;162;Maeßiger bis starker Regen mit Gewitter;9;8;1.3;Stadt Konstanz, Amt fuer Stadtplanung und Umwelt
11.12.2023 22:00;208;86;122;Maeßiger Regenfall;9;7;3.7;Stadt Konstanz, Amt fuer Stadtplanung und Umwelt
11.12.2023 23:00;169;71;98;Maeßiger Regenfall;8;7;3;Stadt Konstanz, Amt fuer Stadtplanung und Umwelt
12.12.2023 00:00;41;14;27;Stellenweiser Regenfall;7;6;0;Stadt Konstanz, Amt fuer Stadtplanung und Umwelt
12.12.2023 01:00;19;9;10;Stellenweiser Regenfall;7;6;0;Stadt Konstanz, Amt fuer Stadtplanung und Umwelt
12.12.2023 02:00;12;6;6;Stellenweiser Regenfall;7;6;0;Stadt Konstanz, Amt fuer Stadtplanung und Umwelt
12.12.2023 03:00;2;0;2;Nieselregen;8;6;0.2;Stadt Konstanz, Amt fuer Stadtplanung und Umwelt
12.12.2023 04:00;10;4;6;Stellenweiser Regenfall;8;6;0.1;Stadt Konstanz, Amt fuer Stadtplanung und Umwelt
12.12.2023 05:00;49;31;18;Nieselregen;7;6;0.2;Stadt Konstanz, Amt fuer Stadtplanung und Umwelt
12.12.2023 06:00;158;79;79;Nieselregen;7;5;0.5;Stadt Konstanz, Amt fuer Stadtplanung und Umwelt
12.12.2023 07:00;801;522;279;Nieselregen;7;5;0.5;Stadt Konstanz, Amt fuer Stadtplanung und Umwelt
12.12.2023 08:00;163;84;79;Maeßiger Regenfall;7;5;3.7;Stadt Konstanz, Amt fuer Stadtplanung und Umwelt
12.12.2023 09:00;0;0;0;Leichter Regenfall;7;5;1.3;Stadt Konstanz, Amt fuer Stadtplanung und Umwelt
12.12.2023 10:00;0;0;0;Leichter Regenfall;7;6;1.4;Stadt Konstanz, Amt fuer Stadtplanung und Umwelt
12.12.2023 11:00;0;0;0;Leichter Regenfall;7;5;2.1;Stadt Konstanz, Amt fuer Stadtplanung und Umwelt
12.12.2023 12:00;0;0;0;Leichter Regenfall;8;6;0.8;Stadt Konstanz, Amt fuer Stadtplanung und Umwelt
12.12.2023 13:00;436;222;214;Nieselregen;9;6;0.7;Stadt Konstanz, Amt fuer Stadtplanung und Umwelt
12.12.2023 14:00;489;242;247;Nieselregen;9;7;0.4;Stadt Konstanz, Amt fuer Stadtplanung und Umwelt
12.12.2023 15:00;748;345;403;Nieselregen;9;7;0.2;Stadt Konstanz, Amt fuer Stadtplanung und Umwelt
12.12.2023 16:00;690;308;382;Leichter Regenschauer;9;7;0.4;Stadt Konstanz, Amt fuer Stadtplanung und Umwelt
12.12.2023 17:00;813;353;460;Leichter Regenschauer;9;7;0.4;Stadt Konstanz, Amt fuer Stadtplanung und Umwelt
12.12.2023 18:00;712;294;418;Leichter Regenschauer;9;7;1.2;Stadt Konstanz, Amt fuer Stadtplanung und Umwelt
12.12.2023 19:00;555;238;317;Leichter Regenfall;9;7;2;Stadt Konstanz, Amt fuer Stadtplanung und Umwelt
12.12.2023 20:00;354;159;195;Leichter Regenfall;9;7;1.7;Stadt Konstanz, Amt fuer Stadtplanung und Umwelt
12.12.2023 21:00;291;108;183;Leichter Regenfall;9;7;1.9;Stadt Konstanz, Amt fuer Stadtplanung und Umwelt
12.12.2023 22:00;234;84;150;Maeßiger Regenfall;9;7;2.6;Stadt Konstanz, Amt fuer Stadtplanung und Umwelt
12.12.2023 23:00;153;54;99;Leichter Regenfall;9;7;1.5;Stadt Konstanz, Amt fuer Stadtplanung und Umwelt
13.12.2023 00:00;60;26;34;Leichter Regenfall;9;7;1.1;Stadt Konstanz, Amt fuer Stadtplanung und Umwelt
13.12.2023 01:00;22;11;11;Nieselregen;9;7;0.4;Stadt Konstanz, Amt fuer Stadtplanung und Umwelt
13.12.2023 02:00;7;6;1;Nieselregen;8;6;0.2;Stadt Konstanz, Amt fuer Stadtplanung und Umwelt
13.12.2023 03:00;4;2;2;Leichter Regenschauer;8;6;0.2;Stadt Konstanz, Amt fuer Stadtplanung und Umwelt
13.12.2023 04:00;4;2;2;Leichter Regenschauer;8;6;0.3;Stadt Konstanz, Amt fuer Stadtplanung und Umwelt
13.12.2023 05:00;56;39;17;Leichter Regenschauer;7;5;0.3;Stadt Konstanz, Amt fuer Stadtplanung und Umwelt
13.12.2023 06:00;194;87;107;Leichter Regenschauer;7;4;0.2;Stadt Konstanz, Amt fuer Stadtplanung und Umwelt
13.12.2023 07:00;905;519;386;Leichter Regenschauer;7;5;0.2;Stadt Konstanz, Amt fuer Stadtplanung und Umwelt
13.12.2023 08:00;336;187;149;Nieselregen;7;5;0.4;Stadt Konstanz, Amt fuer Stadtplanung und Umwelt
13.12.2023 09:00;2;1;1;Nieselregen;7;5;0.4;Stadt Konstanz, Amt fuer Stadtplanung und Umwelt
13.12.2023 10:00;6;6;0;Leichter Regenschauer;7;6;0.6;Stadt Konstanz, Amt fuer Stadtplanung und Umwelt
13.12.2023 11:00;0;0;0;Leichter Regenschauer;8;6;0.4;Stadt Konstanz, Amt fuer Stadtplanung und Umwelt
13.12.2023 12:00;5;0;5;Stellenweiser Regenfall;8;7;0.5;Stadt Konstanz, Amt fuer Stadtplanung und Umwelt
13.12.2023 13:00;0;0;0;Leichter Regenschauer;8;7;0.4;Stadt Konstanz, Amt fuer Stadtplanung und Umwelt
13.12.2023 14:00;511;236;275;Leichter Regenschauer;8;7;0.5;Stadt Konstanz, Amt fuer Stadtplanung und Umwelt
13.12.2023 15:00;822;369;453;Stellenweiser Nieselregen;7;6;0.7;Stadt Konstanz, Amt fuer Stadtplanung und Umwelt
13.12.2023 16:00;864;426;438;Leichter Regenschauer;6;4;0.2;Stadt Konstanz, Amt fuer Stadtplanung und Umwelt
13.12.2023 17:00;942;445;497;Nieselregen;5;4;0.3;Stadt Konstanz, Amt fuer Stadtplanung und Umwelt
13.12.2023 18:00;767;347;420;Leichter Regenschauer;5;3;1.1;Stadt Konstanz, Amt fuer Stadtplanung und Umwelt
13.12.2023 19:00;536;277;259;Leichter Regenfall;5;3;0.8;Stadt Konstanz, Amt fuer Stadtplanung und Umwelt
13.12.2023 20:00;386;175;211;Leichter Regenfall;5;3;2.4;Stadt Konstanz, Amt fuer Stadtplanung und Umwelt
13.12.2023 21:00;335;124;211;Leichter Regenfall;4;2;1.5;Stadt Konstanz, Amt fuer Stadtplanung und Umwelt
13.12.2023 22:00;275;94;181;Leichter Nebel;4;2;0.1;Stadt Konstanz, Amt fuer Stadtplanung und Umwelt
13.12.2023 23:00;182;73;109;Stellenweiser Regenfall;5;2;0.1;Stadt Konstanz, Amt fuer Stadtplanung und Umwelt
14.12.2023 00:00;92;27;65;Leichter Regenschauer;5;2;0.5;Stadt Konstanz, Amt fuer Stadtplanung und Umwelt
14.12.2023 01:00;59;10;49;Leichter Regenschauer;5;2;0.2;Stadt Konstanz, Amt fuer Stadtplanung und Umwelt
14.12.2023 02:00;42;14;28;Nieselregen;5;3;0.4;Stadt Konstanz, Amt fuer Stadtplanung und Umwelt
14.12.2023 03:00;25;19;6;Nieselregen;5;3;0.7;Stadt Konstanz, Amt fuer Stadtplanung und Umwelt
14.12.2023 04:00;17;9;8;Leichter Regenschauer;5;3;0.2;Stadt Konstanz, Amt fuer Stadtplanung und Umwelt
14.12.2023 05:00;42;26;16;Leichter Nebel;5;3;0.1;Stadt Konstanz, Amt fuer Stadtplanung und Umwelt
14.12.2023 06:00;184;89;95;Nieselregen;5;3;0.6;Stadt Konstanz, Amt fuer Stadtplanung und Umwelt
14.12.2023 07:00;921;560;361;Nieselregen;5;3;0.5;Stadt Konstanz, Amt fuer Stadtplanung und Umwelt
14.12.2023 08:00;656;353;303;Nieselregen;5;3;0.5;Stadt Konstanz, Amt fuer Stadtplanung und Umwelt
14.12.2023 09:00;636;367;269;Nieselregen;5;3;0.3;Stadt Konstanz, Amt fuer Stadtplanung und Umwelt
14.12.2023 10:00;469;253;216;Leichter Nebel;5;3;0.1;Stadt Konstanz, Amt fuer Stadtplanung und Umwelt
14.12.2023 11:00;550;281;269;Leichter Nebel;5;3;0.1;Stadt Konstanz, Amt fuer Stadtplanung und Umwelt
14.12.2023 12:00;552;217;335;Leichter Regenschauer;5;3;0.2;Stadt Konstanz, Amt fuer Stadtplanung und Umwelt
14.12.2023 13:00;781;321;460;Nieselregen;5;3;0.3;Stadt Konstanz, Amt fuer Stadtplanung und Umwelt
14.12.2023 14:00;571;264;307;Nieselregen;5;3;0.3;Stadt Konstanz, Amt fuer Stadtplanung und Umwelt
14.12.2023 15:00;695;306;389;Leichter Regenfall;5;2;0.8;Stadt Konstanz, Amt fuer Stadtplanung und Umwelt
14.12.2023 16:00;686;310;376;Nieselregen;4;2;0.3;Stadt Konstanz, Amt fuer Stadtplanung und Umwelt
14.12.2023 17:00;977;447;530;Nieselregen;4;2;0.2;Stadt Konstanz, Amt fuer Stadtplanung und Umwelt
14.12.2023 18:00;743;366;377;Leichter Regenschauer;4;2;0.4;Stadt Konstanz, Amt fuer Stadtplanung und Umwelt
14.12.2023 19:00;533;236;297;Nieselregen;4;2;0.7;Stadt Konstanz, Amt fuer Stadtplanung und Umwelt
14.12.2023 20:00;403;186;217;Nieselregen;4;2;0.3;Stadt Konstanz, Amt fuer Stadtplanung und Umwelt
14.12.2023 21:00;285;115;170;Leichter Regenfall;4;2;0.8;Stadt Konstanz, Amt fuer Stadtplanung und Umwelt
14.12.2023 22:00;247;68;179;Leichter Regenfall;4;2;0.8;Stadt Konstanz, Amt fuer Stadtplanung und Umwelt
14.12.2023 23:00;173;47;126;Leichter Regenfall;5;3;0.8;Stadt Konstanz, Amt fuer Stadtplanung und Umwelt
15.12.2023 00:00;80;18;62;Leichter Regenschauer;5;4;0.5;Stadt Konstanz, Amt fuer Stadtplanung und Umwelt
15.12.2023 01:00;59;12;47;Nieselregen;5;3;0.6;Stadt Konstanz, Amt fuer Stadtplanung und Umwelt
15.12.2023 02:00;18;8;10;Nieselregen;4;2;0.5;Stadt Konstanz, Amt fuer Stadtplanung und Umwelt
15.12.2023 03:00;15;6;9;Nieselregen;4;2;0.2;Stadt Konstanz, Amt fuer Stadtplanung und Umwelt
15.12.2023 04:00;13;4;9;Stellenweiser Regenfall;4;2;0.1;Stadt Konstanz, Amt fuer Stadtplanung und Umwelt
15.12.2023 05:00;51;34;17;Stellenweiser Regenfall;3;2;0;Stadt Konstanz, Amt fuer Stadtplanung und Umwelt
15.12.2023 06:00;187;101;86;Stellenweiser Regenfall;3;1;0;Stadt Konstanz, Amt fuer Stadtplanung und Umwelt
15.12.2023 07:00;850;518;332;Leicht bewoelkt;2;1;0;Stadt Konstanz, Amt fuer Stadtplanung und Umwelt
15.12.2023 08:00;667;339;328;Leicht bewoelkt;2;2;0;Stadt Konstanz, Amt fuer Stadtplanung und Umwelt
15.12.2023 09:00;670;378;292;Stellenweiser Regenfall;3;3;0;Stadt Konstanz, Amt fuer Stadtplanung und Umwelt
15.12.2023 10:00;535;266;269;Stellenweiser Regenfall;3;3;0;Stadt Konstanz, Amt fuer Stadtplanung und Umwelt
15.12.2023 11:00;621;316;305;Stellenweiser Regenfall;4;4;0;Stadt Konstanz, Amt fuer Stadtplanung und Umwelt
15.12.2023 12:00;752;304;448;Stellenweiser Regenfall;4;4;0;Stadt Konstanz, Amt fuer Stadtplanung und Umwelt
15.12.2023 13:00;1003;431;572;Stellenweiser Regenfall;5;5;0;Stadt Konstanz, Amt fuer Stadtplanung und Umwelt
15.12.2023 14:00;725;377;348;Stellenweiser Regenfall;5;5;0;Stadt Konstanz, Amt fuer Stadtplanung und Umwelt
15.12.2023 15:00;788;347;441;Bedeckt;5;5;0;Stadt Konstanz, Amt fuer Stadtplanung und Umwelt
15.12.2023 16:00;733;390;343;Bedeckt;5;4;0;Stadt Konstanz, Amt fuer Stadtplanung und Umwelt
15.12.2023 17:00;717;343;374;Bedeckt;5;4;0;Stadt Konstanz, Amt fuer Stadtplanung und Umwelt
15.12.2023 18:00;692;307;385;Bedeckt;4;4;0;Stadt Konstanz, Amt fuer Stadtplanung und Umwelt
15.12.2023 19:00;475;209;266;Bedeckt;4;4;0;Stadt Konstanz, Amt fuer Stadtplanung und Umwelt
15.12.2023 20:00;380;171;209;Bewoelkt;4;4;0;Stadt Konstanz, Amt fuer Stadtplanung und Umwelt
15.12.2023 21:00;304;121;183;Bewoelkt;4;4;0;Stadt Konstanz, Amt fuer Stadtplanung und Umwelt
15.12.2023 22:00;293;114;179;Leicht bewoelkt;4;4;0;Stadt Konstanz, Amt fuer Stadtplanung und Umwelt
15.12.2023 23:00;210;58;152;Leicht bewoelkt;3;3;0;Stadt Konstanz, Amt fuer Stadtplanung und Umwelt
16.12.2023 00:00;209;38;171;Bewoelkt;3;3;0;Stadt Konstanz, Amt fuer Stadtplanung und Umwelt
16.12.2023 01:00;146;31;115;Leicht bewoelkt;3;2;0;Stadt Konstanz, Amt fuer Stadtplanung und Umwelt
16.12.2023 02:00;110;29;81;Leicht bewoelkt;3;1;0;Stadt Konstanz, Amt fuer Stadtplanung und Umwelt
16.12.2023 03:00;71;25;46;Leicht bewoelkt;2;1;0;Stadt Konstanz, Amt fuer Stadtplanung und Umwelt
16.12.2023 04:00;51;30;21;Leicht bewoelkt;2;0;0;Stadt Konstanz, Amt fuer Stadtplanung und Umwelt
16.12.2023 05:00;43;26;17;Sonnig;2;0;0;Stadt Konstanz, Amt fuer Stadtplanung und Umwelt
16.12.2023 06:00;46;22;24;Sonnig;1;-1;0;Stadt Konstanz, Amt fuer Stadtplanung und Umwelt
16.12.2023 07:00;64;46;18;Sonnig;0;-2;0;Stadt Konstanz, Amt fuer Stadtplanung und Umwelt
16.12.2023 08:00;167;77;90;Sonnig;0;-2;0;Stadt Konstanz, Amt fuer Stadtplanung und Umwelt
16.12.2023 09:00;321;199;122;Sonnig;1;0;0;Stadt Konstanz, Amt fuer Stadtplanung und Umwelt
16.12.2023 10:00;400;230;170;Sonnig;2;2;0;Stadt Konstanz, Amt fuer Stadtplanung und Umwelt
16.12.2023 11:00;436;243;193;Sonnig;3;3;0;Stadt Konstanz, Amt fuer Stadtplanung und Umwelt
16.12.2023 12:00;487;219;268;Sonnig;4;4;0;Stadt Konstanz, Amt fuer Stadtplanung und Umwelt
16.12.2023 13:00;562;293;269;Sonnig;5;4;0;Stadt Konstanz, Amt fuer Stadtplanung und Umwelt
16.12.2023 14:00;620;327;293;Sonnig;5;5;0;Stadt Konstanz, Amt fuer Stadtplanung und Umwelt
16.12.2023 15:00;596;278;318;Sonnig;4;4;0;Stadt Konstanz, Amt fuer Stadtplanung und Umwelt
16.12.2023 16:00;501;212;289;Sonnig;3;3;0;Stadt Konstanz, Amt fuer Stadtplanung und Umwelt
16.12.2023 17:00;505;187;318;Sonnig;2;2;0;Stadt Konstanz, Amt fuer Stadtplanung und Umwelt
16.12.2023 18:00;472;199;273;Sonnig;1;1;0;Stadt Konstanz, Amt fuer Stadtplanung und Umwelt
16.12.2023 19:00;313;151;162;Sonnig;1;1;0;Stadt Konstanz, Amt fuer Stadtplanung und Umwelt
16.12.2023 20:00;244;111;133;Sonnig;0;0;0;Stadt Konstanz, Amt fuer Stadtplanung und Umwelt
16.12.2023 21:00;232;83;149;Sonnig;0;-1;0;Stadt Konstanz, Amt fuer Stadtplanung und Umwelt
16.12.2023 22:00;212;53;159;Sonnig;0;-1;0;Stadt Konstanz, Amt fuer Stadtplanung und Umwelt
16.12.2023 23:00;169;54;115;Sonnig;-1;-1;0;Stadt Konstanz, Amt fuer Stadtplanung und Umwelt
17.12.2023 00:00;130;38;92;Sonnig;-1;-1;0;Stadt Konstanz, Amt fuer Stadtplanung und Umwelt
17.12.2023 01:00;121;35;86;Sonnig;-1;-1;0;Stadt Konstanz, Amt fuer Stadtplanung und Umwelt
17.12.2023 02:00;88;20;68;Sonnig;-1;-1;0;Stadt Konstanz, Amt fuer Stadtplanung und Umwelt
17.12.2023 03:00;71;29;42;Sonnig;-1;-1;0;Stadt Konstanz, Amt fuer Stadtplanung und Umwelt
17.12.2023 04:00;29;8;21;Sonnig;-1;-1;0;Stadt Konstanz, Amt fuer Stadtplanung und Umwelt
17.12.2023 05:00;20;14;6;Sonnig;-1;-1;0;Stadt Konstanz, Amt fuer Stadtplanung und Umwelt
17.12.2023 06:00;24;14;10;Sonnig;-1;-1;0;Stadt Konstanz, Amt fuer Stadtplanung und Umwelt
17.12.2023 07:00;38;16;22;Sonnig;-1;-1;0;Stadt Konstanz, Amt fuer Stadtplanung und Umwelt
17.12.2023 08:00;63;20;43;Sonnig;-1;-1;0;Stadt Konstanz, Amt fuer Stadtplanung und Umwelt
17.12.2023 09:00;145;76;69;Sonnig;1;1;0;Stadt Konstanz, Amt fuer Stadtplanung und Umwelt
17.12.2023 10:00;159;84;75;Sonnig;3;3;0;Stadt Konstanz, Amt fuer Stadtplanung und Umwelt
17.12.2023 11:00;180;78;102;Sonnig;4;4;0;Stadt Konstanz, Amt fuer Stadtplanung und Umwelt
17.12.2023 12:00;228;120;108;Sonnig;5;5;0;Stadt Konstanz, Amt fuer Stadtplanung und Umwelt
17.12.2023 13:00;246;133;113;Sonnig;6;6;0;Stadt Konstanz, Amt fuer Stadtplanung und Umwelt
17.12.2023 14:00;297;145;152;Sonnig;5;5;0;Stadt Konstanz, Amt fuer Stadtplanung und Umwelt
17.12.2023 15:00;311;152;159;Sonnig;4;4;0;Stadt Konstanz, Amt fuer Stadtplanung und Umwelt
17.12.2023 16:00;367;176;191;Sonnig;2;2;0;Stadt Konstanz, Amt fuer Stadtplanung und Umwelt
17.12.2023 17:00;370;175;195;Sonnig;1;1;0;Stadt Konstanz, Amt fuer Stadtplanung und Umwelt
17.12.2023 18:00;308;120;188;Sonnig;1;1;0;Stadt Konstanz, Amt fuer Stadtplanung und Umwelt
17.12.2023 19:00;240;98;142;Sonnig;1;1;0;Stadt Konstanz, Amt fuer Stadtplanung und Umwelt
17.12.2023 20:00;162;66;96;Sonnig;0;0;0;Stadt Konstanz, Amt fuer Stadtplanung und Umwelt
17.12.2023 21:00;157;61;96;Sonnig;0;0;0;Stadt Konstanz, Amt fuer Stadtplanung und Umwelt
17.12.2023 22:00;132;52;80;Sonnig;0;0;0;Stadt Konstanz, Amt fuer Stadtplanung und Umwelt
17.12.2023 23:00;63;31;32;Sonnig;0;0;0;Stadt Konstanz, Amt fuer Stadtplanung und Umwelt
18.12.2023 00:00;26;8;18;Sonnig;0;0;0;Stadt Konstanz, Amt fuer Stadtplanung und Umwelt
18.12.2023 01:00;13;7;6;Sonnig;0;0;0;Stadt Konstanz, Amt fuer Stadtplanung und Umwelt
18.12.2023 02:00;19;6;13;Sonnig;0;0;0;Stadt Konstanz, Amt fuer Stadtplanung und Umwelt
18.12.2023 03:00;1;1;0;Sonnig;0;0;0;Stadt Konstanz, Amt fuer Stadtplanung und Umwelt
18.12.2023 04:00;18;5;13;Sonnig;0;0;0;Stadt Konstanz, Amt fuer Stadtplanung und Umwelt
18.12.2023 05:00;56;39;17;Sonnig;0;0;0;Stadt Konstanz, Amt fuer Stadtplanung und Umwelt
18.12.2023 06:00;185;91;94;Sonnig;0;0;0;Stadt Konstanz, Amt fuer Stadtplanung und Umwelt
18.12.2023 07:00;878;544;334;Sonnig;0;0;0;Stadt Konstanz, Amt fuer Stadtplanung und Umwelt
18.12.2023 08:00;645;360;285;Sonnig;0;0;0;Stadt Konstanz, Amt fuer Stadtplanung und Umwelt
18.12.2023 09:00;631;361;270;Sonnig;1;1;0;Stadt Konstanz, Amt fuer Stadtplanung und Umwelt
18.12.2023 10:00;407;213;194;Sonnig;3;3;0;Stadt Konstanz, Amt fuer Stadtplanung und Umwelt
18.12.2023 11:00;288;205;83;Sonnig;5;5;0;Stadt Konstanz, Amt fuer Stadtplanung und Umwelt
18.12.2023 12:00;431;217;214;Sonnig;6;6;0;Stadt Konstanz, Amt fuer Stadtplanung und Umwelt
18.12.2023 13:00;777;341;436;Sonnig;7;7;0;Stadt Konstanz, Amt fuer Stadtplanung und Umwelt
18.12.2023 14:00;575;278;297;Sonnig;6;6;0;Stadt Konstanz, Amt fuer Stadtplanung und Umwelt
18.12.2023 15:00;855;419;436;Sonnig;5;5;0;Stadt Konstanz, Amt fuer Stadtplanung und Umwelt
18.12.2023 16:00;781;388;393;Sonnig;3;3;0;Stadt Konstanz, Amt fuer Stadtplanung und Umwelt
18.12.2023 17:00;931;426;505;Sonnig;3;3;0;Stadt Konstanz, Amt fuer Stadtplanung und Umwelt
18.12.2023 18:00;730;346;384;Sonnig;2;2;0;Stadt Konstanz, Amt fuer Stadtplanung und Umwelt
18.12.2023 19:00;566;242;324;Sonnig;2;1;0;Stadt Konstanz, Amt fuer Stadtplanung und Umwelt
18.12.2023 20:00;372;127;245;Sonnig;1;1;0;Stadt Konstanz, Amt fuer Stadtplanung und Umwelt
18.12.2023 21:00;250;84;166;Sonnig;1;1;0;Stadt Konstanz, Amt fuer Stadtplanung und Umwelt
18.12.2023 22:00;227;92;135;Sonnig;1;0;0;Stadt Konstanz, Amt fuer Stadtplanung und Umwelt
18.12.2023 23:00;156;58;98;Sonnig;1;0;0;Stadt Konstanz, Amt fuer Stadtplanung und Umwelt
19.12.2023 00:00;70;20;50;Sonnig;0;0;0;Stadt Konstanz, Amt fuer Stadtplanung und Umwelt
19.12.2023 01:00;30;8;22;Sonnig;0;0;0;Stadt Konstanz, Amt fuer Stadtplanung und Umwelt
19.12.2023 02:00;24;13;11;Sonnig;0;-1;0;Stadt Konstanz, Amt fuer Stadtplanung und Umwelt
19.12.2023 03:00;8;7;1;Sonnig;0;0;0;Stadt Konstanz, Amt fuer Stadtplanung und Umwelt
19.12.2023 04:00;7;2;5;Sonnig;0;0;0;Stadt Konstanz, Amt fuer Stadtplanung und Umwelt
19.12.2023 05:00;59;38;21;Sonnig;0;-1;0;Stadt Konstanz, Amt fuer Stadtplanung und Umwelt
19.12.2023 06:00;156;77;79;Sonnig;0;-1;0;Stadt Konstanz, Amt fuer Stadtplanung und Umwelt
19.12.2023 07:00;865;542;323;Sonnig;0;-1;0;Stadt Konstanz, Amt fuer Stadtplanung und Umwelt
19.12.2023 08:00;757;407;350;Sonnig;0;0;0;Stadt Konstanz, Amt fuer Stadtplanung und Umwelt
19.12.2023 09:00;689;437;252;Sonnig;1;0;0;Stadt Konstanz, Amt fuer Stadtplanung und Umwelt
19.12.2023 10:00;451;277;174;Sonnig;3;2;0;Stadt Konstanz, Amt fuer Stadtplanung und Umwelt
19.12.2023 11:00;586;287;299;Sonnig;5;4;0;Stadt Konstanz, Amt fuer Stadtplanung und Umwelt
19.12.2023 12:00;626;249;377;Sonnig;6;5;0;Stadt Konstanz, Amt fuer Stadtplanung und Umwelt
19.12.2023 13:00;801;327;474;Sonnig;7;6;0;Stadt Konstanz, Amt fuer Stadtplanung und Umwelt
19.12.2023 14:00;702;365;337;Sonnig;6;6;0;Stadt Konstanz, Amt fuer Stadtplanung und Umwelt
19.12.2023 15:00;923;451;472;Sonnig;5;4;0;Stadt Konstanz, Amt fuer Stadtplanung und Umwelt
19.12.2023 16:00;904;428;476;Leicht bewoelkt;3;2;0;Stadt Konstanz, Amt fuer Stadtplanung und Umwelt
19.12.2023 17:00;1039;484;555;Sonnig;3;1;0;Stadt Konstanz, Amt fuer Stadtplanung und Umwelt
19.12.2023 18:00;834;396;438;Sonnig;2;0;0;Stadt Konstanz, Amt fuer Stadtplanung und Umwelt
19.12.2023 19:00;565;251;314;Sonnig;2;0;0;Stadt Konstanz, Amt fuer Stadtplanung und Umwelt
19.12.2023 20:00;419;138;281;Leicht bewoelkt;1;0;0;Stadt Konstanz, Amt fuer Stadtplanung und Umwelt
19.12.2023 21:00;328;113;215;Leicht bewoelkt;1;0;0;Stadt Konstanz, Amt fuer Stadtplanung und Umwelt
19.12.2023 22:00;272;68;204;Leicht bewoelkt;1;-1;0;Stadt Konstanz, Amt fuer Stadtplanung und Umwelt
19.12.2023 23:00;131;38;93;Leicht bewoelkt;1;-1;0;Stadt Konstanz, Amt fuer Stadtplanung und Umwelt
20.12.2023 00:00;70;20;50;Leicht bewoelkt;0;-2;0;Stadt Konstanz, Amt fuer Stadtplanung und Umwelt
20.12.2023 01:00;57;15;42;Leicht bewoelkt;1;-1;0;Stadt Konstanz, Amt fuer Stadtplanung und Umwelt
20.12.2023 02:00;15;11;4;Stellenweiser Regenfall;2;0;0;Stadt Konstanz, Amt fuer Stadtplanung und Umwelt
20.12.2023 03:00;10;4;6;Bewoelkt;3;0;0;Stadt Konstanz, Amt fuer Stadtplanung und Umwelt
20.12.2023 04:00;6;3;3;Stellenweiser Regenfall;4;1;0;Stadt Konstanz, Amt fuer Stadtplanung und Umwelt
20.12.2023 05:00;41;28;13;Stellenweiser Regenfall;4;1;0.1;Stadt Konstanz, Amt fuer Stadtplanung und Umwelt
20.12.2023 06:00;131;70;61;Nieselregen;4;1;0.7;Stadt Konstanz, Amt fuer Stadtplanung und Umwelt
20.12.2023 07:00;769;485;284;Leichter Regenfall;4;0;1.9;Stadt Konstanz, Amt fuer Stadtplanung und Umwelt
20.12.2023 08:00;652;392;260;Leichter Regenfall;4;0;2;Stadt Konstanz, Amt fuer Stadtplanung und Umwelt
20.12.2023 09:00;611;374;237;Leichter Regenfall;4;1;2.1;Stadt Konstanz, Amt fuer Stadtplanung und Umwelt
20.12.2023 10:00;401;211;190;Leichter Regenfall;4;1;1.4;Stadt Konstanz, Amt fuer Stadtplanung und Umwelt
20.12.2023 11:00;577;279;298;Nieselregen;4;1;0.6;Stadt Konstanz, Amt fuer Stadtplanung und Umwelt
20.12.2023 12:00;605;277;328;Nieselregen;4;1;0.2;Stadt Konstanz, Amt fuer Stadtplanung und Umwelt
20.12.2023 13:00;876;440;436;Nieselregen;4;2;0.2;Stadt Konstanz, Amt fuer Stadtplanung und Umwelt
20.12.2023 14:00;611;286;325;Nieselregen;4;2;0.2;Stadt Konstanz, Amt fuer Stadtplanung und Umwelt
20.12.2023 15:00;841;375;466;Nebel;4;2;0.1;Stadt Konstanz, Amt fuer Stadtplanung und Umwelt
20.12.2023 16:00;797;379;418;Nebel;4;2;0.1;Stadt Konstanz, Amt fuer Stadtplanung und Umwelt
20.12.2023 17:00;909;408;501;Leichter Nebel;4;2;0.1;Stadt Konstanz, Amt fuer Stadtplanung und Umwelt
20.12.2023 18:00;746;343;403;Leichter Nebel;4;2;0;Stadt Konstanz, Amt fuer Stadtplanung und Umwelt
20.12.2023 19:00;488;198;290;Leichter Nebel;4;1;0;Stadt Konstanz, Amt fuer Stadtplanung und Umwelt
20.12.2023 20:00;409;154;255;Stellenweiser Regenfall;3;1;0;Stadt Konstanz, Amt fuer Stadtplanung und Umwelt
20.12.2023 21:00;251;100;151;Bewoelkt;3;0;0;Stadt Konstanz, Amt fuer Stadtplanung und Umwelt
20.12.2023 22:00;238;88;150;Bewoelkt;2;-1;0;Stadt Konstanz, Amt fuer Stadtplanung und Umwelt
20.12.2023 23:00;150;67;83;Bewoelkt;3;-1;0;Stadt Konstanz, Amt fuer Stadtplanung und Umwelt
21.12.2023 00:00;90;26;64;Leicht bewoelkt;3;-1;0;Stadt Konstanz, Amt fuer Stadtplanung und Umwelt
21.12.2023 01:00;57;14;43;Leicht bewoelkt;3;0;0;Stadt Konstanz, Amt fuer Stadtplanung und Umwelt
21.12.2023 02:00;43;12;31;Stellenweiser Regenfall;4;0;0;Stadt Konstanz, Amt fuer Stadtplanung und Umwelt
21.12.2023 03:00;14;4;10;Nieselregen;4;0;0.2;Stadt Konstanz, Amt fuer Stadtplanung und Umwelt
21.12.2023 04:00;10;3;7;Stellenweiser Regenfall;4;0;0;Stadt Konstanz, Amt fuer Stadtplanung und Umwelt
21.12.2023 05:00;42;31;11;Stellenweiser Regenfall;4;0;0;Stadt Konstanz, Amt fuer Stadtplanung und Umwelt
21.12.2023 06:00;133;68;65;Stellenweiser Regenfall;4;0;0;Stadt Konstanz, Amt fuer Stadtplanung und Umwelt
21.12.2023 07:00;583;267;316;Stellenweiser Regenfall;5;0;0;Stadt Konstanz, Amt fuer Stadtplanung und Umwelt
21.12.2023 08:00;645;369;276;Stellenweiser Regenfall;5;1;0;Stadt Konstanz, Amt fuer Stadtplanung und Umwelt
21.12.2023 09:00;771;526;245;Stellenweiser Regenfall;5;1;0.1;Stadt Konstanz, Amt fuer Stadtplanung und Umwelt
21.12.2023 10:00;397;214;183;Stellenweiser Regenfall;5;1;0.1;Stadt Konstanz, Amt fuer Stadtplanung und Umwelt
21.12.2023 11:00;652;370;282;Nieselregen;5;1;0.3;Stadt Konstanz, Amt fuer Stadtplanung und Umwelt
21.12.2023 12:00;603;259;344;Stellenweiser Regenfall;6;2;0.1;Stadt Konstanz, Amt fuer Stadtplanung und Umwelt
21.12.2023 13:00;736;280;456;Stellenweiser Regenfall;6;2;0;Stadt Konstanz, Amt fuer Stadtplanung und Umwelt
21.12.2023 14:00;481;195;286;Stellenweiser Regenfall;7;2;0.1;Stadt Konstanz, Amt fuer Stadtplanung und Umwelt
21.12.2023 15:00;553;229;324;Nieselregen;7;2;0.2;Stadt Konstanz, Amt fuer Stadtplanung und Umwelt
21.12.2023 16:00;487;201;286;Nieselregen;7;2;0.7;Stadt Konstanz, Amt fuer Stadtplanung und Umwelt
21.12.2023 17:00;500;211;289;Leichter Regenfall;7;2;1.1;Stadt Konstanz, Amt fuer Stadtplanung und Umwelt
21.12.2023 18:00;488;183;305;Leichter Regenfall;7;2;1;Stadt Konstanz, Amt fuer Stadtplanung und Umwelt
21.12.2023 19:00;341;158;183;Nieselregen;7;3;0.5;Stadt Konstanz, Amt fuer Stadtplanung und Umwelt
21.12.2023 20:00;216;108;108;Nieselregen;7;3;0.6;Stadt Konstanz, Amt fuer Stadtplanung und Umwelt
21.12.2023 21:00;151;70;81;Leichter Regenfall;7;3;1.2;Stadt Konstanz, Amt fuer Stadtplanung und Umwelt
21.12.2023 22:00;175;65;110;Leichter Regenfall;8;3;1.1;Stadt Konstanz, Amt fuer Stadtplanung und Umwelt
21.12.2023 23:00;107;20;87;Leichter Regenfall;8;3;0.9;Stadt Konstanz, Amt fuer Stadtplanung und Umwelt
22.12.2023 00:00;56;17;39;Leichter Regenschauer;8;3;0.3;Stadt Konstanz, Amt fuer Stadtplanung und Umwelt
22.12.2023 01:00;50;15;35;Leichter Regenfall;7;3;1.6;Stadt Konstanz, Amt fuer Stadtplanung und Umwelt
22.12.2023 02:00;31;16;15;Stellenweiser Nieselregen;6;2;0.5;Stadt Konstanz, Amt fuer Stadtplanung und Umwelt
22.12.2023 03:00;21;16;5;Leichter Regenfall;6;1;1.4;Stadt Konstanz, Amt fuer Stadtplanung und Umwelt
22.12.2023 04:00;7;4;3;Nieselregen;6;1;0.6;Stadt Konstanz, Amt fuer Stadtplanung und Umwelt
22.12.2023 05:00;36;28;8;Nieselregen;6;1;0.3;Stadt Konstanz, Amt fuer Stadtplanung und Umwelt
22.12.2023 06:00;102;62;40;Leichter Regenschauer;6;1;0.5;Stadt Konstanz, Amt fuer Stadtplanung und Umwelt
22.12.2023 07:00;232;134;98;Leichter Regenschauer;6;1;0.2;Stadt Konstanz, Amt fuer Stadtplanung und Umwelt
22.12.2023 08:00;337;202;135;Nieselregen;6;1;0.5;Stadt Konstanz, Amt fuer Stadtplanung und Umwelt
22.12.2023 09:00;391;218;173;Stellenweiser Regenfall;6;1;0.1;Stadt Konstanz, Amt fuer Stadtplanung und Umwelt
22.12.2023 10:00;458;246;212;Stellenweiser Regenfall;5;1;0.1;Stadt Konstanz, Amt fuer Stadtplanung und Umwelt
22.12.2023 11:00;468;231;237;Leichter Regenfall;5;0;0.8;Stadt Konstanz, Amt fuer Stadtplanung und Umwelt
22.12.2023 12:00;539;235;304;Leichter Regenfall;5;0;1.2;Stadt Konstanz, Amt fuer Stadtplanung und Umwelt
22.12.2023 13:00;480;200;280;Leichter Regenfall;5;0;1;Stadt Konstanz, Amt fuer Stadtplanung und Umwelt
22.12.2023 14:00;390;185;205;Leichter Regenfall;5;0;2.3;Stadt Konstanz, Amt fuer Stadtplanung und Umwelt
22.12.2023 15:00;332;154;178;Nieselregen;6;1;0.7;Stadt Konstanz, Amt fuer Stadtplanung und Umwelt
22.12.2023 16:00;390;183;207;Leichter Regenfall;6;2;1.2;Stadt Konstanz, Amt fuer Stadtplanung und Umwelt
22.12.2023 17:00;361;173;188;Leichter Regenfall;7;2;1.5;Stadt Konstanz, Amt fuer Stadtplanung und Umwelt
22.12.2023 18:00;365;172;193;Leichter Regenfall;7;3;0.9;Stadt Konstanz, Amt fuer Stadtplanung und Umwelt
22.12.2023 19:00;212;89;123;Nieselregen;7;3;0.4;Stadt Konstanz, Amt fuer Stadtplanung und Umwelt
22.12.2023 20:00;184;61;123;Nieselregen;7;3;0.4;Stadt Konstanz, Amt fuer Stadtplanung und Umwelt
22.12.2023 21:00;129;50;79;Nieselregen;7;3;0.4;Stadt Konstanz, Amt fuer Stadtplanung und Umwelt
22.12.2023 22:00;90;29;61;Nieselregen;7;2;0.4;Stadt Konstanz, Amt fuer Stadtplanung und Umwelt
22.12.2023 23:00;112;48;64;Nieselregen;7;2;0.6;Stadt Konstanz, Amt fuer Stadtplanung und Umwelt
23.12.2023 00:00;89;32;57;Leichter Regenschauer;6;1;0.2;Stadt Konstanz, Amt fuer Stadtplanung und Umwelt
23.12.2023 01:00;53;15;38;Leichter Regenschauer;6;1;0.3;Stadt Konstanz, Amt fuer Stadtplanung und Umwelt
23.12.2023 02:00;31;9;22;Nieselregen;6;1;0.2;Stadt Konstanz, Amt fuer Stadtplanung und Umwelt
23.12.2023 03:00;25;10;15;Stellenweiser Regenfall;6;1;0.1;Stadt Konstanz, Amt fuer Stadtplanung und Umwelt
23.12.2023 04:00;13;4;9;Stellenweiser Regenfall;6;1;0;Stadt Konstanz, Amt fuer Stadtplanung und Umwelt
23.12.2023 05:00;22;16;6;Stellenweiser Regenfall;6;1;0;Stadt Konstanz, Amt fuer Stadtplanung und Umwelt
23.12.2023 06:00;25;10;15;Stellenweiser Regenfall;6;1;0;Stadt Konstanz, Amt fuer Stadtplanung und Umwelt
23.12.2023 07:00;67;37;30;Stellenweiser Regenfall;6;2;0;Stadt Konstanz, Amt fuer Stadtplanung und Umwelt
23.12.2023 08:00;115;67;48;Bedeckt;6;2;0;Stadt Konstanz, Amt fuer Stadtplanung und Umwelt
23.12.2023 09:00;192;125;67;Bedeckt;6;2;0;Stadt Konstanz, Amt fuer Stadtplanung und Umwelt
23.12.2023 10:00;316;195;121;Bedeckt;6;2;0;Stadt Konstanz, Amt fuer Stadtplanung und Umwelt
23.12.2023 11:00;344;179;165;Bewoelkt;7;2;0;Stadt Konstanz, Amt fuer Stadtplanung und Umwelt
23.12.2023 12:00;319;149;170;Bedeckt;7;3;0;Stadt Konstanz, Amt fuer Stadtplanung und Umwelt
23.12.2023 13:00;312;138;174;Bedeckt;7;3;0;Stadt Konstanz, Amt fuer Stadtplanung und Umwelt
23.12.2023 14:00;329;152;177;Bedeckt;7;3;0;Stadt Konstanz, Amt fuer Stadtplanung und Umwelt
23.12.2023 15:00;282;140;142;Bedeckt;7;3;0;Stadt Konstanz, Amt fuer Stadtplanung und Umwelt
23.12.2023 16:00;316;146;170;Leicht bewoelkt;7;3;0;Stadt Konstanz, Amt fuer Stadtplanung und Umwelt
23.12.2023 17:00;255;129;126;Leicht bewoelkt;7;3;0;Stadt Konstanz, Amt fuer Stadtplanung und Umwelt
23.12.2023 18:00;271;97;174;Bewoelkt;7;3;0;Stadt Konstanz, Amt fuer Stadtplanung und Umwelt
23.12.2023 19:00;158;56;102;Bedeckt;7;3;0;Stadt Konstanz, Amt fuer Stadtplanung und Umwelt
23.12.2023 20:00;160;62;98;Bewoelkt;7;3;0;Stadt Konstanz, Amt fuer Stadtplanung und Umwelt
23.12.2023 21:00;122;56;66;Bewoelkt;6;3;0;Stadt Konstanz, Amt fuer Stadtplanung und Umwelt
23.12.2023 22:00;98;30;68;Leicht bewoelkt;6;2;0;Stadt Konstanz, Amt fuer Stadtplanung und Umwelt
23.12.2023 23:00;122;39;83;Leicht bewoelkt;6;2;0;Stadt Konstanz, Amt fuer Stadtplanung und Umwelt
24.12.2023 00:00;69;14;55;Leicht bewoelkt;6;2;0;Stadt Konstanz, Amt fuer Stadtplanung und Umwelt
24.12.2023 01:00;34;7;27;Leicht bewoelkt;6;2;0;Stadt Konstanz, Amt fuer Stadtplanung und Umwelt
24.12.2023 02:00;31;4;27;Leicht bewoelkt;6;2;0;Stadt Konstanz, Amt fuer Stadtplanung und Umwelt
24.12.2023 03:00;17;5;12;Leicht bewoelkt;5;2;0;Stadt Konstanz, Amt fuer Stadtplanung und Umwelt
24.12.2023 04:00;10;4;6;Leicht bewoelkt;5;1;0;Stadt Konstanz, Amt fuer Stadtplanung und Umwelt
24.12.2023 05:00;9;6;3;Leicht bewoelkt;5;1;0;Stadt Konstanz, Amt fuer Stadtplanung und Umwelt
24.12.2023 06:00;17;7;10;Leicht bewoelkt;4;1;0;Stadt Konstanz, Amt fuer Stadtplanung und Umwelt
24.12.2023 07:00;27;18;9;Sonnig;4;1;0;Stadt Konstanz, Amt fuer Stadtplanung und Umwelt
24.12.2023 08:00;48;22;26;Sonnig;4;1;0;Stadt Konstanz, Amt fuer Stadtplanung und Umwelt
24.12.2023 09:00;98;53;45;Sonnig;5;1;0;Stadt Konstanz, Amt fuer Stadtplanung und Umwelt
24.12.2023 10:00;102;52;50;Sonnig;6;2;0;Stadt Konstanz, Amt fuer Stadtplanung und Umwelt
24.12.2023 11:00;118;61;57;Sonnig;7;4;0;Stadt Konstanz, Amt fuer Stadtplanung und Umwelt
24.12.2023 12:00;119;45;74;Sonnig;8;5;0;Stadt Konstanz, Amt fuer Stadtplanung und Umwelt
24.12.2023 13:00;106;47;59;Sonnig;8;5;0;Stadt Konstanz, Amt fuer Stadtplanung und Umwelt
24.12.2023 14:00;120;45;75;Sonnig;8;6;0;Stadt Konstanz, Amt fuer Stadtplanung und Umwelt
24.12.2023 15:00;73;32;41;Sonnig;8;5;0;Stadt Konstanz, Amt fuer Stadtplanung und Umwelt
24.12.2023 16:00;96;32;64;Stellenweiser Regenfall;7;5;0.1;Stadt Konstanz, Amt fuer Stadtplanung und Umwelt
24.12.2023 17:00;68;24;44;Stellenweiser Regenfall;7;5;0;Stadt Konstanz, Amt fuer Stadtplanung und Umwelt
24.12.2023 18:00;63;29;34;Leicht bewoelkt;7;4;0;Stadt Konstanz, Amt fuer Stadtplanung und Umwelt
24.12.2023 19:00;31;11;20;Leicht bewoelkt;6;4;0;Stadt Konstanz, Amt fuer Stadtplanung und Umwelt
24.12.2023 20:00;35;17;18;Leicht bewoelkt;6;4;0;Stadt Konstanz, Amt fuer Stadtplanung und Umwelt
24.12.2023 21:00;36;21;15;Leicht bewoelkt;6;4;0;Stadt Konstanz, Amt fuer Stadtplanung und Umwelt
24.12.2023 22:00;50;26;24;Leicht bewoelkt;6;4;0;Stadt Konstanz, Amt fuer Stadtplanung und Umwelt
24.12.2023 23:00;44;28;16;Leicht bewoelkt;7;5;0;Stadt Konstanz, Amt fuer Stadtplanung und Umwelt
25.12.2023 00:00;39;22;17;Bedeckt;8;6;0;Stadt Konstanz, Amt fuer Stadtplanung und Umwelt
25.12.2023 01:00;26;12;14;Bewoelkt;9;6;0;Stadt Konstanz, Amt fuer Stadtplanung und Umwelt
25.12.2023 02:00;6;3;3;Bedeckt;9;7;0;Stadt Konstanz, Amt fuer Stadtplanung und Umwelt
25.12.2023 03:00;8;1;7;Bewoelkt;9;6;0;Stadt Konstanz, Amt fuer Stadtplanung und Umwelt
25.12.2023 04:00;6;4;2;Leicht bewoelkt;8;6;0;Stadt Konstanz, Amt fuer Stadtplanung und Umwelt
25.12.2023 05:00;6;5;1;Bedeckt;8;6;0;Stadt Konstanz, Amt fuer Stadtplanung und Umwelt
25.12.2023 06:00;14;8;6;Bedeckt;8;6;0;Stadt Konstanz, Amt fuer Stadtplanung und Umwelt
25.12.2023 07:00;15;10;5;Bedeckt;8;6;0;Stadt Konstanz, Amt fuer Stadtplanung und Umwelt
25.12.2023 08:00;16;9;7;Bedeckt;8;6;0;Stadt Konstanz, Amt fuer Stadtplanung und Umwelt
25.12.2023 09:00;74;38;36;Leicht bewoelkt;8;7;0;Stadt Konstanz, Amt fuer Stadtplanung und Umwelt
25.12.2023 10:00;63;30;33;Sonnig;9;7;0;Stadt Konstanz, Amt fuer Stadtplanung und Umwelt
25.12.2023 11:00;97;50;47;Sonnig;10;8;0;Stadt Konstanz, Amt fuer Stadtplanung und Umwelt
25.12.2023 12:00;129;71;58;Sonnig;11;9;0;Stadt Konstanz, Amt fuer Stadtplanung und Umwelt
25.12.2023 13:00;115;52;63;Sonnig;11;9;0;Stadt Konstanz, Amt fuer Stadtplanung und Umwelt
25.12.2023 14:00;150;80;70;Sonnig;11;9;0;Stadt Konstanz, Amt fuer Stadtplanung und Umwelt
25.12.2023 15:00;132;49;83;Sonnig;10;8;0;Stadt Konstanz, Amt fuer Stadtplanung und Umwelt
25.12.2023 16:00;124;55;69;Sonnig;9;7;0;Stadt Konstanz, Amt fuer Stadtplanung und Umwelt
25.12.2023 17:00;131;60;71;Sonnig;8;6;0;Stadt Konstanz, Amt fuer Stadtplanung und Umwelt
25.12.2023 18:00;56;20;36;Sonnig;7;6;0;Stadt Konstanz, Amt fuer Stadtplanung und Umwelt
25.12.2023 19:00;60;35;25;Sonnig;7;5;0;Stadt Konstanz, Amt fuer Stadtplanung und Umwelt
25.12.2023 20:00;59;31;28;Sonnig;6;5;0;Stadt Konstanz, Amt fuer Stadtplanung und Umwelt
25.12.2023 21:00;42;24;18;Sonnig;6;4;0;Stadt Konstanz, Amt fuer Stadtplanung und Umwelt
25.12.2023 22:00;56;25;31;Sonnig;5;3;0;Stadt Konstanz, Amt fuer Stadtplanung und Umwelt
25.12.2023 23:00;44;21;23;Leicht bewoelkt;4;3;0;Stadt Konstanz, Amt fuer Stadtplanung und Umwelt
26.12.2023 00:00;26;13;13;Leicht bewoelkt;4;2;0;Stadt Konstanz, Amt fuer Stadtplanung und Umwelt
26.12.2023 01:00;20;9;11;Leicht bewoelkt;4;2;0;Stadt Konstanz, Amt fuer Stadtplanung und Umwelt
26.12.2023 02:00;9;1;8;Leicht bewoelkt;4;2;0;Stadt Konstanz, Amt fuer Stadtplanung und Umwelt
26.12.2023 03:00;5;0;5;Leicht bewoelkt;4;2;0;Stadt Konstanz, Amt fuer Stadtplanung und Umwelt
26.12.2023 04:00;5;2;3;Leicht bewoelkt;5;2;0;Stadt Konstanz, Amt fuer Stadtplanung und Umwelt
26.12.2023 05:00;9;6;3;Bewoelkt;5;3;0;Stadt Konstanz, Amt fuer Stadtplanung und Umwelt
26.12.2023 06:00;20;10;10;Bewoelkt;6;3;0;Stadt Konstanz, Amt fuer Stadtplanung und Umwelt
26.12.2023 07:00;16;11;5;Bedeckt;6;4;0;Stadt Konstanz, Amt fuer Stadtplanung und Umwelt
26.12.2023 08:00;30;16;14;Bedeckt;6;4;0;Stadt Konstanz, Amt fuer Stadtplanung und Umwelt
26.12.2023 09:00;72;38;34;Sonnig;7;5;0;Stadt Konstanz, Amt fuer Stadtplanung und Umwelt
26.12.2023 10:00;83;50;33;Sonnig;7;5;0;Stadt Konstanz, Amt fuer Stadtplanung und Umwelt
26.12.2023 11:00;138;68;70;Leicht bewoelkt;8;6;0;Stadt Konstanz, Amt fuer Stadtplanung und Umwelt
26.12.2023 12:00;143;67;76;Leicht bewoelkt;8;6;0;Stadt Konstanz, Amt fuer Stadtplanung und Umwelt
26.12.2023 13:00;161;76;85;Sonnig;8;6;0;Stadt Konstanz, Amt fuer Stadtplanung und Umwelt
26.12.2023 14:00;179;78;101;Sonnig;8;6;0;Stadt Konstanz, Amt fuer Stadtplanung und Umwelt
26.12.2023 15:00;188;102;86;Sonnig;8;5;0;Stadt Konstanz, Amt fuer Stadtplanung und Umwelt
26.12.2023 16:00;167;74;93;Leicht bewoelkt;7;4;0;Stadt Konstanz, Amt fuer Stadtplanung und Umwelt
26.12.2023 17:00;145;90;55;Bedeckt;6;4;0;Stadt Konstanz, Amt fuer Stadtplanung und Umwelt
26.12.2023 18:00;102;42;60;Bedeckt;6;4;0;Stadt Konstanz, Amt fuer Stadtplanung und Umwelt
26.12.2023 19:00;111;67;44;Leicht bewoelkt;6;4;0;Stadt Konstanz, Amt fuer Stadtplanung und Umwelt
26.12.2023 20:00;123;72;51;Stellenweiser Regenfall;6;5;0;Stadt Konstanz, Amt fuer Stadtplanung und Umwelt
26.12.2023 21:00;77;33;44;Leicht bewoelkt;6;5;0;Stadt Konstanz, Amt fuer Stadtplanung und Umwelt
26.12.2023 22:00;58;25;33;Leicht bewoelkt;6;5;0;Stadt Konstanz, Amt fuer Stadtplanung und Umwelt
26.12.2023 23:00;61;9;52;Leicht bewoelkt;5;4;0;Stadt Konstanz, Amt fuer Stadtplanung und Umwelt
27.12.2023 00:00;40;6;34;Sonnig;3;3;0;Stadt Konstanz, Amt fuer Stadtplanung und Umwelt
27.12.2023 01:00;29;2;27;Leicht bewoelkt;3;3;0;Stadt Konstanz, Amt fuer Stadtplanung und Umwelt
27.12.2023 02:00;7;4;3;Leicht bewoelkt;3;3;0;Stadt Konstanz, Amt fuer Stadtplanung und Umwelt
27.12.2023 03:00;10;6;4;Leicht bewoelkt;2;2;0;Stadt Konstanz, Amt fuer Stadtplanung und Umwelt
27.12.2023 04:00;16;10;6;Leicht bewoelkt;2;2;0;Stadt Konstanz, Amt fuer Stadtplanung und Umwelt
27.12.2023 05:00;32;25;7;Leicht bewoelkt;2;2;0;Stadt Konstanz, Amt fuer Stadtplanung und Umwelt
27.12.2023 06:00;68;41;27;Leicht bewoelkt;2;2;0;Stadt Konstanz, Amt fuer Stadtplanung und Umwelt
27.12.2023 07:00;97;56;41;Leicht bewoelkt;2;2;0;Stadt Konstanz, Amt fuer Stadtplanung und Umwelt
27.12.2023 08:00;129;90;39;Leicht bewoelkt;2;2;0;Stadt Konstanz, Amt fuer Stadtplanung und Umwelt
27.12.2023 09:00;172;109;63;Leicht bewoelkt;3;3;0;Stadt Konstanz, Amt fuer Stadtplanung und Umwelt
27.12.2023 10:00;258;139;119;Leicht bewoelkt;4;4;0;Stadt Konstanz, Amt fuer Stadtplanung und Umwelt
27.12.2023 11:00;317;166;151;Leicht bewoelkt;6;6;0;Stadt Konstanz, Amt fuer Stadtplanung und Umwelt
27.12.2023 12:00;276;118;158;Leicht bewoelkt;7;7;0;Stadt Konstanz, Amt fuer Stadtplanung und Umwelt
27.12.2023 13:00;294;156;138;Leicht bewoelkt;7;7;0;Stadt Konstanz, Amt fuer Stadtplanung und Umwelt
27.12.2023 14:00;363;156;207;Sonnig;7;7;0;Stadt Konstanz, Amt fuer Stadtplanung und Umwelt
27.12.2023 15:00;370;157;213;Sonnig;6;6;0;Stadt Konstanz, Amt fuer Stadtplanung und Umwelt
27.12.2023 16:00;380;161;219;Sonnig;5;5;0;Stadt Konstanz, Amt fuer Stadtplanung und Umwelt
27.12.2023 17:00;322;128;194;Sonnig;4;4;0;Stadt Konstanz, Amt fuer Stadtplanung und Umwelt
27.12.2023 18:00;242;70;172;Sonnig;3;3;0;Stadt Konstanz, Amt fuer Stadtplanung und Umwelt
27.12.2023 19:00;172;74;98;Leicht bewoelkt;3;3;0;Stadt Konstanz, Amt fuer Stadtplanung und Umwelt
27.12.2023 20:00;117;50;67;Leicht bewoelkt;3;3;0;Stadt Konstanz, Amt fuer Stadtplanung und Umwelt
27.12.2023 21:00;96;44;52;Sonnig;2;2;0;Stadt Konstanz, Amt fuer Stadtplanung und Umwelt
27.12.2023 22:00;88;36;52;Sonnig;2;2;0;Stadt Konstanz, Amt fuer Stadtplanung und Umwelt
27.12.2023 23:00;58;22;36;Sonnig;2;1;0;Stadt Konstanz, Amt fuer Stadtplanung und Umwelt
28.12.2023 00:00;45;11;34;Sonnig;2;1;0;Stadt Konstanz, Amt fuer Stadtplanung und Umwelt
28.12.2023 01:00;40;7;33;Sonnig;1;0;0;Stadt Konstanz, Amt fuer Stadtplanung und Umwelt
28.12.2023 02:00;13;4;9;Sonnig;1;0;0;Stadt Konstanz, Amt fuer Stadtplanung und Umwelt
28.12.2023 03:00;6;2;4;Sonnig;1;0;0;Stadt Konstanz, Amt fuer Stadtplanung und Umwelt
28.12.2023 04:00;4;3;1;Sonnig;1;-1;0;Stadt Konstanz, Amt fuer Stadtplanung und Umwelt
28.12.2023 05:00;36;23;13;Sonnig;1;-1;0;Stadt Konstanz, Amt fuer Stadtplanung und Umwelt
28.12.2023 06:00;59;36;23;Sonnig;1;0;0;Stadt Konstanz, Amt fuer Stadtplanung und Umwelt
28.12.2023 07:00;110;64;46;Sonnig;1;-1;0;Stadt Konstanz, Amt fuer Stadtplanung und Umwelt
28.12.2023 08:00;141;89;52;Sonnig;2;0;0;Stadt Konstanz, Amt fuer Stadtplanung und Umwelt
28.12.2023 09:00;188;124;64;Sonnig;3;1;0;Stadt Konstanz, Amt fuer Stadtplanung und Umwelt
28.12.2023 10:00;234;136;98;Bedeckt;4;3;0;Stadt Konstanz, Amt fuer Stadtplanung und Umwelt
28.12.2023 11:00;269;150;119;Bedeckt;5;5;0;Stadt Konstanz, Amt fuer Stadtplanung und Umwelt
28.12.2023 12:00;301;137;164;Sonnig;6;6;0;Stadt Konstanz, Amt fuer Stadtplanung und Umwelt
28.12.2023 13:00;301;158;143;Bewoelkt;6;6;0;Stadt Konstanz, Amt fuer Stadtplanung und Umwelt
28.12.2023 14:00;362;159;203;Bedeckt;6;6;0;Stadt Konstanz, Amt fuer Stadtplanung und Umwelt
28.12.2023 15:00;359;152;207;Bedeckt;6;6;0;Stadt Konstanz, Amt fuer Stadtplanung und Umwelt
28.12.2023 16:00;348;149;199;Bedeckt;6;5;0;Stadt Konstanz, Amt fuer Stadtplanung und Umwelt
28.12.2023 17:00;329;122;207;Bedeckt;6;5;0;Stadt Konstanz, Amt fuer Stadtplanung und Umwelt
28.12.2023 18:00;267;108;159;Bedeckt;5;5;0;Stadt Konstanz, Amt fuer Stadtplanung und Umwelt
28.12.2023 19:00;205;84;121;Bedeckt;5;4;0;Stadt Konstanz, Amt fuer Stadtplanung und Umwelt
28.12.2023 20:00;162;67;95;Leicht bewoelkt;4;4;0;Stadt Konstanz, Amt fuer Stadtplanung und Umwelt
28.12.2023 21:00;103;41;62;Leicht bewoelkt;4;3;0;Stadt Konstanz, Amt fuer Stadtplanung und Umwelt
28.12.2023 22:00;122;58;64;Bewoelkt;4;3;0;Stadt Konstanz, Amt fuer Stadtplanung und Umwelt
28.12.2023 23:00;56;16;40;Bewoelkt;4;3;0;Stadt Konstanz, Amt fuer Stadtplanung und Umwelt
29.12.2023 00:00;47;14;33;Leicht bewoelkt;4;2;0;Stadt Konstanz, Amt fuer Stadtplanung und Umwelt
29.12.2023 01:00;43;9;34;Leicht bewoelkt;4;2;0;Stadt Konstanz, Amt fuer Stadtplanung und Umwelt
29.12.2023 02:00;14;9;5;Sonnig;4;3;0;Stadt Konstanz, Amt fuer Stadtplanung und Umwelt
29.12.2023 03:00;13;6;7;Sonnig;4;3;0;Stadt Konstanz, Amt fuer Stadtplanung und Umwelt
29.12.2023 04:00;9;3;6;Leicht bewoelkt;4;3;0;Stadt Konstanz, Amt fuer Stadtplanung und Umwelt
29.12.2023 05:00;33;19;14;Leicht bewoelkt;4;3;0;Stadt Konstanz, Amt fuer Stadtplanung und Umwelt
29.12.2023 06:00;68;43;25;Leicht bewoelkt;4;2;0;Stadt Konstanz, Amt fuer Stadtplanung und Umwelt
29.12.2023 07:00;85;46;39;Stellenweiser Regenfall;4;2;0;Stadt Konstanz, Amt fuer Stadtplanung und Umwelt
29.12.2023 08:00;162;101;61;Leicht bewoelkt;4;3;0;Stadt Konstanz, Amt fuer Stadtplanung und Umwelt
29.12.2023 09:00;246;144;102;Bedeckt;5;4;0;Stadt Konstanz, Amt fuer Stadtplanung und Umwelt
29.12.2023 10:00;318;194;124;Bewoelkt;6;5;0;Stadt Konstanz, Amt fuer Stadtplanung und Umwelt
29.12.2023 11:00;350;179;171;Bewoelkt;8;6;0;Stadt Konstanz, Amt fuer Stadtplanung und Umwelt
29.12.2023 12:00;399;189;210;Bewoelkt;9;7;0;Stadt Konstanz, Amt fuer Stadtplanung und Umwelt
29.12.2023 13:00;444;222;222;Leicht bewoelkt;9;8;0;Stadt Konstanz, Amt fuer Stadtplanung und Umwelt
29.12.2023 14:00;401;206;195;Leicht bewoelkt;9;7;0;Stadt Konstanz, Amt fuer Stadtplanung und Umwelt
29.12.2023 15:00;380;202;178;Leicht bewoelkt;8;7;0;Stadt Konstanz, Amt fuer Stadtplanung und Umwelt
29.12.2023 16:00;415;173;242;Leicht bewoelkt;7;6;0;Stadt Konstanz, Amt fuer Stadtplanung und Umwelt
29.12.2023 17:00;421;199;222;Leicht bewoelkt;7;5;0;Stadt Konstanz, Amt fuer Stadtplanung und Umwelt
29.12.2023 18:00;311;120;191;Bewoelkt;6;5;0;Stadt Konstanz, Amt fuer Stadtplanung und Umwelt
29.12.2023 19:00;243;93;150;Leicht bewoelkt;6;4;0;Stadt Konstanz, Amt fuer Stadtplanung und Umwelt
29.12.2023 20:00;160;75;85;Bewoelkt;6;4;0;Stadt Konstanz, Amt fuer Stadtplanung und Umwelt
29.12.2023 21:00;184;68;116;Bedeckt;6;4;0;Stadt Konstanz, Amt fuer Stadtplanung und Umwelt
29.12.2023 22:00;108;48;60;Sonnig;5;3;0;Stadt Konstanz, Amt fuer Stadtplanung und Umwelt
29.12.2023 23:00;111;34;77;Sonnig;6;4;0;Stadt Konstanz, Amt fuer Stadtplanung und Umwelt
30.12.2023 00:00;68;22;46;Stellenweiser Regenfall;7;5;0;Stadt Konstanz, Amt fuer Stadtplanung und Umwelt
30.12.2023 01:00;48;13;35;Leicht bewoelkt;7;5;0;Stadt Konstanz, Amt fuer Stadtplanung und Umwelt
30.12.2023 02:00;36;7;29;Stellenweiser Regenfall;7;5;0;Stadt Konstanz, Amt fuer Stadtplanung und Umwelt
30.12.2023 03:00;18;6;12;Stellenweiser Regenfall;7;5;0;Stadt Konstanz, Amt fuer Stadtplanung und Umwelt
30.12.2023 04:00;15;8;7;Stellenweiser Regenfall;7;5;0;Stadt Konstanz, Amt fuer Stadtplanung und Umwelt
30.12.2023 05:00;36;25;11;Stellenweiser Regenfall;6;5;0.1;Stadt Konstanz, Amt fuer Stadtplanung und Umwelt
30.12.2023 06:00;39;28;11;Stellenweiser Regenfall;6;5;0;Stadt Konstanz, Amt fuer Stadtplanung und Umwelt
30.12.2023 07:00;60;23;37;Stellenweiser Regenfall;6;4;0;Stadt Konstanz, Amt fuer Stadtplanung und Umwelt
30.12.2023 08:00;99;56;43;Sonnig;6;4;0;Stadt Konstanz, Amt fuer Stadtplanung und Umwelt
30.12.2023 09:00;212;104;108;Leicht bewoelkt;6;5;0;Stadt Konstanz, Amt fuer Stadtplanung und Umwelt
30.12.2023 10:00;284;149;135;Leicht bewoelkt;8;7;0;Stadt Konstanz, Amt fuer Stadtplanung und Umwelt
30.12.2023 11:00;388;202;186;Sonnig;9;8;0;Stadt Konstanz, Amt fuer Stadtplanung und Umwelt
30.12.2023 12:00;428;230;198;Sonnig;9;9;0;Stadt Konstanz, Amt fuer Stadtplanung und Umwelt
30.12.2023 13:00;454;212;242;Sonnig;10;10;0;Stadt Konstanz, Amt fuer Stadtplanung und Umwelt
30.12.2023 14:00;405;179;226;Sonnig;10;10;0;Stadt Konstanz, Amt fuer Stadtplanung und Umwelt
30.12.2023 15:00;410;200;210;Sonnig;8;8;0;Stadt Konstanz, Amt fuer Stadtplanung und Umwelt
30.12.2023 16:00;423;161;262;Sonnig;7;7;0;Stadt Konstanz, Amt fuer Stadtplanung und Umwelt
30.12.2023 17:00;352;161;191;Sonnig;6;6;0;Stadt Konstanz, Amt fuer Stadtplanung und Umwelt
30.12.2023 18:00;264;113;151;Sonnig;5;5;0;Stadt Konstanz, Amt fuer Stadtplanung und Umwelt
30.12.2023 19:00;207;87;120;Sonnig;4;4;0;Stadt Konstanz, Amt fuer Stadtplanung und Umwelt
30.12.2023 20:00;146;69;77;Sonnig;4;3;0;Stadt Konstanz, Amt fuer Stadtplanung und Umwelt
30.12.2023 21:00;122;56;66;Sonnig;3;3;0;Stadt Konstanz, Amt fuer Stadtplanung und Umwelt
30.12.2023 22:00;99;41;58;Sonnig;3;2;0;Stadt Konstanz, Amt fuer Stadtplanung und Umwelt
30.12.2023 23:00;80;27;53;Sonnig;3;2;0;Stadt Konstanz, Amt fuer Stadtplanung und Umwelt
31.12.2023 00:00;65;21;44;Sonnig;3;2;0;Stadt Konstanz, Amt fuer Stadtplanung und Umwelt
31.12.2023 01:00;25;9;16;Sonnig;2;1;0;Stadt Konstanz, Amt fuer Stadtplanung und Umwelt
31.12.2023 02:00;17;10;7;Sonnig;2;1;0;Stadt Konstanz, Amt fuer Stadtplanung und Umwelt
31.12.2023 03:00;17;4;13;Sonnig;2;0;0;Stadt Konstanz, Amt fuer Stadtplanung und Umwelt
31.12.2023 04:00;7;3;4;Sonnig;1;0;0;Stadt Konstanz, Amt fuer Stadtplanung und Umwelt
31.12.2023 05:00;18;11;7;Sonnig;1;0;0;Stadt Konstanz, Amt fuer Stadtplanung und Umwelt
31.12.2023 06:00;26;8;18;Bedeckt;2;0;0;Stadt Konstanz, Amt fuer Stadtplanung und Umwelt
31.12.2023 07:00;26;13;13;Bedeckt;2;0;0;Stadt Konstanz, Amt fuer Stadtplanung und Umwelt
31.12.2023 08:00;39;21;18;Sonnig;2;1;0;Stadt Konstanz, Amt fuer Stadtplanung und Umwelt
31.12.2023 09:00;93;45;48;Bewoelkt;3;2;0;Stadt Konstanz, Amt fuer Stadtplanung und Umwelt
31.12.2023 10:00;112;50;62;Sonnig;4;4;0;Stadt Konstanz, Amt fuer Stadtplanung und Umwelt
31.12.2023 11:00;158;85;73;Sonnig;6;5;0;Stadt Konstanz, Amt fuer Stadtplanung und Umwelt
31.12.2023 12:00;168;80;88;Sonnig;7;6;0;Stadt Konstanz, Amt fuer Stadtplanung und Umwelt
31.12.2023 13:00;209;95;114;Sonnig;7;5;0;Stadt Konstanz, Amt fuer Stadtplanung und Umwelt
31.12.2023 14:00;218;93;125;Leicht bewoelkt;7;3;0;Stadt Konstanz, Amt fuer Stadtplanung und Umwelt
31.12.2023 15:00;169;83;86;Stellenweiser Regenfall;6;2;0;Stadt Konstanz, Amt fuer Stadtplanung und Umwelt
31.12.2023 16:00;147;74;73;Nieselregen;4;1;0.6;Stadt Konstanz, Amt fuer Stadtplanung und Umwelt
31.12.2023 17:00;154;88;66;Leichter Eisregen;4;0;0.7;Stadt Konstanz, Amt fuer Stadtplanung und Umwelt
31.12.2023 18:00;212;114;98;Stellenweiser Regenfall;4;1;0;Stadt Konstanz, Amt fuer Stadtplanung und Umwelt
31.12.2023 19:00;212;107;105;Stellenweiser Regenfall;4;1;0;Stadt Konstanz, Amt fuer Stadtplanung und Umwelt
31.12.2023 20:00;110;63;47;Bedeckt;4;1;0;Stadt Konstanz, Amt fuer Stadtplanung und Umwelt
31.12.2023 21:00;110;72;38;Bewoelkt;4;1;0;Stadt Konstanz, Amt fuer Stadtplanung und Umwelt
31.12.2023 22:00;101;44;57;Leicht bewoelkt;4;1;0;Stadt Konstanz, Amt fuer Stadtplanung und Umwelt
31.12.2023 23:00;132;48;84;Sonnig;4;1;0;Stadt Konstanz, Amt fuer Stadtplanung und Umwelt
